,Station,DateTime,Destination,Origin,Day,Hour,Total
0,12TH,2016-06-01 04:00:00,12,28,Wednesday,4,40
1,12TH,2016-06-01 05:00:00,76,185,Wednesday,5,261
2,12TH,2016-06-01 06:00:00,256,765,Wednesday,6,1021
3,12TH,2016-06-01 07:00:00,637,2098,Wednesday,7,2735
4,12TH,2016-06-01 08:00:00,1017,2917,Wednesday,8,3934
5,12TH,2016-06-01 09:00:00,763,1641,Wednesday,9,2404
6,12TH,2016-06-01 10:00:00,582,653,Wednesday,10,1235
7,12TH,2016-06-01 11:00:00,464,489,Wednesday,11,953
8,12TH,2016-06-01 12:00:00,592,479,Wednesday,12,1071
9,12TH,2016-06-01 13:00:00,571,535,Wednesday,13,1106
10,12TH,2016-06-01 14:00:00,580,487,Wednesday,14,1067
11,12TH,2016-06-01 15:00:00,915,498,Wednesday,15,1413
12,12TH,2016-06-01 16:00:00,1528,666,Wednesday,16,2194
13,12TH,2016-06-01 17:00:00,2959,1113,Wednesday,17,4072
14,12TH,2016-06-01 18:00:00,2033,946,Wednesday,18,2979
15,12TH,2016-06-01 19:00:00,806,521,Wednesday,19,1327
16,12TH,2016-06-01 20:00:00,382,271,Wednesday,20,653
17,12TH,2016-06-01 21:00:00,239,292,Wednesday,21,531
18,12TH,2016-06-01 22:00:00,174,199,Wednesday,22,373
19,12TH,2016-06-01 23:00:00,108,116,Wednesday,23,224
20,12TH,2016-06-02 00:00:00,44,52,Thursday,0,96
21,12TH,2016-06-02 04:00:00,14,30,Thursday,4,44
22,12TH,2016-06-02 05:00:00,69,204,Thursday,5,273
23,12TH,2016-06-02 06:00:00,231,733,Thursday,6,964
24,12TH,2016-06-02 07:00:00,622,2100,Thursday,7,2722
25,12TH,2016-06-02 08:00:00,1040,2858,Thursday,8,3898
26,12TH,2016-06-02 09:00:00,810,1610,Thursday,9,2420
27,12TH,2016-06-02 10:00:00,515,666,Thursday,10,1181
28,12TH,2016-06-02 11:00:00,429,459,Thursday,11,888
29,12TH,2016-06-02 12:00:00,491,442,Thursday,12,933
30,12TH,2016-06-02 13:00:00,536,473,Thursday,13,1009
31,12TH,2016-06-02 14:00:00,597,463,Thursday,14,1060
32,12TH,2016-06-02 15:00:00,803,601,Thursday,15,1404
33,12TH,2016-06-02 16:00:00,1691,789,Thursday,16,2480
34,12TH,2016-06-02 17:00:00,3317,1145,Thursday,17,4462
35,12TH,2016-06-02 18:00:00,1790,922,Thursday,18,2712
36,12TH,2016-06-02 19:00:00,759,429,Thursday,19,1188
37,12TH,2016-06-02 20:00:00,419,385,Thursday,20,804
38,12TH,2016-06-02 21:00:00,374,373,Thursday,21,747
39,12TH,2016-06-02 22:00:00,216,230,Thursday,22,446
40,12TH,2016-06-02 23:00:00,116,151,Thursday,23,267
41,12TH,2016-06-03 00:00:00,70,55,Friday,0,125
42,12TH,2016-06-03 01:00:00,18,2,Friday,1,20
43,12TH,2016-06-03 04:00:00,13,26,Friday,4,39
44,12TH,2016-06-03 05:00:00,64,176,Friday,5,240
45,12TH,2016-06-03 06:00:00,227,640,Friday,6,867
46,12TH,2016-06-03 07:00:00,542,1864,Friday,7,2406
47,12TH,2016-06-03 08:00:00,828,2596,Friday,8,3424
48,12TH,2016-06-03 09:00:00,752,1427,Friday,9,2179
49,12TH,2016-06-03 10:00:00,503,581,Friday,10,1084
50,12TH,2016-06-03 11:00:00,443,436,Friday,11,879
51,12TH,2016-06-03 12:00:00,543,460,Friday,12,1003
52,12TH,2016-06-03 13:00:00,602,464,Friday,13,1066
53,12TH,2016-06-03 14:00:00,635,464,Friday,14,1099
54,12TH,2016-06-03 15:00:00,914,496,Friday,15,1410
55,12TH,2016-06-03 16:00:00,1618,718,Friday,16,2336
56,12TH,2016-06-03 17:00:00,2403,1046,Friday,17,3449
57,12TH,2016-06-03 18:00:00,1576,860,Friday,18,2436
58,12TH,2016-06-03 19:00:00,648,579,Friday,19,1227
59,12TH,2016-06-03 20:00:00,337,413,Friday,20,750
60,12TH,2016-06-03 21:00:00,303,321,Friday,21,624
61,12TH,2016-06-03 22:00:00,295,294,Friday,22,589
62,12TH,2016-06-03 23:00:00,262,212,Friday,23,474
63,12TH,2016-06-04 00:00:00,255,138,Saturday,0,393
64,12TH,2016-06-04 06:00:00,55,49,Saturday,6,104
65,12TH,2016-06-04 07:00:00,121,104,Saturday,7,225
66,12TH,2016-06-04 08:00:00,198,219,Saturday,8,417
67,12TH,2016-06-04 09:00:00,227,254,Saturday,9,481
68,12TH,2016-06-04 10:00:00,238,223,Saturday,10,461
69,12TH,2016-06-04 11:00:00,320,270,Saturday,11,590
70,12TH,2016-06-04 12:00:00,298,304,Saturday,12,602
71,12TH,2016-06-04 13:00:00,375,249,Saturday,13,624
72,12TH,2016-06-04 14:00:00,339,252,Saturday,14,591
73,12TH,2016-06-04 15:00:00,339,292,Saturday,15,631
74,12TH,2016-06-04 16:00:00,298,269,Saturday,16,567
75,12TH,2016-06-04 17:00:00,276,336,Saturday,17,612
76,12TH,2016-06-04 18:00:00,244,346,Saturday,18,590
77,12TH,2016-06-04 19:00:00,223,271,Saturday,19,494
78,12TH,2016-06-04 20:00:00,177,227,Saturday,20,404
79,12TH,2016-06-04 21:00:00,199,184,Saturday,21,383
80,12TH,2016-06-04 22:00:00,128,174,Saturday,22,302
81,12TH,2016-06-04 23:00:00,90,152,Saturday,23,242
82,12TH,2016-06-05 00:00:00,90,108,Sunday,0,198
83,12TH,2016-06-05 08:00:00,103,142,Sunday,8,245
84,12TH,2016-06-05 09:00:00,183,159,Sunday,9,342
85,12TH,2016-06-05 10:00:00,218,182,Sunday,10,400
86,12TH,2016-06-05 11:00:00,207,194,Sunday,11,401
87,12TH,2016-06-05 12:00:00,241,227,Sunday,12,468
88,12TH,2016-06-05 13:00:00,272,230,Sunday,13,502
89,12TH,2016-06-05 14:00:00,280,238,Sunday,14,518
90,12TH,2016-06-05 15:00:00,259,243,Sunday,15,502
91,12TH,2016-06-05 16:00:00,224,290,Sunday,16,514
92,12TH,2016-06-05 17:00:00,246,296,Sunday,17,542
93,12TH,2016-06-05 18:00:00,225,266,Sunday,18,491
94,12TH,2016-06-05 19:00:00,159,201,Sunday,19,360
95,12TH,2016-06-05 20:00:00,185,238,Sunday,20,423
96,12TH,2016-06-05 21:00:00,144,166,Sunday,21,310
97,12TH,2016-06-05 22:00:00,116,131,Sunday,22,247
98,12TH,2016-06-05 23:00:00,102,80,Sunday,23,182
99,12TH,2016-06-06 00:00:00,60,53,Monday,0,113
100,12TH,2016-06-06 01:00:00,6,2,Monday,1,8
101,12TH,2016-06-06 04:00:00,9,25,Monday,4,34
102,12TH,2016-06-06 05:00:00,64,158,Monday,5,222
103,12TH,2016-06-06 06:00:00,227,733,Monday,6,960
104,12TH,2016-06-06 07:00:00,640,2005,Monday,7,2645
105,12TH,2016-06-06 08:00:00,882,2893,Monday,8,3775
106,12TH,2016-06-06 09:00:00,801,1636,Monday,9,2437
107,12TH,2016-06-06 10:00:00,516,709,Monday,10,1225
108,12TH,2016-06-06 11:00:00,425,438,Monday,11,863
109,12TH,2016-06-06 12:00:00,451,424,Monday,12,875
110,12TH,2016-06-06 13:00:00,496,388,Monday,13,884
111,12TH,2016-06-06 14:00:00,574,445,Monday,14,1019
112,12TH,2016-06-06 15:00:00,852,435,Monday,15,1287
113,12TH,2016-06-06 16:00:00,1658,595,Monday,16,2253
114,12TH,2016-06-06 17:00:00,3022,980,Monday,17,4002
115,12TH,2016-06-06 18:00:00,1912,830,Monday,18,2742
116,12TH,2016-06-06 19:00:00,683,477,Monday,19,1160
117,12TH,2016-06-06 20:00:00,322,341,Monday,20,663
118,12TH,2016-06-06 21:00:00,203,239,Monday,21,442
119,12TH,2016-06-06 22:00:00,189,182,Monday,22,371
120,12TH,2016-06-06 23:00:00,89,121,Monday,23,210
121,12TH,2016-06-07 00:00:00,31,63,Tuesday,0,94
122,12TH,2016-06-07 04:00:00,7,30,Tuesday,4,37
123,12TH,2016-06-07 05:00:00,75,192,Tuesday,5,267
124,12TH,2016-06-07 06:00:00,223,805,Tuesday,6,1028
125,12TH,2016-06-07 07:00:00,556,2166,Tuesday,7,2722
126,12TH,2016-06-07 08:00:00,1034,3029,Tuesday,8,4063
127,12TH,2016-06-07 09:00:00,776,1641,Tuesday,9,2417
128,12TH,2016-06-07 10:00:00,504,660,Tuesday,10,1164
129,12TH,2016-06-07 11:00:00,461,414,Tuesday,11,875
130,12TH,2016-06-07 12:00:00,576,441,Tuesday,12,1017
131,12TH,2016-06-07 13:00:00,501,417,Tuesday,13,918
132,12TH,2016-06-07 14:00:00,634,457,Tuesday,14,1091
133,12TH,2016-06-07 15:00:00,994,471,Tuesday,15,1465
134,12TH,2016-06-07 16:00:00,1709,656,Tuesday,16,2365
135,12TH,2016-06-07 17:00:00,3132,1014,Tuesday,17,4146
136,12TH,2016-06-07 18:00:00,2017,999,Tuesday,18,3016
137,12TH,2016-06-07 19:00:00,728,503,Tuesday,19,1231
138,12TH,2016-06-07 20:00:00,321,325,Tuesday,20,646
139,12TH,2016-06-07 21:00:00,274,282,Tuesday,21,556
140,12TH,2016-06-07 22:00:00,220,160,Tuesday,22,380
141,12TH,2016-06-07 23:00:00,95,182,Tuesday,23,277
142,12TH,2016-06-08 00:00:00,55,60,Wednesday,0,115
143,12TH,2016-06-08 01:00:00,9,2,Wednesday,1,11
144,12TH,2016-06-08 04:00:00,11,34,Wednesday,4,45
145,12TH,2016-06-08 05:00:00,65,202,Wednesday,5,267
146,12TH,2016-06-08 06:00:00,230,713,Wednesday,6,943
147,12TH,2016-06-08 07:00:00,634,2084,Wednesday,7,2718
148,12TH,2016-06-08 08:00:00,967,2872,Wednesday,8,3839
149,12TH,2016-06-08 09:00:00,758,1632,Wednesday,9,2390
150,12TH,2016-06-08 10:00:00,522,621,Wednesday,10,1143
151,12TH,2016-06-08 11:00:00,515,484,Wednesday,11,999
152,12TH,2016-06-08 12:00:00,495,380,Wednesday,12,875
153,12TH,2016-06-08 13:00:00,557,443,Wednesday,13,1000
154,12TH,2016-06-08 14:00:00,584,487,Wednesday,14,1071
155,12TH,2016-06-08 15:00:00,831,471,Wednesday,15,1302
156,12TH,2016-06-08 16:00:00,1680,702,Wednesday,16,2382
157,12TH,2016-06-08 17:00:00,3307,1030,Wednesday,17,4337
158,12TH,2016-06-08 18:00:00,1829,984,Wednesday,18,2813
159,12TH,2016-06-08 19:00:00,584,435,Wednesday,19,1019
160,12TH,2016-06-08 20:00:00,319,317,Wednesday,20,636
161,12TH,2016-06-08 21:00:00,322,341,Wednesday,21,663
162,12TH,2016-06-08 22:00:00,202,239,Wednesday,22,441
163,12TH,2016-06-08 23:00:00,119,166,Wednesday,23,285
164,12TH,2016-06-09 00:00:00,56,56,Thursday,0,112
165,12TH,2016-06-09 04:00:00,12,36,Thursday,4,48
166,12TH,2016-06-09 05:00:00,57,202,Thursday,5,259
167,12TH,2016-06-09 06:00:00,233,753,Thursday,6,986
168,12TH,2016-06-09 07:00:00,627,1981,Thursday,7,2608
169,12TH,2016-06-09 08:00:00,952,2871,Thursday,8,3823
170,12TH,2016-06-09 09:00:00,793,1589,Thursday,9,2382
171,12TH,2016-06-09 10:00:00,496,608,Thursday,10,1104
172,12TH,2016-06-09 11:00:00,477,457,Thursday,11,934
173,12TH,2016-06-09 12:00:00,503,452,Thursday,12,955
174,12TH,2016-06-09 13:00:00,547,440,Thursday,13,987
175,12TH,2016-06-09 14:00:00,616,420,Thursday,14,1036
176,12TH,2016-06-09 15:00:00,875,515,Thursday,15,1390
177,12TH,2016-06-09 16:00:00,1653,643,Thursday,16,2296
178,12TH,2016-06-09 17:00:00,2978,1066,Thursday,17,4044
179,12TH,2016-06-09 18:00:00,1966,839,Thursday,18,2805
180,12TH,2016-06-09 19:00:00,717,546,Thursday,19,1263
181,12TH,2016-06-09 20:00:00,350,338,Thursday,20,688
182,12TH,2016-06-09 21:00:00,336,358,Thursday,21,694
183,12TH,2016-06-09 22:00:00,203,201,Thursday,22,404
184,12TH,2016-06-09 23:00:00,127,149,Thursday,23,276
185,12TH,2016-06-10 00:00:00,73,80,Friday,0,153
186,12TH,2016-06-10 04:00:00,16,23,Friday,4,39
187,12TH,2016-06-10 05:00:00,55,134,Friday,5,189
188,12TH,2016-06-10 06:00:00,228,667,Friday,6,895
189,12TH,2016-06-10 07:00:00,519,1772,Friday,7,2291
190,12TH,2016-06-10 08:00:00,907,2465,Friday,8,3372
191,12TH,2016-06-10 09:00:00,645,1450,Friday,9,2095
192,12TH,2016-06-10 10:00:00,579,581,Friday,10,1160
193,12TH,2016-06-10 11:00:00,445,395,Friday,11,840
194,12TH,2016-06-10 12:00:00,619,415,Friday,12,1034
195,12TH,2016-06-10 13:00:00,623,446,Friday,13,1069
196,12TH,2016-06-10 14:00:00,635,485,Friday,14,1120
197,12TH,2016-06-10 15:00:00,924,505,Friday,15,1429
198,12TH,2016-06-10 16:00:00,1610,743,Friday,16,2353
199,12TH,2016-06-10 17:00:00,2526,1124,Friday,17,3650
200,12TH,2016-06-10 18:00:00,1425,804,Friday,18,2229
201,12TH,2016-06-10 19:00:00,544,462,Friday,19,1006
202,12TH,2016-06-10 20:00:00,254,246,Friday,20,500
203,12TH,2016-06-10 21:00:00,245,334,Friday,21,579
204,12TH,2016-06-10 22:00:00,287,256,Friday,22,543
205,12TH,2016-06-10 23:00:00,172,173,Friday,23,345
206,12TH,2016-06-11 00:00:00,141,114,Saturday,0,255
207,12TH,2016-06-11 06:00:00,26,38,Saturday,6,64
208,12TH,2016-06-11 07:00:00,129,119,Saturday,7,248
209,12TH,2016-06-11 08:00:00,174,172,Saturday,8,346
210,12TH,2016-06-11 09:00:00,257,292,Saturday,9,549
211,12TH,2016-06-11 10:00:00,223,231,Saturday,10,454
212,12TH,2016-06-11 11:00:00,321,252,Saturday,11,573
213,12TH,2016-06-11 12:00:00,332,244,Saturday,12,576
214,12TH,2016-06-11 13:00:00,311,288,Saturday,13,599
215,12TH,2016-06-11 14:00:00,365,271,Saturday,14,636
216,12TH,2016-06-11 15:00:00,332,275,Saturday,15,607
217,12TH,2016-06-11 16:00:00,342,380,Saturday,16,722
218,12TH,2016-06-11 17:00:00,351,393,Saturday,17,744
219,12TH,2016-06-11 18:00:00,331,369,Saturday,18,700
220,12TH,2016-06-11 19:00:00,225,365,Saturday,19,590
221,12TH,2016-06-11 20:00:00,189,311,Saturday,20,500
222,12TH,2016-06-11 21:00:00,190,234,Saturday,21,424
223,12TH,2016-06-11 22:00:00,174,218,Saturday,22,392
224,12TH,2016-06-11 23:00:00,188,166,Saturday,23,354
225,12TH,2016-06-12 00:00:00,122,104,Sunday,0,226
226,12TH,2016-06-12 01:00:00,19,1,Sunday,1,20
227,12TH,2016-06-12 08:00:00,115,128,Sunday,8,243
228,12TH,2016-06-12 09:00:00,184,141,Sunday,9,325
229,12TH,2016-06-12 10:00:00,218,168,Sunday,10,386
230,12TH,2016-06-12 11:00:00,250,200,Sunday,11,450
231,12TH,2016-06-12 12:00:00,217,161,Sunday,12,378
232,12TH,2016-06-12 13:00:00,247,169,Sunday,13,416
233,12TH,2016-06-12 14:00:00,270,225,Sunday,14,495
234,12TH,2016-06-12 15:00:00,248,228,Sunday,15,476
235,12TH,2016-06-12 16:00:00,222,267,Sunday,16,489
236,12TH,2016-06-12 17:00:00,231,252,Sunday,17,483
237,12TH,2016-06-12 18:00:00,191,239,Sunday,18,430
238,12TH,2016-06-12 19:00:00,182,242,Sunday,19,424
239,12TH,2016-06-12 20:00:00,156,263,Sunday,20,419
240,12TH,2016-06-12 21:00:00,184,212,Sunday,21,396
241,12TH,2016-06-12 22:00:00,189,168,Sunday,22,357
242,12TH,2016-06-12 23:00:00,68,91,Sunday,23,159
243,12TH,2016-06-13 00:00:00,39,95,Monday,0,134
244,12TH,2016-06-13 04:00:00,12,30,Monday,4,42
245,12TH,2016-06-13 05:00:00,69,184,Monday,5,253
246,12TH,2016-06-13 06:00:00,207,712,Monday,6,919
247,12TH,2016-06-13 07:00:00,580,1935,Monday,7,2515
248,12TH,2016-06-13 08:00:00,925,2907,Monday,8,3832
249,12TH,2016-06-13 09:00:00,731,1513,Monday,9,2244
250,12TH,2016-06-13 10:00:00,451,639,Monday,10,1090
251,12TH,2016-06-13 11:00:00,432,434,Monday,11,866
252,12TH,2016-06-13 12:00:00,464,401,Monday,12,865
253,12TH,2016-06-13 13:00:00,463,398,Monday,13,861
254,12TH,2016-06-13 14:00:00,548,409,Monday,14,957
255,12TH,2016-06-13 15:00:00,814,512,Monday,15,1326
256,12TH,2016-06-13 16:00:00,1640,695,Monday,16,2335
257,12TH,2016-06-13 17:00:00,3174,1190,Monday,17,4364
258,12TH,2016-06-13 18:00:00,1792,1010,Monday,18,2802
259,12TH,2016-06-13 19:00:00,608,403,Monday,19,1011
260,12TH,2016-06-13 20:00:00,261,248,Monday,20,509
261,12TH,2016-06-13 21:00:00,427,348,Monday,21,775
262,12TH,2016-06-13 22:00:00,206,225,Monday,22,431
263,12TH,2016-06-13 23:00:00,112,121,Monday,23,233
264,12TH,2016-06-14 00:00:00,58,45,Tuesday,0,103
265,12TH,2016-06-14 04:00:00,9,27,Tuesday,4,36
266,12TH,2016-06-14 05:00:00,75,195,Tuesday,5,270
267,12TH,2016-06-14 06:00:00,217,793,Tuesday,6,1010
268,12TH,2016-06-14 07:00:00,592,2052,Tuesday,7,2644
269,12TH,2016-06-14 08:00:00,994,3138,Tuesday,8,4132
270,12TH,2016-06-14 09:00:00,703,1530,Tuesday,9,2233
271,12TH,2016-06-14 10:00:00,516,665,Tuesday,10,1181
272,12TH,2016-06-14 11:00:00,433,480,Tuesday,11,913
273,12TH,2016-06-14 12:00:00,458,452,Tuesday,12,910
274,12TH,2016-06-14 13:00:00,471,406,Tuesday,13,877
275,12TH,2016-06-14 14:00:00,613,413,Tuesday,14,1026
276,12TH,2016-06-14 15:00:00,874,491,Tuesday,15,1365
277,12TH,2016-06-14 16:00:00,1746,668,Tuesday,16,2414
278,12TH,2016-06-14 17:00:00,3176,1052,Tuesday,17,4228
279,12TH,2016-06-14 18:00:00,1976,890,Tuesday,18,2866
280,12TH,2016-06-14 19:00:00,789,507,Tuesday,19,1296
281,12TH,2016-06-14 20:00:00,345,335,Tuesday,20,680
282,12TH,2016-06-14 21:00:00,273,252,Tuesday,21,525
283,12TH,2016-06-14 22:00:00,217,247,Tuesday,22,464
284,12TH,2016-06-14 23:00:00,102,120,Tuesday,23,222
285,16TH,2016-06-01 01:00:00,27,13,Wednesday,1,40
286,16TH,2016-06-01 04:00:00,12,13,Wednesday,4,25
287,16TH,2016-06-01 05:00:00,96,111,Wednesday,5,207
288,16TH,2016-06-01 06:00:00,229,451,Wednesday,6,680
289,16TH,2016-06-01 07:00:00,574,1027,Wednesday,7,1601
290,16TH,2016-06-01 08:00:00,1279,1444,Wednesday,8,2723
291,16TH,2016-06-01 09:00:00,939,1072,Wednesday,9,2011
292,16TH,2016-06-01 10:00:00,408,623,Wednesday,10,1031
293,16TH,2016-06-01 11:00:00,332,449,Wednesday,11,781
294,16TH,2016-06-01 12:00:00,396,491,Wednesday,12,887
295,16TH,2016-06-01 13:00:00,409,476,Wednesday,13,885
296,16TH,2016-06-01 14:00:00,519,522,Wednesday,14,1041
297,16TH,2016-06-01 15:00:00,623,615,Wednesday,15,1238
298,16TH,2016-06-01 16:00:00,914,758,Wednesday,16,1672
299,16TH,2016-06-01 17:00:00,1491,1451,Wednesday,17,2942
300,16TH,2016-06-01 18:00:00,1746,1266,Wednesday,18,3012
301,16TH,2016-06-01 19:00:00,973,814,Wednesday,19,1787
302,16TH,2016-06-01 20:00:00,660,468,Wednesday,20,1128
303,16TH,2016-06-01 21:00:00,528,345,Wednesday,21,873
304,16TH,2016-06-01 22:00:00,401,217,Wednesday,22,618
305,16TH,2016-06-01 23:00:00,295,165,Wednesday,23,460
306,16TH,2016-06-02 00:00:00,200,60,Thursday,0,260
307,16TH,2016-06-02 01:00:00,21,14,Thursday,1,35
308,16TH,2016-06-02 04:00:00,14,9,Thursday,4,23
309,16TH,2016-06-02 05:00:00,87,107,Thursday,5,194
310,16TH,2016-06-02 06:00:00,231,478,Thursday,6,709
311,16TH,2016-06-02 07:00:00,565,1030,Thursday,7,1595
312,16TH,2016-06-02 08:00:00,1032,1444,Thursday,8,2476
313,16TH,2016-06-02 09:00:00,1074,1155,Thursday,9,2229
314,16TH,2016-06-02 10:00:00,473,634,Thursday,10,1107
315,16TH,2016-06-02 11:00:00,315,487,Thursday,11,802
316,16TH,2016-06-02 12:00:00,406,446,Thursday,12,852
317,16TH,2016-06-02 13:00:00,387,402,Thursday,13,789
318,16TH,2016-06-02 14:00:00,459,529,Thursday,14,988
319,16TH,2016-06-02 15:00:00,677,596,Thursday,15,1273
320,16TH,2016-06-02 16:00:00,942,771,Thursday,16,1713
321,16TH,2016-06-02 17:00:00,1868,1587,Thursday,17,3455
322,16TH,2016-06-02 18:00:00,1549,1400,Thursday,18,2949
323,16TH,2016-06-02 19:00:00,880,712,Thursday,19,1592
324,16TH,2016-06-02 20:00:00,598,503,Thursday,20,1101
325,16TH,2016-06-02 21:00:00,714,514,Thursday,21,1228
326,16TH,2016-06-02 22:00:00,500,241,Thursday,22,741
327,16TH,2016-06-02 23:00:00,340,165,Thursday,23,505
328,16TH,2016-06-03 00:00:00,230,75,Friday,0,305
329,16TH,2016-06-03 01:00:00,40,28,Friday,1,68
330,16TH,2016-06-03 04:00:00,14,10,Friday,4,24
331,16TH,2016-06-03 05:00:00,78,99,Friday,5,177
332,16TH,2016-06-03 06:00:00,223,447,Friday,6,670
333,16TH,2016-06-03 07:00:00,459,994,Friday,7,1453
334,16TH,2016-06-03 08:00:00,1099,1332,Friday,8,2431
335,16TH,2016-06-03 09:00:00,924,995,Friday,9,1919
336,16TH,2016-06-03 10:00:00,524,588,Friday,10,1112
337,16TH,2016-06-03 11:00:00,447,494,Friday,11,941
338,16TH,2016-06-03 12:00:00,416,523,Friday,12,939
339,16TH,2016-06-03 13:00:00,490,522,Friday,13,1012
340,16TH,2016-06-03 14:00:00,546,547,Friday,14,1093
341,16TH,2016-06-03 15:00:00,769,737,Friday,15,1506
342,16TH,2016-06-03 16:00:00,1026,884,Friday,16,1910
343,16TH,2016-06-03 17:00:00,1467,1518,Friday,17,2985
344,16TH,2016-06-03 18:00:00,1502,1329,Friday,18,2831
345,16TH,2016-06-03 19:00:00,982,868,Friday,19,1850
346,16TH,2016-06-03 20:00:00,608,538,Friday,20,1146
347,16TH,2016-06-03 21:00:00,614,381,Friday,21,995
348,16TH,2016-06-03 22:00:00,557,301,Friday,22,858
349,16TH,2016-06-03 23:00:00,509,342,Friday,23,851
350,16TH,2016-06-04 00:00:00,352,250,Saturday,0,602
351,16TH,2016-06-04 01:00:00,54,30,Saturday,1,84
352,16TH,2016-06-04 06:00:00,67,66,Saturday,6,133
353,16TH,2016-06-04 07:00:00,129,162,Saturday,7,291
354,16TH,2016-06-04 08:00:00,212,254,Saturday,8,466
355,16TH,2016-06-04 09:00:00,245,374,Saturday,9,619
356,16TH,2016-06-04 10:00:00,335,436,Saturday,10,771
357,16TH,2016-06-04 11:00:00,370,487,Saturday,11,857
358,16TH,2016-06-04 12:00:00,386,569,Saturday,12,955
359,16TH,2016-06-04 13:00:00,481,589,Saturday,13,1070
360,16TH,2016-06-04 14:00:00,506,638,Saturday,14,1144
361,16TH,2016-06-04 15:00:00,561,591,Saturday,15,1152
362,16TH,2016-06-04 16:00:00,600,717,Saturday,16,1317
363,16TH,2016-06-04 17:00:00,623,707,Saturday,17,1330
364,16TH,2016-06-04 18:00:00,675,661,Saturday,18,1336
365,16TH,2016-06-04 19:00:00,552,597,Saturday,19,1149
366,16TH,2016-06-04 20:00:00,516,408,Saturday,20,924
367,16TH,2016-06-04 21:00:00,507,374,Saturday,21,881
368,16TH,2016-06-04 22:00:00,450,279,Saturday,22,729
369,16TH,2016-06-04 23:00:00,405,340,Saturday,23,745
370,16TH,2016-06-05 00:00:00,385,174,Sunday,0,559
371,16TH,2016-06-05 01:00:00,44,25,Sunday,1,69
372,16TH,2016-06-05 08:00:00,134,165,Sunday,8,299
373,16TH,2016-06-05 09:00:00,150,291,Sunday,9,441
374,16TH,2016-06-05 10:00:00,246,353,Sunday,10,599
375,16TH,2016-06-05 11:00:00,304,424,Sunday,11,728
376,16TH,2016-06-05 12:00:00,329,493,Sunday,12,822
377,16TH,2016-06-05 13:00:00,442,532,Sunday,13,974
378,16TH,2016-06-05 14:00:00,449,570,Sunday,14,1019
379,16TH,2016-06-05 15:00:00,555,552,Sunday,15,1107
380,16TH,2016-06-05 16:00:00,578,540,Sunday,16,1118
381,16TH,2016-06-05 17:00:00,425,496,Sunday,17,921
382,16TH,2016-06-05 18:00:00,462,378,Sunday,18,840
383,16TH,2016-06-05 19:00:00,398,306,Sunday,19,704
384,16TH,2016-06-05 20:00:00,442,328,Sunday,20,770
385,16TH,2016-06-05 21:00:00,381,206,Sunday,21,587
386,16TH,2016-06-05 22:00:00,274,176,Sunday,22,450
387,16TH,2016-06-05 23:00:00,227,122,Sunday,23,349
388,16TH,2016-06-06 00:00:00,113,40,Monday,0,153
389,16TH,2016-06-06 01:00:00,11,5,Monday,1,16
390,16TH,2016-06-06 04:00:00,15,4,Monday,4,19
391,16TH,2016-06-06 05:00:00,81,105,Monday,5,186
392,16TH,2016-06-06 06:00:00,217,407,Monday,6,624
393,16TH,2016-06-06 07:00:00,528,968,Monday,7,1496
394,16TH,2016-06-06 08:00:00,1200,1386,Monday,8,2586
395,16TH,2016-06-06 09:00:00,959,1109,Monday,9,2068
396,16TH,2016-06-06 10:00:00,439,627,Monday,10,1066
397,16TH,2016-06-06 11:00:00,326,410,Monday,11,736
398,16TH,2016-06-06 12:00:00,323,402,Monday,12,725
399,16TH,2016-06-06 13:00:00,373,462,Monday,13,835
400,16TH,2016-06-06 14:00:00,532,475,Monday,14,1007
401,16TH,2016-06-06 15:00:00,607,537,Monday,15,1144
402,16TH,2016-06-06 16:00:00,978,747,Monday,16,1725
403,16TH,2016-06-06 17:00:00,1461,1373,Monday,17,2834
404,16TH,2016-06-06 18:00:00,1574,1311,Monday,18,2885
405,16TH,2016-06-06 19:00:00,955,795,Monday,19,1750
406,16TH,2016-06-06 20:00:00,524,421,Monday,20,945
407,16TH,2016-06-06 21:00:00,493,258,Monday,21,751
408,16TH,2016-06-06 22:00:00,415,225,Monday,22,640
409,16TH,2016-06-06 23:00:00,293,160,Monday,23,453
410,16TH,2016-06-07 00:00:00,147,65,Tuesday,0,212
411,16TH,2016-06-07 01:00:00,11,9,Tuesday,1,20
412,16TH,2016-06-07 04:00:00,10,17,Tuesday,4,27
413,16TH,2016-06-07 05:00:00,98,126,Tuesday,5,224
414,16TH,2016-06-07 06:00:00,222,468,Tuesday,6,690
415,16TH,2016-06-07 07:00:00,565,984,Tuesday,7,1549
416,16TH,2016-06-07 08:00:00,1224,1505,Tuesday,8,2729
417,16TH,2016-06-07 09:00:00,992,1091,Tuesday,9,2083
418,16TH,2016-06-07 10:00:00,443,680,Tuesday,10,1123
419,16TH,2016-06-07 11:00:00,359,416,Tuesday,11,775
420,16TH,2016-06-07 12:00:00,380,484,Tuesday,12,864
421,16TH,2016-06-07 13:00:00,422,448,Tuesday,13,870
422,16TH,2016-06-07 14:00:00,448,493,Tuesday,14,941
423,16TH,2016-06-07 15:00:00,678,605,Tuesday,15,1283
424,16TH,2016-06-07 16:00:00,1028,728,Tuesday,16,1756
425,16TH,2016-06-07 17:00:00,1696,1396,Tuesday,17,3092
426,16TH,2016-06-07 18:00:00,1644,1376,Tuesday,18,3020
427,16TH,2016-06-07 19:00:00,926,748,Tuesday,19,1674
428,16TH,2016-06-07 20:00:00,607,411,Tuesday,20,1018
429,16TH,2016-06-07 21:00:00,520,278,Tuesday,21,798
430,16TH,2016-06-07 22:00:00,383,263,Tuesday,22,646
431,16TH,2016-06-07 23:00:00,336,164,Tuesday,23,500
432,16TH,2016-06-08 00:00:00,168,82,Wednesday,0,250
433,16TH,2016-06-08 01:00:00,31,9,Wednesday,1,40
434,16TH,2016-06-08 04:00:00,14,7,Wednesday,4,21
435,16TH,2016-06-08 05:00:00,77,113,Wednesday,5,190
436,16TH,2016-06-08 06:00:00,230,421,Wednesday,6,651
437,16TH,2016-06-08 07:00:00,593,1022,Wednesday,7,1615
438,16TH,2016-06-08 08:00:00,1223,1452,Wednesday,8,2675
439,16TH,2016-06-08 09:00:00,961,1049,Wednesday,9,2010
440,16TH,2016-06-08 10:00:00,482,670,Wednesday,10,1152
441,16TH,2016-06-08 11:00:00,360,422,Wednesday,11,782
442,16TH,2016-06-08 12:00:00,349,451,Wednesday,12,800
443,16TH,2016-06-08 13:00:00,398,467,Wednesday,13,865
444,16TH,2016-06-08 14:00:00,566,508,Wednesday,14,1074
445,16TH,2016-06-08 15:00:00,611,601,Wednesday,15,1212
446,16TH,2016-06-08 16:00:00,1014,718,Wednesday,16,1732
447,16TH,2016-06-08 17:00:00,1677,1770,Wednesday,17,3447
448,16TH,2016-06-08 18:00:00,1654,1527,Wednesday,18,3181
449,16TH,2016-06-08 19:00:00,873,752,Wednesday,19,1625
450,16TH,2016-06-08 20:00:00,606,412,Wednesday,20,1018
451,16TH,2016-06-08 21:00:00,663,378,Wednesday,21,1041
452,16TH,2016-06-08 22:00:00,498,270,Wednesday,22,768
453,16TH,2016-06-08 23:00:00,331,210,Wednesday,23,541
454,16TH,2016-06-09 00:00:00,218,95,Thursday,0,313
455,16TH,2016-06-09 01:00:00,15,14,Thursday,1,29
456,16TH,2016-06-09 04:00:00,20,15,Thursday,4,35
457,16TH,2016-06-09 05:00:00,94,113,Thursday,5,207
458,16TH,2016-06-09 06:00:00,217,407,Thursday,6,624
459,16TH,2016-06-09 07:00:00,529,941,Thursday,7,1470
460,16TH,2016-06-09 08:00:00,1198,1481,Thursday,8,2679
461,16TH,2016-06-09 09:00:00,918,1097,Thursday,9,2015
462,16TH,2016-06-09 10:00:00,461,653,Thursday,10,1114
463,16TH,2016-06-09 11:00:00,329,497,Thursday,11,826
464,16TH,2016-06-09 12:00:00,421,476,Thursday,12,897
465,16TH,2016-06-09 13:00:00,479,457,Thursday,13,936
466,16TH,2016-06-09 14:00:00,471,491,Thursday,14,962
467,16TH,2016-06-09 15:00:00,582,598,Thursday,15,1180
468,16TH,2016-06-09 16:00:00,1032,792,Thursday,16,1824
469,16TH,2016-06-09 17:00:00,1547,1480,Thursday,17,3027
470,16TH,2016-06-09 18:00:00,1712,1524,Thursday,18,3236
471,16TH,2016-06-09 19:00:00,980,926,Thursday,19,1906
472,16TH,2016-06-09 20:00:00,722,491,Thursday,20,1213
473,16TH,2016-06-09 21:00:00,679,409,Thursday,21,1088
474,16TH,2016-06-09 22:00:00,472,302,Thursday,22,774
475,16TH,2016-06-09 23:00:00,406,202,Thursday,23,608
476,16TH,2016-06-10 00:00:00,228,80,Friday,0,308
477,16TH,2016-06-10 01:00:00,14,8,Friday,1,22
478,16TH,2016-06-10 04:00:00,16,9,Friday,4,25
479,16TH,2016-06-10 05:00:00,73,107,Friday,5,180
480,16TH,2016-06-10 06:00:00,203,416,Friday,6,619
481,16TH,2016-06-10 07:00:00,508,920,Friday,7,1428
482,16TH,2016-06-10 08:00:00,1135,1401,Friday,8,2536
483,16TH,2016-06-10 09:00:00,892,888,Friday,9,1780
484,16TH,2016-06-10 10:00:00,587,702,Friday,10,1289
485,16TH,2016-06-10 11:00:00,379,496,Friday,11,875
486,16TH,2016-06-10 12:00:00,420,460,Friday,12,880
487,16TH,2016-06-10 13:00:00,515,522,Friday,13,1037
488,16TH,2016-06-10 14:00:00,512,673,Friday,14,1185
489,16TH,2016-06-10 15:00:00,731,725,Friday,15,1456
490,16TH,2016-06-10 16:00:00,1104,930,Friday,16,2034
491,16TH,2016-06-10 17:00:00,1553,1595,Friday,17,3148
492,16TH,2016-06-10 18:00:00,1455,1456,Friday,18,2911
493,16TH,2016-06-10 19:00:00,787,760,Friday,19,1547
494,16TH,2016-06-10 20:00:00,520,379,Friday,20,899
495,16TH,2016-06-10 21:00:00,584,478,Friday,21,1062
496,16TH,2016-06-10 22:00:00,545,374,Friday,22,919
497,16TH,2016-06-10 23:00:00,469,263,Friday,23,732
498,16TH,2016-06-11 00:00:00,445,142,Saturday,0,587
499,16TH,2016-06-11 01:00:00,52,23,Saturday,1,75
500,16TH,2016-06-11 06:00:00,58,50,Saturday,6,108
501,16TH,2016-06-11 07:00:00,133,151,Saturday,7,284
502,16TH,2016-06-11 08:00:00,206,248,Saturday,8,454
503,16TH,2016-06-11 09:00:00,288,343,Saturday,9,631
504,16TH,2016-06-11 10:00:00,309,390,Saturday,10,699
505,16TH,2016-06-11 11:00:00,363,641,Saturday,11,1004
506,16TH,2016-06-11 12:00:00,415,592,Saturday,12,1007
507,16TH,2016-06-11 13:00:00,444,651,Saturday,13,1095
508,16TH,2016-06-11 14:00:00,524,648,Saturday,14,1172
509,16TH,2016-06-11 15:00:00,628,667,Saturday,15,1295
510,16TH,2016-06-11 16:00:00,591,682,Saturday,16,1273
511,16TH,2016-06-11 17:00:00,625,742,Saturday,17,1367
512,16TH,2016-06-11 18:00:00,698,637,Saturday,18,1335
513,16TH,2016-06-11 19:00:00,653,529,Saturday,19,1182
514,16TH,2016-06-11 20:00:00,541,429,Saturday,20,970
515,16TH,2016-06-11 21:00:00,449,422,Saturday,21,871
516,16TH,2016-06-11 22:00:00,548,277,Saturday,22,825
517,16TH,2016-06-11 23:00:00,553,324,Saturday,23,877
518,16TH,2016-06-12 00:00:00,410,152,Sunday,0,562
519,16TH,2016-06-12 01:00:00,50,34,Sunday,1,84
520,16TH,2016-06-12 07:00:00,1,1,Sunday,7,2
521,16TH,2016-06-12 08:00:00,113,146,Sunday,8,259
522,16TH,2016-06-12 09:00:00,201,261,Sunday,9,462
523,16TH,2016-06-12 10:00:00,217,364,Sunday,10,581
524,16TH,2016-06-12 11:00:00,276,447,Sunday,11,723
525,16TH,2016-06-12 12:00:00,373,469,Sunday,12,842
526,16TH,2016-06-12 13:00:00,408,544,Sunday,13,952
527,16TH,2016-06-12 14:00:00,415,496,Sunday,14,911
528,16TH,2016-06-12 15:00:00,455,524,Sunday,15,979
529,16TH,2016-06-12 16:00:00,460,489,Sunday,16,949
530,16TH,2016-06-12 17:00:00,450,498,Sunday,17,948
531,16TH,2016-06-12 18:00:00,429,433,Sunday,18,862
532,16TH,2016-06-12 19:00:00,480,417,Sunday,19,897
533,16TH,2016-06-12 20:00:00,382,286,Sunday,20,668
534,16TH,2016-06-12 21:00:00,394,214,Sunday,21,608
535,16TH,2016-06-12 22:00:00,306,225,Sunday,22,531
536,16TH,2016-06-12 23:00:00,212,139,Sunday,23,351
537,16TH,2016-06-13 00:00:00,136,80,Monday,0,216
538,16TH,2016-06-13 01:00:00,15,6,Monday,1,21
539,16TH,2016-06-13 04:00:00,14,11,Monday,4,25
540,16TH,2016-06-13 05:00:00,91,106,Monday,5,197
541,16TH,2016-06-13 06:00:00,229,364,Monday,6,593
542,16TH,2016-06-13 07:00:00,511,1001,Monday,7,1512
543,16TH,2016-06-13 08:00:00,1236,1509,Monday,8,2745
544,16TH,2016-06-13 09:00:00,939,1163,Monday,9,2102
545,16TH,2016-06-13 10:00:00,408,553,Monday,10,961
546,16TH,2016-06-13 11:00:00,341,423,Monday,11,764
547,16TH,2016-06-13 12:00:00,340,439,Monday,12,779
548,16TH,2016-06-13 13:00:00,400,448,Monday,13,848
549,16TH,2016-06-13 14:00:00,451,525,Monday,14,976
550,16TH,2016-06-13 15:00:00,630,557,Monday,15,1187
551,16TH,2016-06-13 16:00:00,1027,773,Monday,16,1800
552,16TH,2016-06-13 17:00:00,1675,1686,Monday,17,3361
553,16TH,2016-06-13 18:00:00,1606,1401,Monday,18,3007
554,16TH,2016-06-13 19:00:00,928,744,Monday,19,1672
555,16TH,2016-06-13 20:00:00,514,353,Monday,20,867
556,16TH,2016-06-13 21:00:00,706,350,Monday,21,1056
557,16TH,2016-06-13 22:00:00,475,349,Monday,22,824
558,16TH,2016-06-13 23:00:00,270,161,Monday,23,431
559,16TH,2016-06-14 00:00:00,124,61,Tuesday,0,185
560,16TH,2016-06-14 01:00:00,20,6,Tuesday,1,26
561,16TH,2016-06-14 04:00:00,15,17,Tuesday,4,32
562,16TH,2016-06-14 05:00:00,99,113,Tuesday,5,212
563,16TH,2016-06-14 06:00:00,201,473,Tuesday,6,674
564,16TH,2016-06-14 07:00:00,549,1017,Tuesday,7,1566
565,16TH,2016-06-14 08:00:00,1309,1542,Tuesday,8,2851
566,16TH,2016-06-14 09:00:00,984,1185,Tuesday,9,2169
567,16TH,2016-06-14 10:00:00,454,580,Tuesday,10,1034
568,16TH,2016-06-14 11:00:00,337,480,Tuesday,11,817
569,16TH,2016-06-14 12:00:00,369,421,Tuesday,12,790
570,16TH,2016-06-14 13:00:00,394,432,Tuesday,13,826
571,16TH,2016-06-14 14:00:00,503,482,Tuesday,14,985
572,16TH,2016-06-14 15:00:00,653,576,Tuesday,15,1229
573,16TH,2016-06-14 16:00:00,1003,747,Tuesday,16,1750
574,16TH,2016-06-14 17:00:00,1651,1420,Tuesday,17,3071
575,16TH,2016-06-14 18:00:00,1702,1327,Tuesday,18,3029
576,16TH,2016-06-14 19:00:00,1028,862,Tuesday,19,1890
577,16TH,2016-06-14 20:00:00,631,468,Tuesday,20,1099
578,16TH,2016-06-14 21:00:00,500,353,Tuesday,21,853
579,16TH,2016-06-14 22:00:00,444,262,Tuesday,22,706
580,16TH,2016-06-14 23:00:00,299,183,Tuesday,23,482
581,19TH,2016-06-01 04:00:00,10,10,Wednesday,4,20
582,19TH,2016-06-01 05:00:00,68,133,Wednesday,5,201
583,19TH,2016-06-01 06:00:00,242,621,Wednesday,6,863
584,19TH,2016-06-01 07:00:00,698,1843,Wednesday,7,2541
585,19TH,2016-06-01 08:00:00,1458,2587,Wednesday,8,4045
586,19TH,2016-06-01 09:00:00,1001,1390,Wednesday,9,2391
587,19TH,2016-06-01 10:00:00,510,459,Wednesday,10,969
588,19TH,2016-06-01 11:00:00,323,319,Wednesday,11,642
589,19TH,2016-06-01 12:00:00,434,277,Wednesday,12,711
590,19TH,2016-06-01 13:00:00,407,340,Wednesday,13,747
591,19TH,2016-06-01 14:00:00,402,336,Wednesday,14,738
592,19TH,2016-06-01 15:00:00,726,400,Wednesday,15,1126
593,19TH,2016-06-01 16:00:00,1464,691,Wednesday,16,2155
594,19TH,2016-06-01 17:00:00,2595,1168,Wednesday,17,3763
595,19TH,2016-06-01 18:00:00,1790,1305,Wednesday,18,3095
596,19TH,2016-06-01 19:00:00,742,702,Wednesday,19,1444
597,19TH,2016-06-01 20:00:00,365,407,Wednesday,20,772
598,19TH,2016-06-01 21:00:00,303,319,Wednesday,21,622
599,19TH,2016-06-01 22:00:00,199,243,Wednesday,22,442
600,19TH,2016-06-01 23:00:00,98,132,Wednesday,23,230
601,19TH,2016-06-02 00:00:00,75,58,Thursday,0,133
602,19TH,2016-06-02 04:00:00,6,22,Thursday,4,28
603,19TH,2016-06-02 05:00:00,86,126,Thursday,5,212
604,19TH,2016-06-02 06:00:00,258,604,Thursday,6,862
605,19TH,2016-06-02 07:00:00,688,1625,Thursday,7,2313
606,19TH,2016-06-02 08:00:00,1336,2639,Thursday,8,3975
607,19TH,2016-06-02 09:00:00,1056,1493,Thursday,9,2549
608,19TH,2016-06-02 10:00:00,501,562,Thursday,10,1063
609,19TH,2016-06-02 11:00:00,455,316,Thursday,11,771
610,19TH,2016-06-02 12:00:00,409,325,Thursday,12,734
611,19TH,2016-06-02 13:00:00,405,318,Thursday,13,723
612,19TH,2016-06-02 14:00:00,465,316,Thursday,14,781
613,19TH,2016-06-02 15:00:00,723,472,Thursday,15,1195
614,19TH,2016-06-02 16:00:00,1495,735,Thursday,16,2230
615,19TH,2016-06-02 17:00:00,2948,1454,Thursday,17,4402
616,19TH,2016-06-02 18:00:00,1549,1136,Thursday,18,2685
617,19TH,2016-06-02 19:00:00,703,590,Thursday,19,1293
618,19TH,2016-06-02 20:00:00,339,438,Thursday,20,777
619,19TH,2016-06-02 21:00:00,389,448,Thursday,21,837
620,19TH,2016-06-02 22:00:00,236,245,Thursday,22,481
621,19TH,2016-06-02 23:00:00,150,202,Thursday,23,352
622,19TH,2016-06-03 00:00:00,97,84,Friday,0,181
623,19TH,2016-06-03 01:00:00,36,2,Friday,1,38
624,19TH,2016-06-03 04:00:00,7,19,Friday,4,26
625,19TH,2016-06-03 05:00:00,71,109,Friday,5,180
626,19TH,2016-06-03 06:00:00,236,499,Friday,6,735
627,19TH,2016-06-03 07:00:00,618,1531,Friday,7,2149
628,19TH,2016-06-03 08:00:00,1213,2081,Friday,8,3294
629,19TH,2016-06-03 09:00:00,1106,1202,Friday,9,2308
630,19TH,2016-06-03 10:00:00,452,425,Friday,10,877
631,19TH,2016-06-03 11:00:00,372,348,Friday,11,720
632,19TH,2016-06-03 12:00:00,431,323,Friday,12,754
633,19TH,2016-06-03 13:00:00,422,418,Friday,13,840
634,19TH,2016-06-03 14:00:00,520,368,Friday,14,888
635,19TH,2016-06-03 15:00:00,792,483,Friday,15,1275
636,19TH,2016-06-03 16:00:00,1491,788,Friday,16,2279
637,19TH,2016-06-03 17:00:00,1989,1585,Friday,17,3574
638,19TH,2016-06-03 18:00:00,1324,2111,Friday,18,3435
639,19TH,2016-06-03 19:00:00,628,1607,Friday,19,2235
640,19TH,2016-06-03 20:00:00,538,850,Friday,20,1388
641,19TH,2016-06-03 21:00:00,887,516,Friday,21,1403
642,19TH,2016-06-03 22:00:00,903,361,Friday,22,1264
643,19TH,2016-06-03 23:00:00,707,220,Friday,23,927
644,19TH,2016-06-04 00:00:00,503,180,Saturday,0,683
645,19TH,2016-06-04 06:00:00,46,30,Saturday,6,76
646,19TH,2016-06-04 07:00:00,130,72,Saturday,7,202
647,19TH,2016-06-04 08:00:00,169,133,Saturday,8,302
648,19TH,2016-06-04 09:00:00,217,181,Saturday,9,398
649,19TH,2016-06-04 10:00:00,250,173,Saturday,10,423
650,19TH,2016-06-04 11:00:00,271,181,Saturday,11,452
651,19TH,2016-06-04 12:00:00,287,225,Saturday,12,512
652,19TH,2016-06-04 13:00:00,293,197,Saturday,13,490
653,19TH,2016-06-04 14:00:00,272,220,Saturday,14,492
654,19TH,2016-06-04 15:00:00,308,278,Saturday,15,586
655,19TH,2016-06-04 16:00:00,295,321,Saturday,16,616
656,19TH,2016-06-04 17:00:00,303,388,Saturday,17,691
657,19TH,2016-06-04 18:00:00,275,418,Saturday,18,693
658,19TH,2016-06-04 19:00:00,233,476,Saturday,19,709
659,19TH,2016-06-04 20:00:00,205,396,Saturday,20,601
660,19TH,2016-06-04 21:00:00,140,250,Saturday,21,390
661,19TH,2016-06-04 22:00:00,208,238,Saturday,22,446
662,19TH,2016-06-04 23:00:00,545,169,Saturday,23,714
663,19TH,2016-06-05 00:00:00,193,141,Sunday,0,334
664,19TH,2016-06-05 01:00:00,37,2,Sunday,1,39
665,19TH,2016-06-05 08:00:00,98,69,Sunday,8,167
666,19TH,2016-06-05 09:00:00,174,119,Sunday,9,293
667,19TH,2016-06-05 10:00:00,187,129,Sunday,10,316
668,19TH,2016-06-05 11:00:00,204,161,Sunday,11,365
669,19TH,2016-06-05 12:00:00,201,172,Sunday,12,373
670,19TH,2016-06-05 13:00:00,258,185,Sunday,13,443
671,19TH,2016-06-05 14:00:00,235,176,Sunday,14,411
672,19TH,2016-06-05 15:00:00,226,224,Sunday,15,450
673,19TH,2016-06-05 16:00:00,252,263,Sunday,16,515
674,19TH,2016-06-05 17:00:00,196,270,Sunday,17,466
675,19TH,2016-06-05 18:00:00,185,229,Sunday,18,414
676,19TH,2016-06-05 19:00:00,137,185,Sunday,19,322
677,19TH,2016-06-05 20:00:00,185,217,Sunday,20,402
678,19TH,2016-06-05 21:00:00,153,163,Sunday,21,316
679,19TH,2016-06-05 22:00:00,101,101,Sunday,22,202
680,19TH,2016-06-05 23:00:00,68,83,Sunday,23,151
681,19TH,2016-06-06 00:00:00,24,31,Monday,0,55
682,19TH,2016-06-06 01:00:00,11,1,Monday,1,12
683,19TH,2016-06-06 04:00:00,10,18,Monday,4,28
684,19TH,2016-06-06 05:00:00,77,94,Monday,5,171
685,19TH,2016-06-06 06:00:00,243,602,Monday,6,845
686,19TH,2016-06-06 07:00:00,676,1676,Monday,7,2352
687,19TH,2016-06-06 08:00:00,1351,2405,Monday,8,3756
688,19TH,2016-06-06 09:00:00,1023,1645,Monday,9,2668
689,19TH,2016-06-06 10:00:00,458,477,Monday,10,935
690,19TH,2016-06-06 11:00:00,335,299,Monday,11,634
691,19TH,2016-06-06 12:00:00,342,268,Monday,12,610
692,19TH,2016-06-06 13:00:00,481,288,Monday,13,769
693,19TH,2016-06-06 14:00:00,461,280,Monday,14,741
694,19TH,2016-06-06 15:00:00,663,411,Monday,15,1074
695,19TH,2016-06-06 16:00:00,1445,527,Monday,16,1972
696,19TH,2016-06-06 17:00:00,2619,1194,Monday,17,3813
697,19TH,2016-06-06 18:00:00,1693,1080,Monday,18,2773
698,19TH,2016-06-06 19:00:00,671,723,Monday,19,1394
699,19TH,2016-06-06 20:00:00,306,412,Monday,20,718
700,19TH,2016-06-06 21:00:00,214,282,Monday,21,496
701,19TH,2016-06-06 22:00:00,145,216,Monday,22,361
702,19TH,2016-06-06 23:00:00,84,127,Monday,23,211
703,19TH,2016-06-07 00:00:00,44,39,Tuesday,0,83
704,19TH,2016-06-07 04:00:00,10,22,Tuesday,4,32
705,19TH,2016-06-07 05:00:00,93,133,Tuesday,5,226
706,19TH,2016-06-07 06:00:00,254,627,Tuesday,6,881
707,19TH,2016-06-07 07:00:00,599,1705,Tuesday,7,2304
708,19TH,2016-06-07 08:00:00,1392,2887,Tuesday,8,4279
709,19TH,2016-06-07 09:00:00,1113,1691,Tuesday,9,2804
710,19TH,2016-06-07 10:00:00,487,556,Tuesday,10,1043
711,19TH,2016-06-07 11:00:00,770,282,Tuesday,11,1052
712,19TH,2016-06-07 12:00:00,506,278,Tuesday,12,784
713,19TH,2016-06-07 13:00:00,508,315,Tuesday,13,823
714,19TH,2016-06-07 14:00:00,442,359,Tuesday,14,801
715,19TH,2016-06-07 15:00:00,757,424,Tuesday,15,1181
716,19TH,2016-06-07 16:00:00,1465,696,Tuesday,16,2161
717,19TH,2016-06-07 17:00:00,2647,1205,Tuesday,17,3852
718,19TH,2016-06-07 18:00:00,1773,1265,Tuesday,18,3038
719,19TH,2016-06-07 19:00:00,717,636,Tuesday,19,1353
720,19TH,2016-06-07 20:00:00,324,419,Tuesday,20,743
721,19TH,2016-06-07 21:00:00,287,393,Tuesday,21,680
722,19TH,2016-06-07 22:00:00,203,231,Tuesday,22,434
723,19TH,2016-06-07 23:00:00,121,199,Tuesday,23,320
724,19TH,2016-06-08 00:00:00,94,93,Wednesday,0,187
725,19TH,2016-06-08 01:00:00,9,3,Wednesday,1,12
726,19TH,2016-06-08 04:00:00,12,16,Wednesday,4,28
727,19TH,2016-06-08 05:00:00,84,142,Wednesday,5,226
728,19TH,2016-06-08 06:00:00,259,586,Wednesday,6,845
729,19TH,2016-06-08 07:00:00,671,1686,Wednesday,7,2357
730,19TH,2016-06-08 08:00:00,1384,2476,Wednesday,8,3860
731,19TH,2016-06-08 09:00:00,1028,1479,Wednesday,9,2507
732,19TH,2016-06-08 10:00:00,517,569,Wednesday,10,1086
733,19TH,2016-06-08 11:00:00,380,306,Wednesday,11,686
734,19TH,2016-06-08 12:00:00,401,300,Wednesday,12,701
735,19TH,2016-06-08 13:00:00,524,361,Wednesday,13,885
736,19TH,2016-06-08 14:00:00,434,324,Wednesday,14,758
737,19TH,2016-06-08 15:00:00,718,441,Wednesday,15,1159
738,19TH,2016-06-08 16:00:00,1383,706,Wednesday,16,2089
739,19TH,2016-06-08 17:00:00,2879,1329,Wednesday,17,4208
740,19TH,2016-06-08 18:00:00,1699,1598,Wednesday,18,3297
741,19TH,2016-06-08 19:00:00,571,839,Wednesday,19,1410
742,19TH,2016-06-08 20:00:00,316,504,Wednesday,20,820
743,19TH,2016-06-08 21:00:00,333,524,Wednesday,21,857
744,19TH,2016-06-08 22:00:00,244,269,Wednesday,22,513
745,19TH,2016-06-08 23:00:00,578,180,Wednesday,23,758
746,19TH,2016-06-09 00:00:00,240,70,Thursday,0,310
747,19TH,2016-06-09 01:00:00,34,2,Thursday,1,36
748,19TH,2016-06-09 04:00:00,8,20,Thursday,4,28
749,19TH,2016-06-09 05:00:00,80,132,Thursday,5,212
750,19TH,2016-06-09 06:00:00,244,578,Thursday,6,822
751,19TH,2016-06-09 07:00:00,643,1532,Thursday,7,2175
752,19TH,2016-06-09 08:00:00,1344,2463,Thursday,8,3807
753,19TH,2016-06-09 09:00:00,1092,1537,Thursday,9,2629
754,19TH,2016-06-09 10:00:00,500,480,Thursday,10,980
755,19TH,2016-06-09 11:00:00,366,309,Thursday,11,675
756,19TH,2016-06-09 12:00:00,449,325,Thursday,12,774
757,19TH,2016-06-09 13:00:00,390,395,Thursday,13,785
758,19TH,2016-06-09 14:00:00,448,336,Thursday,14,784
759,19TH,2016-06-09 15:00:00,686,429,Thursday,15,1115
760,19TH,2016-06-09 16:00:00,1514,632,Thursday,16,2146
761,19TH,2016-06-09 17:00:00,2525,1182,Thursday,17,3707
762,19TH,2016-06-09 18:00:00,1651,1169,Thursday,18,2820
763,19TH,2016-06-09 19:00:00,689,679,Thursday,19,1368
764,19TH,2016-06-09 20:00:00,365,425,Thursday,20,790
765,19TH,2016-06-09 21:00:00,335,418,Thursday,21,753
766,19TH,2016-06-09 22:00:00,233,251,Thursday,22,484
767,19TH,2016-06-09 23:00:00,138,167,Thursday,23,305
768,19TH,2016-06-10 00:00:00,68,90,Friday,0,158
769,19TH,2016-06-10 04:00:00,9,10,Friday,4,19
770,19TH,2016-06-10 05:00:00,70,119,Friday,5,189
771,19TH,2016-06-10 06:00:00,225,492,Friday,6,717
772,19TH,2016-06-10 07:00:00,610,1304,Friday,7,1914
773,19TH,2016-06-10 08:00:00,1221,2023,Friday,8,3244
774,19TH,2016-06-10 09:00:00,925,1136,Friday,9,2061
775,19TH,2016-06-10 10:00:00,484,373,Friday,10,857
776,19TH,2016-06-10 11:00:00,386,339,Friday,11,725
777,19TH,2016-06-10 12:00:00,461,276,Friday,12,737
778,19TH,2016-06-10 13:00:00,436,321,Friday,13,757
779,19TH,2016-06-10 14:00:00,469,411,Friday,14,880
780,19TH,2016-06-10 15:00:00,740,508,Friday,15,1248
781,19TH,2016-06-10 16:00:00,1357,710,Friday,16,2067
782,19TH,2016-06-10 17:00:00,2242,1393,Friday,17,3635
783,19TH,2016-06-10 18:00:00,1232,1096,Friday,18,2328
784,19TH,2016-06-10 19:00:00,435,528,Friday,19,963
785,19TH,2016-06-10 20:00:00,256,299,Friday,20,555
786,19TH,2016-06-10 21:00:00,314,461,Friday,21,775
787,19TH,2016-06-10 22:00:00,328,297,Friday,22,625
788,19TH,2016-06-10 23:00:00,234,230,Friday,23,464
789,19TH,2016-06-11 00:00:00,181,121,Saturday,0,302
790,19TH,2016-06-11 06:00:00,33,24,Saturday,6,57
791,19TH,2016-06-11 07:00:00,118,76,Saturday,7,194
792,19TH,2016-06-11 08:00:00,166,80,Saturday,8,246
793,19TH,2016-06-11 09:00:00,217,142,Saturday,9,359
794,19TH,2016-06-11 10:00:00,229,165,Saturday,10,394
795,19TH,2016-06-11 11:00:00,250,164,Saturday,11,414
796,19TH,2016-06-11 12:00:00,280,241,Saturday,12,521
797,19TH,2016-06-11 13:00:00,282,248,Saturday,13,530
798,19TH,2016-06-11 14:00:00,341,232,Saturday,14,573
799,19TH,2016-06-11 15:00:00,323,273,Saturday,15,596
800,19TH,2016-06-11 16:00:00,290,274,Saturday,16,564
801,19TH,2016-06-11 17:00:00,304,319,Saturday,17,623
802,19TH,2016-06-11 18:00:00,270,382,Saturday,18,652
803,19TH,2016-06-11 19:00:00,265,499,Saturday,19,764
804,19TH,2016-06-11 20:00:00,198,508,Saturday,20,706
805,19TH,2016-06-11 21:00:00,216,299,Saturday,21,515
806,19TH,2016-06-11 22:00:00,202,296,Saturday,22,498
807,19TH,2016-06-11 23:00:00,527,205,Saturday,23,732
808,19TH,2016-06-12 00:00:00,223,92,Sunday,0,315
809,19TH,2016-06-12 08:00:00,80,55,Sunday,8,135
810,19TH,2016-06-12 09:00:00,171,100,Sunday,9,271
811,19TH,2016-06-12 10:00:00,177,129,Sunday,10,306
812,19TH,2016-06-12 11:00:00,202,169,Sunday,11,371
813,19TH,2016-06-12 12:00:00,237,161,Sunday,12,398
814,19TH,2016-06-12 13:00:00,239,165,Sunday,13,404
815,19TH,2016-06-12 14:00:00,225,204,Sunday,14,429
816,19TH,2016-06-12 15:00:00,246,209,Sunday,15,455
817,19TH,2016-06-12 16:00:00,222,256,Sunday,16,478
818,19TH,2016-06-12 17:00:00,205,270,Sunday,17,475
819,19TH,2016-06-12 18:00:00,179,231,Sunday,18,410
820,19TH,2016-06-12 19:00:00,183,184,Sunday,19,367
821,19TH,2016-06-12 20:00:00,138,203,Sunday,20,341
822,19TH,2016-06-12 21:00:00,112,194,Sunday,21,306
823,19TH,2016-06-12 22:00:00,120,117,Sunday,22,237
824,19TH,2016-06-12 23:00:00,74,92,Sunday,23,166
825,19TH,2016-06-13 00:00:00,32,68,Monday,0,100
826,19TH,2016-06-13 04:00:00,11,19,Monday,4,30
827,19TH,2016-06-13 05:00:00,76,129,Monday,5,205
828,19TH,2016-06-13 06:00:00,228,572,Monday,6,800
829,19TH,2016-06-13 07:00:00,681,1497,Monday,7,2178
830,19TH,2016-06-13 08:00:00,1404,2484,Monday,8,3888
831,19TH,2016-06-13 09:00:00,1057,1489,Monday,9,2546
832,19TH,2016-06-13 10:00:00,429,456,Monday,10,885
833,19TH,2016-06-13 11:00:00,322,297,Monday,11,619
834,19TH,2016-06-13 12:00:00,341,280,Monday,12,621
835,19TH,2016-06-13 13:00:00,346,297,Monday,13,643
836,19TH,2016-06-13 14:00:00,398,299,Monday,14,697
837,19TH,2016-06-13 15:00:00,660,417,Monday,15,1077
838,19TH,2016-06-13 16:00:00,1357,743,Monday,16,2100
839,19TH,2016-06-13 17:00:00,2830,1490,Monday,17,4320
840,19TH,2016-06-13 18:00:00,1690,1375,Monday,18,3065
841,19TH,2016-06-13 19:00:00,499,542,Monday,19,1041
842,19TH,2016-06-13 20:00:00,217,276,Monday,20,493
843,19TH,2016-06-13 21:00:00,476,400,Monday,21,876
844,19TH,2016-06-13 22:00:00,220,254,Monday,22,474
845,19TH,2016-06-13 23:00:00,117,145,Monday,23,262
846,19TH,2016-06-14 00:00:00,51,55,Tuesday,0,106
847,19TH,2016-06-14 04:00:00,15,16,Tuesday,4,31
848,19TH,2016-06-14 05:00:00,78,124,Tuesday,5,202
849,19TH,2016-06-14 06:00:00,268,602,Tuesday,6,870
850,19TH,2016-06-14 07:00:00,687,1635,Tuesday,7,2322
851,19TH,2016-06-14 08:00:00,1481,2644,Tuesday,8,4125
852,19TH,2016-06-14 09:00:00,1059,1497,Tuesday,9,2556
853,19TH,2016-06-14 10:00:00,501,487,Tuesday,10,988
854,19TH,2016-06-14 11:00:00,368,290,Tuesday,11,658
855,19TH,2016-06-14 12:00:00,361,333,Tuesday,12,694
856,19TH,2016-06-14 13:00:00,350,328,Tuesday,13,678
857,19TH,2016-06-14 14:00:00,420,287,Tuesday,14,707
858,19TH,2016-06-14 15:00:00,662,364,Tuesday,15,1026
859,19TH,2016-06-14 16:00:00,1476,666,Tuesday,16,2142
860,19TH,2016-06-14 17:00:00,2759,1322,Tuesday,17,4081
861,19TH,2016-06-14 18:00:00,1812,1334,Tuesday,18,3146
862,19TH,2016-06-14 19:00:00,732,725,Tuesday,19,1457
863,19TH,2016-06-14 20:00:00,327,429,Tuesday,20,756
864,19TH,2016-06-14 21:00:00,336,312,Tuesday,21,648
865,19TH,2016-06-14 22:00:00,242,310,Tuesday,22,552
866,19TH,2016-06-14 23:00:00,145,135,Tuesday,23,280
867,24TH,2016-06-01 01:00:00,8,16,Wednesday,1,24
868,24TH,2016-06-01 04:00:00,36,11,Wednesday,4,47
869,24TH,2016-06-01 05:00:00,163,109,Wednesday,5,272
870,24TH,2016-06-01 06:00:00,329,417,Wednesday,6,746
871,24TH,2016-06-01 07:00:00,1000,649,Wednesday,7,1649
872,24TH,2016-06-01 08:00:00,2283,669,Wednesday,8,2952
873,24TH,2016-06-01 09:00:00,1669,550,Wednesday,9,2219
874,24TH,2016-06-01 10:00:00,642,455,Wednesday,10,1097
875,24TH,2016-06-01 11:00:00,510,348,Wednesday,11,858
876,24TH,2016-06-01 12:00:00,449,436,Wednesday,12,885
877,24TH,2016-06-01 13:00:00,491,433,Wednesday,13,924
878,24TH,2016-06-01 14:00:00,433,518,Wednesday,14,951
879,24TH,2016-06-01 15:00:00,575,630,Wednesday,15,1205
880,24TH,2016-06-01 16:00:00,738,1068,Wednesday,16,1806
881,24TH,2016-06-01 17:00:00,924,1912,Wednesday,17,2836
882,24TH,2016-06-01 18:00:00,1009,1724,Wednesday,18,2733
883,24TH,2016-06-01 19:00:00,594,1008,Wednesday,19,1602
884,24TH,2016-06-01 20:00:00,380,600,Wednesday,20,980
885,24TH,2016-06-01 21:00:00,379,397,Wednesday,21,776
886,24TH,2016-06-01 22:00:00,263,371,Wednesday,22,634
887,24TH,2016-06-01 23:00:00,163,204,Wednesday,23,367
888,24TH,2016-06-02 00:00:00,85,88,Thursday,0,173
889,24TH,2016-06-02 01:00:00,14,14,Thursday,1,28
890,24TH,2016-06-02 05:00:00,147,122,Thursday,5,269
891,24TH,2016-06-02 06:00:00,342,404,Thursday,6,746
892,24TH,2016-06-02 07:00:00,859,623,Thursday,7,1482
893,24TH,2016-06-02 08:00:00,1886,674,Thursday,8,2560
894,24TH,2016-06-02 09:00:00,2075,522,Thursday,9,2597
895,24TH,2016-06-02 10:00:00,808,378,Thursday,10,1186
896,24TH,2016-06-02 11:00:00,466,409,Thursday,11,875
897,24TH,2016-06-02 12:00:00,474,404,Thursday,12,878
898,24TH,2016-06-02 13:00:00,451,441,Thursday,13,892
899,24TH,2016-06-02 14:00:00,474,586,Thursday,14,1060
900,24TH,2016-06-02 15:00:00,580,691,Thursday,15,1271
901,24TH,2016-06-02 16:00:00,778,979,Thursday,16,1757
902,24TH,2016-06-02 17:00:00,1094,1830,Thursday,17,2924
903,24TH,2016-06-02 18:00:00,975,1747,Thursday,18,2722
904,24TH,2016-06-02 19:00:00,525,901,Thursday,19,1426
905,24TH,2016-06-02 20:00:00,401,505,Thursday,20,906
906,24TH,2016-06-02 21:00:00,431,560,Thursday,21,991
907,24TH,2016-06-02 22:00:00,316,408,Thursday,22,724
908,24TH,2016-06-02 23:00:00,163,212,Thursday,23,375
909,24TH,2016-06-03 00:00:00,79,115,Friday,0,194
910,24TH,2016-06-03 01:00:00,14,29,Friday,1,43
911,24TH,2016-06-03 04:00:00,32,9,Friday,4,41
912,24TH,2016-06-03 05:00:00,127,110,Friday,5,237
913,24TH,2016-06-03 06:00:00,377,380,Friday,6,757
914,24TH,2016-06-03 07:00:00,840,583,Friday,7,1423
915,24TH,2016-06-03 08:00:00,2002,598,Friday,8,2600
916,24TH,2016-06-03 09:00:00,1550,635,Friday,9,2185
917,24TH,2016-06-03 10:00:00,778,417,Friday,10,1195
918,24TH,2016-06-03 11:00:00,548,458,Friday,11,1006
919,24TH,2016-06-03 12:00:00,485,467,Friday,12,952
920,24TH,2016-06-03 13:00:00,632,475,Friday,13,1107
921,24TH,2016-06-03 14:00:00,476,610,Friday,14,1086
922,24TH,2016-06-03 15:00:00,616,754,Friday,15,1370
923,24TH,2016-06-03 16:00:00,816,1170,Friday,16,1986
924,24TH,2016-06-03 17:00:00,931,1791,Friday,17,2722
925,24TH,2016-06-03 18:00:00,1052,1534,Friday,18,2586
926,24TH,2016-06-03 19:00:00,701,967,Friday,19,1668
927,24TH,2016-06-03 20:00:00,479,530,Friday,20,1009
928,24TH,2016-06-03 21:00:00,418,455,Friday,21,873
929,24TH,2016-06-03 22:00:00,344,433,Friday,22,777
930,24TH,2016-06-03 23:00:00,305,466,Friday,23,771
931,24TH,2016-06-04 00:00:00,182,227,Saturday,0,409
932,24TH,2016-06-04 01:00:00,22,44,Saturday,1,66
933,24TH,2016-06-04 05:00:00,3,3,Saturday,5,6
934,24TH,2016-06-04 06:00:00,92,56,Saturday,6,148
935,24TH,2016-06-04 07:00:00,177,165,Saturday,7,342
936,24TH,2016-06-04 08:00:00,320,224,Saturday,8,544
937,24TH,2016-06-04 09:00:00,348,337,Saturday,9,685
938,24TH,2016-06-04 10:00:00,452,382,Saturday,10,834
939,24TH,2016-06-04 11:00:00,517,529,Saturday,11,1046
940,24TH,2016-06-04 12:00:00,534,548,Saturday,12,1082
941,24TH,2016-06-04 13:00:00,603,535,Saturday,13,1138
942,24TH,2016-06-04 14:00:00,539,616,Saturday,14,1155
943,24TH,2016-06-04 15:00:00,551,607,Saturday,15,1158
944,24TH,2016-06-04 16:00:00,573,629,Saturday,16,1202
945,24TH,2016-06-04 17:00:00,548,663,Saturday,17,1211
946,24TH,2016-06-04 18:00:00,548,673,Saturday,18,1221
947,24TH,2016-06-04 19:00:00,493,540,Saturday,19,1033
948,24TH,2016-06-04 20:00:00,380,481,Saturday,20,861
949,24TH,2016-06-04 21:00:00,347,356,Saturday,21,703
950,24TH,2016-06-04 22:00:00,352,308,Saturday,22,660
951,24TH,2016-06-04 23:00:00,300,327,Saturday,23,627
952,24TH,2016-06-05 00:00:00,200,154,Sunday,0,354
953,24TH,2016-06-05 01:00:00,17,25,Sunday,1,42
954,24TH,2016-06-05 07:00:00,2,6,Sunday,7,8
955,24TH,2016-06-05 08:00:00,178,148,Sunday,8,326
956,24TH,2016-06-05 09:00:00,258,322,Sunday,9,580
957,24TH,2016-06-05 10:00:00,389,410,Sunday,10,799
958,24TH,2016-06-05 11:00:00,490,490,Sunday,11,980
959,24TH,2016-06-05 12:00:00,504,492,Sunday,12,996
960,24TH,2016-06-05 13:00:00,608,559,Sunday,13,1167
961,24TH,2016-06-05 14:00:00,550,551,Sunday,14,1101
962,24TH,2016-06-05 15:00:00,592,560,Sunday,15,1152
963,24TH,2016-06-05 16:00:00,530,545,Sunday,16,1075
964,24TH,2016-06-05 17:00:00,379,575,Sunday,17,954
965,24TH,2016-06-05 18:00:00,292,434,Sunday,18,726
966,24TH,2016-06-05 19:00:00,341,320,Sunday,19,661
967,24TH,2016-06-05 20:00:00,305,356,Sunday,20,661
968,24TH,2016-06-05 21:00:00,289,277,Sunday,21,566
969,24TH,2016-06-05 22:00:00,190,206,Sunday,22,396
970,24TH,2016-06-05 23:00:00,106,166,Sunday,23,272
971,24TH,2016-06-06 00:00:00,53,61,Monday,0,114
972,24TH,2016-06-06 01:00:00,9,8,Monday,1,17
973,24TH,2016-06-06 04:00:00,38,3,Monday,4,41
974,24TH,2016-06-06 05:00:00,138,101,Monday,5,239
975,24TH,2016-06-06 06:00:00,340,396,Monday,6,736
976,24TH,2016-06-06 07:00:00,839,563,Monday,7,1402
977,24TH,2016-06-06 08:00:00,2240,632,Monday,8,2872
978,24TH,2016-06-06 09:00:00,1785,486,Monday,9,2271
979,24TH,2016-06-06 10:00:00,617,417,Monday,10,1034
980,24TH,2016-06-06 11:00:00,430,321,Monday,11,751
981,24TH,2016-06-06 12:00:00,443,390,Monday,12,833
982,24TH,2016-06-06 13:00:00,410,537,Monday,13,947
983,24TH,2016-06-06 14:00:00,454,539,Monday,14,993
984,24TH,2016-06-06 15:00:00,541,614,Monday,15,1155
985,24TH,2016-06-06 16:00:00,843,948,Monday,16,1791
986,24TH,2016-06-06 17:00:00,908,1806,Monday,17,2714
987,24TH,2016-06-06 18:00:00,861,1744,Monday,18,2605
988,24TH,2016-06-06 19:00:00,538,951,Monday,19,1489
989,24TH,2016-06-06 20:00:00,350,558,Monday,20,908
990,24TH,2016-06-06 21:00:00,294,429,Monday,21,723
991,24TH,2016-06-06 22:00:00,233,300,Monday,22,533
992,24TH,2016-06-06 23:00:00,113,200,Monday,23,313
993,24TH,2016-06-07 00:00:00,77,103,Tuesday,0,180
994,24TH,2016-06-07 01:00:00,5,11,Tuesday,1,16
995,24TH,2016-06-07 04:00:00,35,8,Tuesday,4,43
996,24TH,2016-06-07 05:00:00,155,112,Tuesday,5,267
997,24TH,2016-06-07 06:00:00,349,415,Tuesday,6,764
998,24TH,2016-06-07 07:00:00,937,604,Tuesday,7,1541
999,24TH,2016-06-07 08:00:00,2235,658,Tuesday,8,2893
1000,24TH,2016-06-07 09:00:00,1882,570,Tuesday,9,2452
1001,24TH,2016-06-07 10:00:00,700,386,Tuesday,10,1086
1002,24TH,2016-06-07 11:00:00,503,368,Tuesday,11,871
1003,24TH,2016-06-07 12:00:00,443,404,Tuesday,12,847
1004,24TH,2016-06-07 13:00:00,445,420,Tuesday,13,865
1005,24TH,2016-06-07 14:00:00,430,567,Tuesday,14,997
1006,24TH,2016-06-07 15:00:00,627,734,Tuesday,15,1361
1007,24TH,2016-06-07 16:00:00,827,1046,Tuesday,16,1873
1008,24TH,2016-06-07 17:00:00,1021,1768,Tuesday,17,2789
1009,24TH,2016-06-07 18:00:00,948,1695,Tuesday,18,2643
1010,24TH,2016-06-07 19:00:00,596,1080,Tuesday,19,1676
1011,24TH,2016-06-07 20:00:00,376,569,Tuesday,20,945
1012,24TH,2016-06-07 21:00:00,307,512,Tuesday,21,819
1013,24TH,2016-06-07 22:00:00,251,354,Tuesday,22,605
1014,24TH,2016-06-07 23:00:00,131,255,Tuesday,23,386
1015,24TH,2016-06-08 00:00:00,87,93,Wednesday,0,180
1016,24TH,2016-06-08 01:00:00,19,11,Wednesday,1,30
1017,24TH,2016-06-08 04:00:00,44,8,Wednesday,4,52
1018,24TH,2016-06-08 05:00:00,140,113,Wednesday,5,253
1019,24TH,2016-06-08 06:00:00,341,414,Wednesday,6,755
1020,24TH,2016-06-08 07:00:00,1022,590,Wednesday,7,1612
1021,24TH,2016-06-08 08:00:00,2188,666,Wednesday,8,2854
1022,24TH,2016-06-08 09:00:00,1798,517,Wednesday,9,2315
1023,24TH,2016-06-08 10:00:00,748,441,Wednesday,10,1189
1024,24TH,2016-06-08 11:00:00,494,409,Wednesday,11,903
1025,24TH,2016-06-08 12:00:00,461,400,Wednesday,12,861
1026,24TH,2016-06-08 13:00:00,489,462,Wednesday,13,951
1027,24TH,2016-06-08 14:00:00,501,564,Wednesday,14,1065
1028,24TH,2016-06-08 15:00:00,545,730,Wednesday,15,1275
1029,24TH,2016-06-08 16:00:00,794,1005,Wednesday,16,1799
1030,24TH,2016-06-08 17:00:00,987,1929,Wednesday,17,2916
1031,24TH,2016-06-08 18:00:00,983,1883,Wednesday,18,2866
1032,24TH,2016-06-08 19:00:00,519,915,Wednesday,19,1434
1033,24TH,2016-06-08 20:00:00,441,535,Wednesday,20,976
1034,24TH,2016-06-08 21:00:00,456,536,Wednesday,21,992
1035,24TH,2016-06-08 22:00:00,264,401,Wednesday,22,665
1036,24TH,2016-06-08 23:00:00,169,272,Wednesday,23,441
1037,24TH,2016-06-09 00:00:00,113,111,Thursday,0,224
1038,24TH,2016-06-09 01:00:00,14,20,Thursday,1,34
1039,24TH,2016-06-09 04:00:00,34,9,Thursday,4,43
1040,24TH,2016-06-09 05:00:00,132,100,Thursday,5,232
1041,24TH,2016-06-09 06:00:00,347,413,Thursday,6,760
1042,24TH,2016-06-09 07:00:00,895,597,Thursday,7,1492
1043,24TH,2016-06-09 08:00:00,2184,656,Thursday,8,2840
1044,24TH,2016-06-09 09:00:00,1788,501,Thursday,9,2289
1045,24TH,2016-06-09 10:00:00,742,427,Thursday,10,1169
1046,24TH,2016-06-09 11:00:00,507,382,Thursday,11,889
1047,24TH,2016-06-09 12:00:00,442,382,Thursday,12,824
1048,24TH,2016-06-09 13:00:00,465,485,Thursday,13,950
1049,24TH,2016-06-09 14:00:00,433,543,Thursday,14,976
1050,24TH,2016-06-09 15:00:00,557,649,Thursday,15,1206
1051,24TH,2016-06-09 16:00:00,763,1034,Thursday,16,1797
1052,24TH,2016-06-09 17:00:00,945,1797,Thursday,17,2742
1053,24TH,2016-06-09 18:00:00,1001,2022,Thursday,18,3023
1054,24TH,2016-06-09 19:00:00,633,1019,Thursday,19,1652
1055,24TH,2016-06-09 20:00:00,369,570,Thursday,20,939
1056,24TH,2016-06-09 21:00:00,386,538,Thursday,21,924
1057,24TH,2016-06-09 22:00:00,273,404,Thursday,22,677
1058,24TH,2016-06-09 23:00:00,166,266,Thursday,23,432
1059,24TH,2016-06-10 00:00:00,93,124,Friday,0,217
1060,24TH,2016-06-10 01:00:00,14,23,Friday,1,37
1061,24TH,2016-06-10 04:00:00,27,3,Friday,4,30
1062,24TH,2016-06-10 05:00:00,120,86,Friday,5,206
1063,24TH,2016-06-10 06:00:00,334,384,Friday,6,718
1064,24TH,2016-06-10 07:00:00,902,571,Friday,7,1473
1065,24TH,2016-06-10 08:00:00,1853,604,Friday,8,2457
1066,24TH,2016-06-10 09:00:00,1728,534,Friday,9,2262
1067,24TH,2016-06-10 10:00:00,748,511,Friday,10,1259
1068,24TH,2016-06-10 11:00:00,507,387,Friday,11,894
1069,24TH,2016-06-10 12:00:00,555,421,Friday,12,976
1070,24TH,2016-06-10 13:00:00,478,529,Friday,13,1007
1071,24TH,2016-06-10 14:00:00,528,642,Friday,14,1170
1072,24TH,2016-06-10 15:00:00,605,770,Friday,15,1375
1073,24TH,2016-06-10 16:00:00,846,1178,Friday,16,2024
1074,24TH,2016-06-10 17:00:00,940,1793,Friday,17,2733
1075,24TH,2016-06-10 18:00:00,1001,1689,Friday,18,2690
1076,24TH,2016-06-10 19:00:00,585,814,Friday,19,1399
1077,24TH,2016-06-10 20:00:00,357,417,Friday,20,774
1078,24TH,2016-06-10 21:00:00,370,506,Friday,21,876
1079,24TH,2016-06-10 22:00:00,386,439,Friday,22,825
1080,24TH,2016-06-10 23:00:00,314,320,Friday,23,634
1081,24TH,2016-06-11 00:00:00,223,182,Saturday,0,405
1082,24TH,2016-06-11 01:00:00,10,27,Saturday,1,37
1083,24TH,2016-06-11 06:00:00,104,65,Saturday,6,169
1084,24TH,2016-06-11 07:00:00,181,164,Saturday,7,345
1085,24TH,2016-06-11 08:00:00,314,211,Saturday,8,525
1086,24TH,2016-06-11 09:00:00,355,326,Saturday,9,681
1087,24TH,2016-06-11 10:00:00,458,410,Saturday,10,868
1088,24TH,2016-06-11 11:00:00,519,470,Saturday,11,989
1089,24TH,2016-06-11 12:00:00,544,497,Saturday,12,1041
1090,24TH,2016-06-11 13:00:00,538,522,Saturday,13,1060
1091,24TH,2016-06-11 14:00:00,591,567,Saturday,14,1158
1092,24TH,2016-06-11 15:00:00,615,507,Saturday,15,1122
1093,24TH,2016-06-11 16:00:00,509,651,Saturday,16,1160
1094,24TH,2016-06-11 17:00:00,475,700,Saturday,17,1175
1095,24TH,2016-06-11 18:00:00,491,665,Saturday,18,1156
1096,24TH,2016-06-11 19:00:00,459,512,Saturday,19,971
1097,24TH,2016-06-11 20:00:00,352,406,Saturday,20,758
1098,24TH,2016-06-11 21:00:00,325,396,Saturday,21,721
1099,24TH,2016-06-11 22:00:00,325,270,Saturday,22,595
1100,24TH,2016-06-11 23:00:00,225,330,Saturday,23,555
1101,24TH,2016-06-12 00:00:00,174,189,Sunday,0,363
1102,24TH,2016-06-12 01:00:00,18,33,Sunday,1,51
1103,24TH,2016-06-12 07:00:00,1,2,Sunday,7,3
1104,24TH,2016-06-12 08:00:00,140,104,Sunday,8,244
1105,24TH,2016-06-12 09:00:00,270,201,Sunday,9,471
1106,24TH,2016-06-12 10:00:00,336,305,Sunday,10,641
1107,24TH,2016-06-12 11:00:00,420,324,Sunday,11,744
1108,24TH,2016-06-12 12:00:00,485,359,Sunday,12,844
1109,24TH,2016-06-12 13:00:00,483,483,Sunday,13,966
1110,24TH,2016-06-12 14:00:00,424,451,Sunday,14,875
1111,24TH,2016-06-12 15:00:00,458,420,Sunday,15,878
1112,24TH,2016-06-12 16:00:00,414,538,Sunday,16,952
1113,24TH,2016-06-12 17:00:00,393,557,Sunday,17,950
1114,24TH,2016-06-12 18:00:00,331,490,Sunday,18,821
1115,24TH,2016-06-12 19:00:00,316,379,Sunday,19,695
1116,24TH,2016-06-12 20:00:00,272,295,Sunday,20,567
1117,24TH,2016-06-12 21:00:00,259,309,Sunday,21,568
1118,24TH,2016-06-12 22:00:00,198,280,Sunday,22,478
1119,24TH,2016-06-12 23:00:00,98,126,Sunday,23,224
1120,24TH,2016-06-13 00:00:00,70,100,Monday,0,170
1121,24TH,2016-06-13 01:00:00,7,8,Monday,1,15
1122,24TH,2016-06-13 04:00:00,29,8,Monday,4,37
1123,24TH,2016-06-13 05:00:00,139,105,Monday,5,244
1124,24TH,2016-06-13 06:00:00,329,375,Monday,6,704
1125,24TH,2016-06-13 07:00:00,862,645,Monday,7,1507
1126,24TH,2016-06-13 08:00:00,2208,696,Monday,8,2904
1127,24TH,2016-06-13 09:00:00,1788,555,Monday,9,2343
1128,24TH,2016-06-13 10:00:00,717,336,Monday,10,1053
1129,24TH,2016-06-13 11:00:00,402,323,Monday,11,725
1130,24TH,2016-06-13 12:00:00,418,392,Monday,12,810
1131,24TH,2016-06-13 13:00:00,445,456,Monday,13,901
1132,24TH,2016-06-13 14:00:00,493,518,Monday,14,1011
1133,24TH,2016-06-13 15:00:00,523,571,Monday,15,1094
1134,24TH,2016-06-13 16:00:00,847,1009,Monday,16,1856
1135,24TH,2016-06-13 17:00:00,1065,2092,Monday,17,3157
1136,24TH,2016-06-13 18:00:00,926,1606,Monday,18,2532
1137,24TH,2016-06-13 19:00:00,576,863,Monday,19,1439
1138,24TH,2016-06-13 20:00:00,321,419,Monday,20,740
1139,24TH,2016-06-13 21:00:00,372,551,Monday,21,923
1140,24TH,2016-06-13 22:00:00,272,464,Monday,22,736
1141,24TH,2016-06-13 23:00:00,149,216,Monday,23,365
1142,24TH,2016-06-14 00:00:00,92,85,Tuesday,0,177
1143,24TH,2016-06-14 01:00:00,10,7,Tuesday,1,17
1144,24TH,2016-06-14 03:00:00,1,1,Tuesday,3,2
1145,24TH,2016-06-14 04:00:00,40,7,Tuesday,4,47
1146,24TH,2016-06-14 05:00:00,132,110,Tuesday,5,242
1147,24TH,2016-06-14 06:00:00,367,412,Tuesday,6,779
1148,24TH,2016-06-14 07:00:00,938,638,Tuesday,7,1576
1149,24TH,2016-06-14 08:00:00,2414,719,Tuesday,8,3133
1150,24TH,2016-06-14 09:00:00,1736,630,Tuesday,9,2366
1151,24TH,2016-06-14 10:00:00,740,367,Tuesday,10,1107
1152,24TH,2016-06-14 11:00:00,439,385,Tuesday,11,824
1153,24TH,2016-06-14 12:00:00,405,406,Tuesday,12,811
1154,24TH,2016-06-14 13:00:00,471,431,Tuesday,13,902
1155,24TH,2016-06-14 14:00:00,433,568,Tuesday,14,1001
1156,24TH,2016-06-14 15:00:00,612,655,Tuesday,15,1267
1157,24TH,2016-06-14 16:00:00,762,1028,Tuesday,16,1790
1158,24TH,2016-06-14 17:00:00,1057,1893,Tuesday,17,2950
1159,24TH,2016-06-14 18:00:00,1007,1868,Tuesday,18,2875
1160,24TH,2016-06-14 19:00:00,580,1160,Tuesday,19,1740
1161,24TH,2016-06-14 20:00:00,444,578,Tuesday,20,1022
1162,24TH,2016-06-14 21:00:00,366,441,Tuesday,21,807
1163,24TH,2016-06-14 22:00:00,279,380,Tuesday,22,659
1164,24TH,2016-06-14 23:00:00,180,273,Tuesday,23,453
1165,ASHB,2016-06-01 04:00:00,7,1,Wednesday,4,8
1166,ASHB,2016-06-01 05:00:00,58,24,Wednesday,5,82
1167,ASHB,2016-06-01 06:00:00,200,84,Wednesday,6,284
1168,ASHB,2016-06-01 07:00:00,641,176,Wednesday,7,817
1169,ASHB,2016-06-01 08:00:00,1257,289,Wednesday,8,1546
1170,ASHB,2016-06-01 09:00:00,886,165,Wednesday,9,1051
1171,ASHB,2016-06-01 10:00:00,420,135,Wednesday,10,555
1172,ASHB,2016-06-01 11:00:00,246,149,Wednesday,11,395
1173,ASHB,2016-06-01 12:00:00,232,147,Wednesday,12,379
1174,ASHB,2016-06-01 13:00:00,188,159,Wednesday,13,347
1175,ASHB,2016-06-01 14:00:00,211,195,Wednesday,14,406
1176,ASHB,2016-06-01 15:00:00,192,326,Wednesday,15,518
1177,ASHB,2016-06-01 16:00:00,219,463,Wednesday,16,682
1178,ASHB,2016-06-01 17:00:00,313,793,Wednesday,17,1106
1179,ASHB,2016-06-01 18:00:00,336,1074,Wednesday,18,1410
1180,ASHB,2016-06-01 19:00:00,188,552,Wednesday,19,740
1181,ASHB,2016-06-01 20:00:00,109,412,Wednesday,20,521
1182,ASHB,2016-06-01 21:00:00,93,285,Wednesday,21,378
1183,ASHB,2016-06-01 22:00:00,67,164,Wednesday,22,231
1184,ASHB,2016-06-01 23:00:00,53,75,Wednesday,23,128
1185,ASHB,2016-06-02 00:00:00,24,90,Thursday,0,114
1186,ASHB,2016-06-02 04:00:00,9,4,Thursday,4,13
1187,ASHB,2016-06-02 05:00:00,56,26,Thursday,5,82
1188,ASHB,2016-06-02 06:00:00,194,81,Thursday,6,275
1189,ASHB,2016-06-02 07:00:00,611,180,Thursday,7,791
1190,ASHB,2016-06-02 08:00:00,1185,272,Thursday,8,1457
1191,ASHB,2016-06-02 09:00:00,945,185,Thursday,9,1130
1192,ASHB,2016-06-02 10:00:00,391,140,Thursday,10,531
1193,ASHB,2016-06-02 11:00:00,268,136,Thursday,11,404
1194,ASHB,2016-06-02 12:00:00,219,153,Thursday,12,372
1195,ASHB,2016-06-02 13:00:00,207,182,Thursday,13,389
1196,ASHB,2016-06-02 14:00:00,201,186,Thursday,14,387
1197,ASHB,2016-06-02 15:00:00,224,366,Thursday,15,590
1198,ASHB,2016-06-02 16:00:00,262,461,Thursday,16,723
1199,ASHB,2016-06-02 17:00:00,372,853,Thursday,17,1225
1200,ASHB,2016-06-02 18:00:00,392,1068,Thursday,18,1460
1201,ASHB,2016-06-02 19:00:00,212,499,Thursday,19,711
1202,ASHB,2016-06-02 20:00:00,97,294,Thursday,20,391
1203,ASHB,2016-06-02 21:00:00,109,388,Thursday,21,497
1204,ASHB,2016-06-02 22:00:00,76,229,Thursday,22,305
1205,ASHB,2016-06-02 23:00:00,47,133,Thursday,23,180
1206,ASHB,2016-06-03 00:00:00,25,63,Friday,0,88
1207,ASHB,2016-06-03 04:00:00,9,3,Friday,4,12
1208,ASHB,2016-06-03 05:00:00,54,20,Friday,5,74
1209,ASHB,2016-06-03 06:00:00,168,80,Friday,6,248
1210,ASHB,2016-06-03 07:00:00,524,171,Friday,7,695
1211,ASHB,2016-06-03 08:00:00,1100,250,Friday,8,1350
1212,ASHB,2016-06-03 09:00:00,864,189,Friday,9,1053
1213,ASHB,2016-06-03 10:00:00,414,152,Friday,10,566
1214,ASHB,2016-06-03 11:00:00,245,143,Friday,11,388
1215,ASHB,2016-06-03 12:00:00,217,180,Friday,12,397
1216,ASHB,2016-06-03 13:00:00,161,182,Friday,13,343
1217,ASHB,2016-06-03 14:00:00,184,263,Friday,14,447
1218,ASHB,2016-06-03 15:00:00,225,315,Friday,15,540
1219,ASHB,2016-06-03 16:00:00,247,490,Friday,16,737
1220,ASHB,2016-06-03 17:00:00,344,777,Friday,17,1121
1221,ASHB,2016-06-03 18:00:00,382,813,Friday,18,1195
1222,ASHB,2016-06-03 19:00:00,276,402,Friday,19,678
1223,ASHB,2016-06-03 20:00:00,164,280,Friday,20,444
1224,ASHB,2016-06-03 21:00:00,132,292,Friday,21,424
1225,ASHB,2016-06-03 22:00:00,109,168,Friday,22,277
1226,ASHB,2016-06-03 23:00:00,77,294,Friday,23,371
1227,ASHB,2016-06-04 00:00:00,46,151,Saturday,0,197
1228,ASHB,2016-06-04 06:00:00,24,21,Saturday,6,45
1229,ASHB,2016-06-04 07:00:00,54,40,Saturday,7,94
1230,ASHB,2016-06-04 08:00:00,107,57,Saturday,8,164
1231,ASHB,2016-06-04 09:00:00,171,95,Saturday,9,266
1232,ASHB,2016-06-04 10:00:00,214,123,Saturday,10,337
1233,ASHB,2016-06-04 11:00:00,227,141,Saturday,11,368
1234,ASHB,2016-06-04 12:00:00,234,151,Saturday,12,385
1235,ASHB,2016-06-04 13:00:00,220,214,Saturday,13,434
1236,ASHB,2016-06-04 14:00:00,215,212,Saturday,14,427
1237,ASHB,2016-06-04 15:00:00,208,208,Saturday,15,416
1238,ASHB,2016-06-04 16:00:00,196,203,Saturday,16,399
1239,ASHB,2016-06-04 17:00:00,216,232,Saturday,17,448
1240,ASHB,2016-06-04 18:00:00,260,219,Saturday,18,479
1241,ASHB,2016-06-04 19:00:00,196,171,Saturday,19,367
1242,ASHB,2016-06-04 20:00:00,131,135,Saturday,20,266
1243,ASHB,2016-06-04 21:00:00,109,129,Saturday,21,238
1244,ASHB,2016-06-04 22:00:00,85,164,Saturday,22,249
1245,ASHB,2016-06-04 23:00:00,79,147,Saturday,23,226
1246,ASHB,2016-06-05 00:00:00,44,133,Sunday,0,177
1247,ASHB,2016-06-05 08:00:00,60,49,Sunday,8,109
1248,ASHB,2016-06-05 09:00:00,135,78,Sunday,9,213
1249,ASHB,2016-06-05 10:00:00,139,127,Sunday,10,266
1250,ASHB,2016-06-05 11:00:00,166,137,Sunday,11,303
1251,ASHB,2016-06-05 12:00:00,193,147,Sunday,12,340
1252,ASHB,2016-06-05 13:00:00,235,174,Sunday,13,409
1253,ASHB,2016-06-05 14:00:00,206,135,Sunday,14,341
1254,ASHB,2016-06-05 15:00:00,188,163,Sunday,15,351
1255,ASHB,2016-06-05 16:00:00,174,182,Sunday,16,356
1256,ASHB,2016-06-05 17:00:00,125,215,Sunday,17,340
1257,ASHB,2016-06-05 18:00:00,125,191,Sunday,18,316
1258,ASHB,2016-06-05 19:00:00,114,159,Sunday,19,273
1259,ASHB,2016-06-05 20:00:00,110,170,Sunday,20,280
1260,ASHB,2016-06-05 21:00:00,66,125,Sunday,21,191
1261,ASHB,2016-06-05 22:00:00,57,108,Sunday,22,165
1262,ASHB,2016-06-05 23:00:00,35,86,Sunday,23,121
1263,ASHB,2016-06-06 00:00:00,16,50,Monday,0,66
1264,ASHB,2016-06-06 04:00:00,8,4,Monday,4,12
1265,ASHB,2016-06-06 05:00:00,54,16,Monday,5,70
1266,ASHB,2016-06-06 06:00:00,179,78,Monday,6,257
1267,ASHB,2016-06-06 07:00:00,598,177,Monday,7,775
1268,ASHB,2016-06-06 08:00:00,1203,274,Monday,8,1477
1269,ASHB,2016-06-06 09:00:00,981,173,Monday,9,1154
1270,ASHB,2016-06-06 10:00:00,370,135,Monday,10,505
1271,ASHB,2016-06-06 11:00:00,253,120,Monday,11,373
1272,ASHB,2016-06-06 12:00:00,171,121,Monday,12,292
1273,ASHB,2016-06-06 13:00:00,183,186,Monday,13,369
1274,ASHB,2016-06-06 14:00:00,197,227,Monday,14,424
1275,ASHB,2016-06-06 15:00:00,197,300,Monday,15,497
1276,ASHB,2016-06-06 16:00:00,271,485,Monday,16,756
1277,ASHB,2016-06-06 17:00:00,323,915,Monday,17,1238
1278,ASHB,2016-06-06 18:00:00,275,1022,Monday,18,1297
1279,ASHB,2016-06-06 19:00:00,150,510,Monday,19,660
1280,ASHB,2016-06-06 20:00:00,95,291,Monday,20,386
1281,ASHB,2016-06-06 21:00:00,89,261,Monday,21,350
1282,ASHB,2016-06-06 22:00:00,41,165,Monday,22,206
1283,ASHB,2016-06-06 23:00:00,29,136,Monday,23,165
1284,ASHB,2016-06-07 00:00:00,18,51,Tuesday,0,69
1285,ASHB,2016-06-07 04:00:00,11,6,Tuesday,4,17
1286,ASHB,2016-06-07 05:00:00,68,26,Tuesday,5,94
1287,ASHB,2016-06-07 06:00:00,191,79,Tuesday,6,270
1288,ASHB,2016-06-07 07:00:00,522,183,Tuesday,7,705
1289,ASHB,2016-06-07 08:00:00,1268,275,Tuesday,8,1543
1290,ASHB,2016-06-07 09:00:00,937,199,Tuesday,9,1136
1291,ASHB,2016-06-07 10:00:00,452,138,Tuesday,10,590
1292,ASHB,2016-06-07 11:00:00,234,110,Tuesday,11,344
1293,ASHB,2016-06-07 12:00:00,203,148,Tuesday,12,351
1294,ASHB,2016-06-07 13:00:00,193,178,Tuesday,13,371
1295,ASHB,2016-06-07 14:00:00,180,205,Tuesday,14,385
1296,ASHB,2016-06-07 15:00:00,199,260,Tuesday,15,459
1297,ASHB,2016-06-07 16:00:00,249,528,Tuesday,16,777
1298,ASHB,2016-06-07 17:00:00,378,966,Tuesday,17,1344
1299,ASHB,2016-06-07 18:00:00,374,962,Tuesday,18,1336
1300,ASHB,2016-06-07 19:00:00,199,537,Tuesday,19,736
1301,ASHB,2016-06-07 20:00:00,95,321,Tuesday,20,416
1302,ASHB,2016-06-07 21:00:00,85,251,Tuesday,21,336
1303,ASHB,2016-06-07 22:00:00,52,238,Tuesday,22,290
1304,ASHB,2016-06-07 23:00:00,36,152,Tuesday,23,188
1305,ASHB,2016-06-08 00:00:00,19,52,Wednesday,0,71
1306,ASHB,2016-06-08 01:00:00,7,17,Wednesday,1,24
1307,ASHB,2016-06-08 04:00:00,11,8,Wednesday,4,19
1308,ASHB,2016-06-08 05:00:00,59,21,Wednesday,5,80
1309,ASHB,2016-06-08 06:00:00,189,95,Wednesday,6,284
1310,ASHB,2016-06-08 07:00:00,585,178,Wednesday,7,763
1311,ASHB,2016-06-08 08:00:00,1218,284,Wednesday,8,1502
1312,ASHB,2016-06-08 09:00:00,952,173,Wednesday,9,1125
1313,ASHB,2016-06-08 10:00:00,419,152,Wednesday,10,571
1314,ASHB,2016-06-08 11:00:00,250,129,Wednesday,11,379
1315,ASHB,2016-06-08 12:00:00,238,129,Wednesday,12,367
1316,ASHB,2016-06-08 13:00:00,197,151,Wednesday,13,348
1317,ASHB,2016-06-08 14:00:00,188,212,Wednesday,14,400
1318,ASHB,2016-06-08 15:00:00,206,319,Wednesday,15,525
1319,ASHB,2016-06-08 16:00:00,267,530,Wednesday,16,797
1320,ASHB,2016-06-08 17:00:00,400,784,Wednesday,17,1184
1321,ASHB,2016-06-08 18:00:00,373,1078,Wednesday,18,1451
1322,ASHB,2016-06-08 19:00:00,169,466,Wednesday,19,635
1323,ASHB,2016-06-08 20:00:00,108,350,Wednesday,20,458
1324,ASHB,2016-06-08 21:00:00,117,384,Wednesday,21,501
1325,ASHB,2016-06-08 22:00:00,80,158,Wednesday,22,238
1326,ASHB,2016-06-08 23:00:00,47,175,Wednesday,23,222
1327,ASHB,2016-06-09 00:00:00,36,112,Thursday,0,148
1328,ASHB,2016-06-09 04:00:00,16,5,Thursday,4,21
1329,ASHB,2016-06-09 05:00:00,57,21,Thursday,5,78
1330,ASHB,2016-06-09 06:00:00,203,84,Thursday,6,287
1331,ASHB,2016-06-09 07:00:00,531,192,Thursday,7,723
1332,ASHB,2016-06-09 08:00:00,1189,292,Thursday,8,1481
1333,ASHB,2016-06-09 09:00:00,970,192,Thursday,9,1162
1334,ASHB,2016-06-09 10:00:00,425,134,Thursday,10,559
1335,ASHB,2016-06-09 11:00:00,267,164,Thursday,11,431
1336,ASHB,2016-06-09 12:00:00,243,133,Thursday,12,376
1337,ASHB,2016-06-09 13:00:00,201,164,Thursday,13,365
1338,ASHB,2016-06-09 14:00:00,176,185,Thursday,14,361
1339,ASHB,2016-06-09 15:00:00,201,282,Thursday,15,483
1340,ASHB,2016-06-09 16:00:00,264,466,Thursday,16,730
1341,ASHB,2016-06-09 17:00:00,352,741,Thursday,17,1093
1342,ASHB,2016-06-09 18:00:00,334,1039,Thursday,18,1373
1343,ASHB,2016-06-09 19:00:00,228,434,Thursday,19,662
1344,ASHB,2016-06-09 20:00:00,107,349,Thursday,20,456
1345,ASHB,2016-06-09 21:00:00,88,379,Thursday,21,467
1346,ASHB,2016-06-09 22:00:00,67,169,Thursday,22,236
1347,ASHB,2016-06-09 23:00:00,39,125,Thursday,23,164
1348,ASHB,2016-06-10 00:00:00,21,84,Friday,0,105
1349,ASHB,2016-06-10 04:00:00,10,8,Friday,4,18
1350,ASHB,2016-06-10 05:00:00,62,20,Friday,5,82
1351,ASHB,2016-06-10 06:00:00,169,70,Friday,6,239
1352,ASHB,2016-06-10 07:00:00,475,184,Friday,7,659
1353,ASHB,2016-06-10 08:00:00,1058,231,Friday,8,1289
1354,ASHB,2016-06-10 09:00:00,829,167,Friday,9,996
1355,ASHB,2016-06-10 10:00:00,407,127,Friday,10,534
1356,ASHB,2016-06-10 11:00:00,280,134,Friday,11,414
1357,ASHB,2016-06-10 12:00:00,231,179,Friday,12,410
1358,ASHB,2016-06-10 13:00:00,208,251,Friday,13,459
1359,ASHB,2016-06-10 14:00:00,193,246,Friday,14,439
1360,ASHB,2016-06-10 15:00:00,217,315,Friday,15,532
1361,ASHB,2016-06-10 16:00:00,267,503,Friday,16,770
1362,ASHB,2016-06-10 17:00:00,405,807,Friday,17,1212
1363,ASHB,2016-06-10 18:00:00,403,761,Friday,18,1164
1364,ASHB,2016-06-10 19:00:00,230,365,Friday,19,595
1365,ASHB,2016-06-10 20:00:00,122,218,Friday,20,340
1366,ASHB,2016-06-10 21:00:00,109,300,Friday,21,409
1367,ASHB,2016-06-10 22:00:00,103,236,Friday,22,339
1368,ASHB,2016-06-10 23:00:00,80,224,Friday,23,304
1369,ASHB,2016-06-11 00:00:00,31,160,Saturday,0,191
1370,ASHB,2016-06-11 06:00:00,26,23,Saturday,6,49
1371,ASHB,2016-06-11 07:00:00,71,37,Saturday,7,108
1372,ASHB,2016-06-11 08:00:00,110,65,Saturday,8,175
1373,ASHB,2016-06-11 09:00:00,157,77,Saturday,9,234
1374,ASHB,2016-06-11 10:00:00,178,138,Saturday,10,316
1375,ASHB,2016-06-11 11:00:00,229,156,Saturday,11,385
1376,ASHB,2016-06-11 12:00:00,224,158,Saturday,12,382
1377,ASHB,2016-06-11 13:00:00,279,149,Saturday,13,428
1378,ASHB,2016-06-11 14:00:00,250,143,Saturday,14,393
1379,ASHB,2016-06-11 15:00:00,222,196,Saturday,15,418
1380,ASHB,2016-06-11 16:00:00,207,198,Saturday,16,405
1381,ASHB,2016-06-11 17:00:00,218,240,Saturday,17,458
1382,ASHB,2016-06-11 18:00:00,214,224,Saturday,18,438
1383,ASHB,2016-06-11 19:00:00,169,155,Saturday,19,324
1384,ASHB,2016-06-11 20:00:00,84,179,Saturday,20,263
1385,ASHB,2016-06-11 21:00:00,137,167,Saturday,21,304
1386,ASHB,2016-06-11 22:00:00,74,141,Saturday,22,215
1387,ASHB,2016-06-11 23:00:00,77,152,Saturday,23,229
1388,ASHB,2016-06-12 00:00:00,32,130,Sunday,0,162
1389,ASHB,2016-06-12 08:00:00,45,48,Sunday,8,93
1390,ASHB,2016-06-12 09:00:00,120,74,Sunday,9,194
1391,ASHB,2016-06-12 10:00:00,137,99,Sunday,10,236
1392,ASHB,2016-06-12 11:00:00,183,133,Sunday,11,316
1393,ASHB,2016-06-12 12:00:00,189,143,Sunday,12,332
1394,ASHB,2016-06-12 13:00:00,207,117,Sunday,13,324
1395,ASHB,2016-06-12 14:00:00,216,139,Sunday,14,355
1396,ASHB,2016-06-12 15:00:00,139,165,Sunday,15,304
1397,ASHB,2016-06-12 16:00:00,124,166,Sunday,16,290
1398,ASHB,2016-06-12 17:00:00,161,180,Sunday,17,341
1399,ASHB,2016-06-12 18:00:00,161,158,Sunday,18,319
1400,ASHB,2016-06-12 19:00:00,140,149,Sunday,19,289
1401,ASHB,2016-06-12 20:00:00,107,158,Sunday,20,265
1402,ASHB,2016-06-12 21:00:00,72,132,Sunday,21,204
1403,ASHB,2016-06-12 22:00:00,52,125,Sunday,22,177
1404,ASHB,2016-06-12 23:00:00,33,118,Sunday,23,151
1405,ASHB,2016-06-13 00:00:00,16,60,Monday,0,76
1406,ASHB,2016-06-13 04:00:00,11,6,Monday,4,17
1407,ASHB,2016-06-13 05:00:00,56,18,Monday,5,74
1408,ASHB,2016-06-13 06:00:00,196,81,Monday,6,277
1409,ASHB,2016-06-13 07:00:00,594,194,Monday,7,788
1410,ASHB,2016-06-13 08:00:00,1203,262,Monday,8,1465
1411,ASHB,2016-06-13 09:00:00,965,183,Monday,9,1148
1412,ASHB,2016-06-13 10:00:00,387,117,Monday,10,504
1413,ASHB,2016-06-13 11:00:00,230,126,Monday,11,356
1414,ASHB,2016-06-13 12:00:00,184,157,Monday,12,341
1415,ASHB,2016-06-13 13:00:00,196,185,Monday,13,381
1416,ASHB,2016-06-13 14:00:00,183,178,Monday,14,361
1417,ASHB,2016-06-13 15:00:00,186,308,Monday,15,494
1418,ASHB,2016-06-13 16:00:00,244,494,Monday,16,738
1419,ASHB,2016-06-13 17:00:00,409,1008,Monday,17,1417
1420,ASHB,2016-06-13 18:00:00,336,856,Monday,18,1192
1421,ASHB,2016-06-13 19:00:00,123,540,Monday,19,663
1422,ASHB,2016-06-13 20:00:00,80,261,Monday,20,341
1423,ASHB,2016-06-13 21:00:00,86,386,Monday,21,472
1424,ASHB,2016-06-13 22:00:00,72,172,Monday,22,244
1425,ASHB,2016-06-13 23:00:00,49,157,Monday,23,206
1426,ASHB,2016-06-14 00:00:00,11,70,Tuesday,0,81
1427,ASHB,2016-06-14 04:00:00,9,7,Tuesday,4,16
1428,ASHB,2016-06-14 05:00:00,57,19,Tuesday,5,76
1429,ASHB,2016-06-14 06:00:00,201,77,Tuesday,6,278
1430,ASHB,2016-06-14 07:00:00,556,185,Tuesday,7,741
1431,ASHB,2016-06-14 08:00:00,1287,266,Tuesday,8,1553
1432,ASHB,2016-06-14 09:00:00,1026,154,Tuesday,9,1180
1433,ASHB,2016-06-14 10:00:00,393,131,Tuesday,10,524
1434,ASHB,2016-06-14 11:00:00,229,125,Tuesday,11,354
1435,ASHB,2016-06-14 12:00:00,230,145,Tuesday,12,375
1436,ASHB,2016-06-14 13:00:00,170,200,Tuesday,13,370
1437,ASHB,2016-06-14 14:00:00,168,200,Tuesday,14,368
1438,ASHB,2016-06-14 15:00:00,190,272,Tuesday,15,462
1439,ASHB,2016-06-14 16:00:00,258,489,Tuesday,16,747
1440,ASHB,2016-06-14 17:00:00,375,905,Tuesday,17,1280
1441,ASHB,2016-06-14 18:00:00,356,943,Tuesday,18,1299
1442,ASHB,2016-06-14 19:00:00,184,561,Tuesday,19,745
1443,ASHB,2016-06-14 20:00:00,116,391,Tuesday,20,507
1444,ASHB,2016-06-14 21:00:00,100,282,Tuesday,21,382
1445,ASHB,2016-06-14 22:00:00,55,206,Tuesday,22,261
1446,ASHB,2016-06-14 23:00:00,55,164,Tuesday,23,219
1447,BALB,2016-06-01 01:00:00,2,20,Wednesday,1,22
1448,BALB,2016-06-01 04:00:00,53,1,Wednesday,4,54
1449,BALB,2016-06-01 05:00:00,184,44,Wednesday,5,228
1450,BALB,2016-06-01 06:00:00,643,111,Wednesday,6,754
1451,BALB,2016-06-01 07:00:00,1642,262,Wednesday,7,1904
1452,BALB,2016-06-01 08:00:00,2314,329,Wednesday,8,2643
1453,BALB,2016-06-01 09:00:00,1391,210,Wednesday,9,1601
1454,BALB,2016-06-01 10:00:00,673,200,Wednesday,10,873
1455,BALB,2016-06-01 11:00:00,496,225,Wednesday,11,721
1456,BALB,2016-06-01 12:00:00,425,265,Wednesday,12,690
1457,BALB,2016-06-01 13:00:00,458,265,Wednesday,13,723
1458,BALB,2016-06-01 14:00:00,432,517,Wednesday,14,949
1459,BALB,2016-06-01 15:00:00,445,576,Wednesday,15,1021
1460,BALB,2016-06-01 16:00:00,499,1048,Wednesday,16,1547
1461,BALB,2016-06-01 17:00:00,500,1980,Wednesday,17,2480
1462,BALB,2016-06-01 18:00:00,434,1431,Wednesday,18,1865
1463,BALB,2016-06-01 19:00:00,227,809,Wednesday,19,1036
1464,BALB,2016-06-01 20:00:00,141,425,Wednesday,20,566
1465,BALB,2016-06-01 21:00:00,113,461,Wednesday,21,574
1466,BALB,2016-06-01 22:00:00,95,397,Wednesday,22,492
1467,BALB,2016-06-01 23:00:00,48,326,Wednesday,23,374
1468,BALB,2016-06-02 00:00:00,31,174,Thursday,0,205
1469,BALB,2016-06-02 01:00:00,3,25,Thursday,1,28
1470,BALB,2016-06-02 04:00:00,64,1,Thursday,4,65
1471,BALB,2016-06-02 05:00:00,197,44,Thursday,5,241
1472,BALB,2016-06-02 06:00:00,616,107,Thursday,6,723
1473,BALB,2016-06-02 07:00:00,1582,261,Thursday,7,1843
1474,BALB,2016-06-02 08:00:00,2004,339,Thursday,8,2343
1475,BALB,2016-06-02 09:00:00,1671,173,Thursday,9,1844
1476,BALB,2016-06-02 10:00:00,665,154,Thursday,10,819
1477,BALB,2016-06-02 11:00:00,507,148,Thursday,11,655
1478,BALB,2016-06-02 12:00:00,359,240,Thursday,12,599
1479,BALB,2016-06-02 13:00:00,423,286,Thursday,13,709
1480,BALB,2016-06-02 14:00:00,454,402,Thursday,14,856
1481,BALB,2016-06-02 15:00:00,435,582,Thursday,15,1017
1482,BALB,2016-06-02 16:00:00,469,1122,Thursday,16,1591
1483,BALB,2016-06-02 17:00:00,602,1807,Thursday,17,2409
1484,BALB,2016-06-02 18:00:00,405,1470,Thursday,18,1875
1485,BALB,2016-06-02 19:00:00,218,690,Thursday,19,908
1486,BALB,2016-06-02 20:00:00,116,366,Thursday,20,482
1487,BALB,2016-06-02 21:00:00,123,546,Thursday,21,669
1488,BALB,2016-06-02 22:00:00,101,458,Thursday,22,559
1489,BALB,2016-06-02 23:00:00,43,362,Thursday,23,405
1490,BALB,2016-06-03 00:00:00,20,190,Friday,0,210
1491,BALB,2016-06-03 01:00:00,1,30,Friday,1,31
1492,BALB,2016-06-03 04:00:00,57,2,Friday,4,59
1493,BALB,2016-06-03 05:00:00,193,34,Friday,5,227
1494,BALB,2016-06-03 06:00:00,583,112,Friday,6,695
1495,BALB,2016-06-03 07:00:00,1557,266,Friday,7,1823
1496,BALB,2016-06-03 08:00:00,2163,280,Friday,8,2443
1497,BALB,2016-06-03 09:00:00,1282,184,Friday,9,1466
1498,BALB,2016-06-03 10:00:00,706,147,Friday,10,853
1499,BALB,2016-06-03 11:00:00,507,179,Friday,11,686
1500,BALB,2016-06-03 12:00:00,412,262,Friday,12,674
1501,BALB,2016-06-03 13:00:00,446,284,Friday,13,730
1502,BALB,2016-06-03 14:00:00,461,480,Friday,14,941
1503,BALB,2016-06-03 15:00:00,467,643,Friday,15,1110
1504,BALB,2016-06-03 16:00:00,515,1121,Friday,16,1636
1505,BALB,2016-06-03 17:00:00,459,1653,Friday,17,2112
1506,BALB,2016-06-03 18:00:00,393,1262,Friday,18,1655
1507,BALB,2016-06-03 19:00:00,270,724,Friday,19,994
1508,BALB,2016-06-03 20:00:00,159,357,Friday,20,516
1509,BALB,2016-06-03 21:00:00,167,426,Friday,21,593
1510,BALB,2016-06-03 22:00:00,126,430,Friday,22,556
1511,BALB,2016-06-03 23:00:00,70,404,Friday,23,474
1512,BALB,2016-06-04 00:00:00,33,296,Saturday,0,329
1513,BALB,2016-06-04 01:00:00,4,38,Saturday,1,42
1514,BALB,2016-06-04 06:00:00,222,24,Saturday,6,246
1515,BALB,2016-06-04 07:00:00,442,88,Saturday,7,530
1516,BALB,2016-06-04 08:00:00,587,131,Saturday,8,718
1517,BALB,2016-06-04 09:00:00,515,138,Saturday,9,653
1518,BALB,2016-06-04 10:00:00,544,117,Saturday,10,661
1519,BALB,2016-06-04 11:00:00,471,189,Saturday,11,660
1520,BALB,2016-06-04 12:00:00,427,227,Saturday,12,654
1521,BALB,2016-06-04 13:00:00,427,224,Saturday,13,651
1522,BALB,2016-06-04 14:00:00,455,296,Saturday,14,751
1523,BALB,2016-06-04 15:00:00,379,378,Saturday,15,757
1524,BALB,2016-06-04 16:00:00,299,491,Saturday,16,790
1525,BALB,2016-06-04 17:00:00,272,592,Saturday,17,864
1526,BALB,2016-06-04 18:00:00,254,513,Saturday,18,767
1527,BALB,2016-06-04 19:00:00,158,377,Saturday,19,535
1528,BALB,2016-06-04 20:00:00,131,294,Saturday,20,425
1529,BALB,2016-06-04 21:00:00,133,335,Saturday,21,468
1530,BALB,2016-06-04 22:00:00,103,280,Saturday,22,383
1531,BALB,2016-06-04 23:00:00,47,329,Saturday,23,376
1532,BALB,2016-06-05 00:00:00,23,212,Sunday,0,235
1533,BALB,2016-06-05 01:00:00,4,21,Sunday,1,25
1534,BALB,2016-06-05 08:00:00,479,38,Sunday,8,517
1535,BALB,2016-06-05 09:00:00,423,98,Sunday,9,521
1536,BALB,2016-06-05 10:00:00,414,115,Sunday,10,529
1537,BALB,2016-06-05 11:00:00,410,135,Sunday,11,545
1538,BALB,2016-06-05 12:00:00,357,183,Sunday,12,540
1539,BALB,2016-06-05 13:00:00,343,194,Sunday,13,537
1540,BALB,2016-06-05 14:00:00,367,224,Sunday,14,591
1541,BALB,2016-06-05 15:00:00,354,298,Sunday,15,652
1542,BALB,2016-06-05 16:00:00,256,375,Sunday,16,631
1543,BALB,2016-06-05 17:00:00,197,503,Sunday,17,700
1544,BALB,2016-06-05 18:00:00,171,456,Sunday,18,627
1545,BALB,2016-06-05 19:00:00,113,329,Sunday,19,442
1546,BALB,2016-06-05 20:00:00,110,338,Sunday,20,448
1547,BALB,2016-06-05 21:00:00,113,275,Sunday,21,388
1548,BALB,2016-06-05 22:00:00,78,227,Sunday,22,305
1549,BALB,2016-06-05 23:00:00,35,220,Sunday,23,255
1550,BALB,2016-06-06 00:00:00,19,105,Monday,0,124
1551,BALB,2016-06-06 01:00:00,1,12,Monday,1,13
1552,BALB,2016-06-06 04:00:00,49,2,Monday,4,51
1553,BALB,2016-06-06 05:00:00,168,45,Monday,5,213
1554,BALB,2016-06-06 06:00:00,578,125,Monday,6,703
1555,BALB,2016-06-06 07:00:00,1582,276,Monday,7,1858
1556,BALB,2016-06-06 08:00:00,2316,317,Monday,8,2633
1557,BALB,2016-06-06 09:00:00,1355,200,Monday,9,1555
1558,BALB,2016-06-06 10:00:00,674,153,Monday,10,827
1559,BALB,2016-06-06 11:00:00,417,210,Monday,11,627
1560,BALB,2016-06-06 12:00:00,370,222,Monday,12,592
1561,BALB,2016-06-06 13:00:00,410,298,Monday,13,708
1562,BALB,2016-06-06 14:00:00,445,406,Monday,14,851
1563,BALB,2016-06-06 15:00:00,471,606,Monday,15,1077
1564,BALB,2016-06-06 16:00:00,407,1095,Monday,16,1502
1565,BALB,2016-06-06 17:00:00,495,1892,Monday,17,2387
1566,BALB,2016-06-06 18:00:00,411,1472,Monday,18,1883
1567,BALB,2016-06-06 19:00:00,200,746,Monday,19,946
1568,BALB,2016-06-06 20:00:00,102,446,Monday,20,548
1569,BALB,2016-06-06 21:00:00,118,398,Monday,21,516
1570,BALB,2016-06-06 22:00:00,100,389,Monday,22,489
1571,BALB,2016-06-06 23:00:00,52,302,Monday,23,354
1572,BALB,2016-06-07 00:00:00,23,178,Tuesday,0,201
1573,BALB,2016-06-07 01:00:00,3,23,Tuesday,1,26
1574,BALB,2016-06-07 04:00:00,58,1,Tuesday,4,59
1575,BALB,2016-06-07 05:00:00,196,42,Tuesday,5,238
1576,BALB,2016-06-07 06:00:00,618,135,Tuesday,6,753
1577,BALB,2016-06-07 07:00:00,1697,281,Tuesday,7,1978
1578,BALB,2016-06-07 08:00:00,2352,355,Tuesday,8,2707
1579,BALB,2016-06-07 09:00:00,1404,207,Tuesday,9,1611
1580,BALB,2016-06-07 10:00:00,728,164,Tuesday,10,892
1581,BALB,2016-06-07 11:00:00,421,197,Tuesday,11,618
1582,BALB,2016-06-07 12:00:00,403,254,Tuesday,12,657
1583,BALB,2016-06-07 13:00:00,401,292,Tuesday,13,693
1584,BALB,2016-06-07 14:00:00,421,460,Tuesday,14,881
1585,BALB,2016-06-07 15:00:00,500,628,Tuesday,15,1128
1586,BALB,2016-06-07 16:00:00,472,1126,Tuesday,16,1598
1587,BALB,2016-06-07 17:00:00,521,1884,Tuesday,17,2405
1588,BALB,2016-06-07 18:00:00,443,1326,Tuesday,18,1769
1589,BALB,2016-06-07 19:00:00,242,982,Tuesday,19,1224
1590,BALB,2016-06-07 20:00:00,143,428,Tuesday,20,571
1591,BALB,2016-06-07 21:00:00,96,455,Tuesday,21,551
1592,BALB,2016-06-07 22:00:00,121,435,Tuesday,22,556
1593,BALB,2016-06-07 23:00:00,53,341,Tuesday,23,394
1594,BALB,2016-06-08 00:00:00,24,204,Wednesday,0,228
1595,BALB,2016-06-08 01:00:00,2,29,Wednesday,1,31
1596,BALB,2016-06-08 04:00:00,58,1,Wednesday,4,59
1597,BALB,2016-06-08 05:00:00,182,43,Wednesday,5,225
1598,BALB,2016-06-08 06:00:00,653,143,Wednesday,6,796
1599,BALB,2016-06-08 07:00:00,1739,313,Wednesday,7,2052
1600,BALB,2016-06-08 08:00:00,2293,363,Wednesday,8,2656
1601,BALB,2016-06-08 09:00:00,1425,212,Wednesday,9,1637
1602,BALB,2016-06-08 10:00:00,676,165,Wednesday,10,841
1603,BALB,2016-06-08 11:00:00,484,188,Wednesday,11,672
1604,BALB,2016-06-08 12:00:00,414,236,Wednesday,12,650
1605,BALB,2016-06-08 13:00:00,448,284,Wednesday,13,732
1606,BALB,2016-06-08 14:00:00,413,372,Wednesday,14,785
1607,BALB,2016-06-08 15:00:00,475,596,Wednesday,15,1071
1608,BALB,2016-06-08 16:00:00,482,1179,Wednesday,16,1661
1609,BALB,2016-06-08 17:00:00,567,1815,Wednesday,17,2382
1610,BALB,2016-06-08 18:00:00,467,1499,Wednesday,18,1966
1611,BALB,2016-06-08 19:00:00,226,707,Wednesday,19,933
1612,BALB,2016-06-08 20:00:00,113,374,Wednesday,20,487
1613,BALB,2016-06-08 21:00:00,122,566,Wednesday,21,688
1614,BALB,2016-06-08 22:00:00,95,419,Wednesday,22,514
1615,BALB,2016-06-08 23:00:00,51,374,Wednesday,23,425
1616,BALB,2016-06-09 00:00:00,32,200,Thursday,0,232
1617,BALB,2016-06-09 01:00:00,1,32,Thursday,1,33
1618,BALB,2016-06-09 05:00:00,202,43,Thursday,5,245
1619,BALB,2016-06-09 06:00:00,603,134,Thursday,6,737
1620,BALB,2016-06-09 07:00:00,1649,275,Thursday,7,1924
1621,BALB,2016-06-09 08:00:00,2251,336,Thursday,8,2587
1622,BALB,2016-06-09 09:00:00,1370,225,Thursday,9,1595
1623,BALB,2016-06-09 10:00:00,663,181,Thursday,10,844
1624,BALB,2016-06-09 11:00:00,501,191,Thursday,11,692
1625,BALB,2016-06-09 12:00:00,377,230,Thursday,12,607
1626,BALB,2016-06-09 13:00:00,417,299,Thursday,13,716
1627,BALB,2016-06-09 14:00:00,481,392,Thursday,14,873
1628,BALB,2016-06-09 15:00:00,491,601,Thursday,15,1092
1629,BALB,2016-06-09 16:00:00,481,1158,Thursday,16,1639
1630,BALB,2016-06-09 17:00:00,560,1658,Thursday,17,2218
1631,BALB,2016-06-09 18:00:00,427,1660,Thursday,18,2087
1632,BALB,2016-06-09 19:00:00,248,672,Thursday,19,920
1633,BALB,2016-06-09 20:00:00,146,609,Thursday,20,755
1634,BALB,2016-06-09 21:00:00,159,489,Thursday,21,648
1635,BALB,2016-06-09 22:00:00,138,399,Thursday,22,537
1636,BALB,2016-06-09 23:00:00,54,381,Thursday,23,435
1637,BALB,2016-06-10 00:00:00,23,214,Friday,0,237
1638,BALB,2016-06-10 04:00:00,56,1,Friday,4,57
1639,BALB,2016-06-10 05:00:00,164,44,Friday,5,208
1640,BALB,2016-06-10 06:00:00,614,124,Friday,6,738
1641,BALB,2016-06-10 07:00:00,1586,268,Friday,7,1854
1642,BALB,2016-06-10 08:00:00,2193,358,Friday,8,2551
1643,BALB,2016-06-10 09:00:00,1368,173,Friday,9,1541
1644,BALB,2016-06-10 10:00:00,706,164,Friday,10,870
1645,BALB,2016-06-10 11:00:00,452,166,Friday,11,618
1646,BALB,2016-06-10 12:00:00,417,236,Friday,12,653
1647,BALB,2016-06-10 13:00:00,407,306,Friday,13,713
1648,BALB,2016-06-10 14:00:00,492,438,Friday,14,930
1649,BALB,2016-06-10 15:00:00,496,645,Friday,15,1141
1650,BALB,2016-06-10 16:00:00,508,1123,Friday,16,1631
1651,BALB,2016-06-10 17:00:00,601,1683,Friday,17,2284
1652,BALB,2016-06-10 18:00:00,443,1241,Friday,18,1684
1653,BALB,2016-06-10 19:00:00,241,607,Friday,19,848
1654,BALB,2016-06-10 20:00:00,147,301,Friday,20,448
1655,BALB,2016-06-10 21:00:00,151,587,Friday,21,738
1656,BALB,2016-06-10 22:00:00,133,427,Friday,22,560
1657,BALB,2016-06-10 23:00:00,68,425,Friday,23,493
1658,BALB,2016-06-11 00:00:00,29,284,Saturday,0,313
1659,BALB,2016-06-11 01:00:00,2,43,Saturday,1,45
1660,BALB,2016-06-11 05:00:00,3,4,Saturday,5,7
1661,BALB,2016-06-11 06:00:00,210,22,Saturday,6,232
1662,BALB,2016-06-11 07:00:00,424,66,Saturday,7,490
1663,BALB,2016-06-11 08:00:00,561,119,Saturday,8,680
1664,BALB,2016-06-11 09:00:00,499,137,Saturday,9,636
1665,BALB,2016-06-11 10:00:00,542,130,Saturday,10,672
1666,BALB,2016-06-11 11:00:00,513,136,Saturday,11,649
1667,BALB,2016-06-11 12:00:00,454,185,Saturday,12,639
1668,BALB,2016-06-11 13:00:00,470,243,Saturday,13,713
1669,BALB,2016-06-11 14:00:00,443,294,Saturday,14,737
1670,BALB,2016-06-11 15:00:00,426,410,Saturday,15,836
1671,BALB,2016-06-11 16:00:00,323,493,Saturday,16,816
1672,BALB,2016-06-11 17:00:00,263,668,Saturday,17,931
1673,BALB,2016-06-11 18:00:00,214,522,Saturday,18,736
1674,BALB,2016-06-11 19:00:00,210,413,Saturday,19,623
1675,BALB,2016-06-11 20:00:00,130,321,Saturday,20,451
1676,BALB,2016-06-11 21:00:00,136,373,Saturday,21,509
1677,BALB,2016-06-11 22:00:00,125,281,Saturday,22,406
1678,BALB,2016-06-11 23:00:00,65,331,Saturday,23,396
1679,BALB,2016-06-12 00:00:00,40,208,Sunday,0,248
1680,BALB,2016-06-12 01:00:00,2,33,Sunday,1,35
1681,BALB,2016-06-12 08:00:00,445,36,Sunday,8,481
1682,BALB,2016-06-12 09:00:00,381,108,Sunday,9,489
1683,BALB,2016-06-12 10:00:00,403,100,Sunday,10,503
1684,BALB,2016-06-12 11:00:00,348,128,Sunday,11,476
1685,BALB,2016-06-12 12:00:00,420,167,Sunday,12,587
1686,BALB,2016-06-12 13:00:00,379,190,Sunday,13,569
1687,BALB,2016-06-12 14:00:00,368,219,Sunday,14,587
1688,BALB,2016-06-12 15:00:00,320,280,Sunday,15,600
1689,BALB,2016-06-12 16:00:00,239,364,Sunday,16,603
1690,BALB,2016-06-12 17:00:00,224,506,Sunday,17,730
1691,BALB,2016-06-12 18:00:00,157,411,Sunday,18,568
1692,BALB,2016-06-12 19:00:00,166,358,Sunday,19,524
1693,BALB,2016-06-12 20:00:00,105,356,Sunday,20,461
1694,BALB,2016-06-12 21:00:00,101,341,Sunday,21,442
1695,BALB,2016-06-12 22:00:00,89,263,Sunday,22,352
1696,BALB,2016-06-12 23:00:00,51,208,Sunday,23,259
1697,BALB,2016-06-13 00:00:00,9,186,Monday,0,195
1698,BALB,2016-06-13 01:00:00,4,10,Monday,1,14
1699,BALB,2016-06-13 04:00:00,64,1,Monday,4,65
1700,BALB,2016-06-13 05:00:00,201,35,Monday,5,236
1701,BALB,2016-06-13 06:00:00,544,138,Monday,6,682
1702,BALB,2016-06-13 07:00:00,1659,402,Monday,7,2061
1703,BALB,2016-06-13 08:00:00,2244,598,Monday,8,2842
1704,BALB,2016-06-13 09:00:00,1504,319,Monday,9,1823
1705,BALB,2016-06-13 10:00:00,657,216,Monday,10,873
1706,BALB,2016-06-13 11:00:00,490,249,Monday,11,739
1707,BALB,2016-06-13 12:00:00,468,286,Monday,12,754
1708,BALB,2016-06-13 13:00:00,504,291,Monday,13,795
1709,BALB,2016-06-13 14:00:00,562,441,Monday,14,1003
1710,BALB,2016-06-13 15:00:00,566,638,Monday,15,1204
1711,BALB,2016-06-13 16:00:00,583,1228,Monday,16,1811
1712,BALB,2016-06-13 17:00:00,613,1829,Monday,17,2442
1713,BALB,2016-06-13 18:00:00,462,1554,Monday,18,2016
1714,BALB,2016-06-13 19:00:00,246,735,Monday,19,981
1715,BALB,2016-06-13 20:00:00,123,368,Monday,20,491
1716,BALB,2016-06-13 21:00:00,156,588,Monday,21,744
1717,BALB,2016-06-13 22:00:00,159,423,Monday,22,582
1718,BALB,2016-06-13 23:00:00,51,326,Monday,23,377
1719,BALB,2016-06-14 00:00:00,21,210,Tuesday,0,231
1720,BALB,2016-06-14 01:00:00,2,21,Tuesday,1,23
1721,BALB,2016-06-14 05:00:00,206,45,Tuesday,5,251
1722,BALB,2016-06-14 06:00:00,606,152,Tuesday,6,758
1723,BALB,2016-06-14 07:00:00,1741,373,Tuesday,7,2114
1724,BALB,2016-06-14 08:00:00,2417,598,Tuesday,8,3015
1725,BALB,2016-06-14 09:00:00,1448,332,Tuesday,9,1780
1726,BALB,2016-06-14 10:00:00,730,229,Tuesday,10,959
1727,BALB,2016-06-14 11:00:00,555,301,Tuesday,11,856
1728,BALB,2016-06-14 12:00:00,486,272,Tuesday,12,758
1729,BALB,2016-06-14 13:00:00,490,271,Tuesday,13,761
1730,BALB,2016-06-14 14:00:00,571,469,Tuesday,14,1040
1731,BALB,2016-06-14 15:00:00,554,605,Tuesday,15,1159
1732,BALB,2016-06-14 16:00:00,475,1127,Tuesday,16,1602
1733,BALB,2016-06-14 17:00:00,558,2057,Tuesday,17,2615
1734,BALB,2016-06-14 18:00:00,459,1576,Tuesday,18,2035
1735,BALB,2016-06-14 19:00:00,274,728,Tuesday,19,1002
1736,BALB,2016-06-14 20:00:00,182,516,Tuesday,20,698
1737,BALB,2016-06-14 21:00:00,164,442,Tuesday,21,606
1738,BALB,2016-06-14 22:00:00,135,453,Tuesday,22,588
1739,BALB,2016-06-14 23:00:00,44,372,Tuesday,23,416
1740,BAYF,2016-06-01 04:00:00,6,4,Wednesday,4,10
1741,BAYF,2016-06-01 05:00:00,202,41,Wednesday,5,243
1742,BAYF,2016-06-01 06:00:00,522,87,Wednesday,6,609
1743,BAYF,2016-06-01 07:00:00,918,182,Wednesday,7,1100
1744,BAYF,2016-06-01 08:00:00,1202,147,Wednesday,8,1349
1745,BAYF,2016-06-01 09:00:00,685,131,Wednesday,9,816
1746,BAYF,2016-06-01 10:00:00,377,158,Wednesday,10,535
1747,BAYF,2016-06-01 11:00:00,313,139,Wednesday,11,452
1748,BAYF,2016-06-01 12:00:00,204,199,Wednesday,12,403
1749,BAYF,2016-06-01 13:00:00,199,218,Wednesday,13,417
1750,BAYF,2016-06-01 14:00:00,210,236,Wednesday,14,446
1751,BAYF,2016-06-01 15:00:00,203,574,Wednesday,15,777
1752,BAYF,2016-06-01 16:00:00,223,669,Wednesday,16,892
1753,BAYF,2016-06-01 17:00:00,198,916,Wednesday,17,1114
1754,BAYF,2016-06-01 18:00:00,183,1090,Wednesday,18,1273
1755,BAYF,2016-06-01 19:00:00,130,487,Wednesday,19,617
1756,BAYF,2016-06-01 20:00:00,96,323,Wednesday,20,419
1757,BAYF,2016-06-01 21:00:00,87,220,Wednesday,21,307
1758,BAYF,2016-06-01 22:00:00,72,152,Wednesday,22,224
1759,BAYF,2016-06-01 23:00:00,47,117,Wednesday,23,164
1760,BAYF,2016-06-02 00:00:00,11,63,Thursday,0,74
1761,BAYF,2016-06-02 04:00:00,5,7,Thursday,4,12
1762,BAYF,2016-06-02 05:00:00,208,41,Thursday,5,249
1763,BAYF,2016-06-02 06:00:00,554,92,Thursday,6,646
1764,BAYF,2016-06-02 07:00:00,902,183,Thursday,7,1085
1765,BAYF,2016-06-02 08:00:00,1149,151,Thursday,8,1300
1766,BAYF,2016-06-02 09:00:00,781,142,Thursday,9,923
1767,BAYF,2016-06-02 10:00:00,331,152,Thursday,10,483
1768,BAYF,2016-06-02 11:00:00,197,140,Thursday,11,337
1769,BAYF,2016-06-02 12:00:00,212,195,Thursday,12,407
1770,BAYF,2016-06-02 13:00:00,206,200,Thursday,13,406
1771,BAYF,2016-06-02 14:00:00,208,273,Thursday,14,481
1772,BAYF,2016-06-02 15:00:00,205,428,Thursday,15,633
1773,BAYF,2016-06-02 16:00:00,245,632,Thursday,16,877
1774,BAYF,2016-06-02 17:00:00,247,1133,Thursday,17,1380
1775,BAYF,2016-06-02 18:00:00,168,987,Thursday,18,1155
1776,BAYF,2016-06-02 19:00:00,150,451,Thursday,19,601
1777,BAYF,2016-06-02 20:00:00,89,228,Thursday,20,317
1778,BAYF,2016-06-02 21:00:00,111,375,Thursday,21,486
1779,BAYF,2016-06-02 22:00:00,72,172,Thursday,22,244
1780,BAYF,2016-06-02 23:00:00,48,136,Thursday,23,184
1781,BAYF,2016-06-03 00:00:00,14,62,Friday,0,76
1782,BAYF,2016-06-03 01:00:00,6,8,Friday,1,14
1783,BAYF,2016-06-03 04:00:00,9,10,Friday,4,19
1784,BAYF,2016-06-03 05:00:00,188,39,Friday,5,227
1785,BAYF,2016-06-03 06:00:00,474,72,Friday,6,546
1786,BAYF,2016-06-03 07:00:00,866,169,Friday,7,1035
1787,BAYF,2016-06-03 08:00:00,999,119,Friday,8,1118
1788,BAYF,2016-06-03 09:00:00,639,137,Friday,9,776
1789,BAYF,2016-06-03 10:00:00,438,119,Friday,10,557
1790,BAYF,2016-06-03 11:00:00,215,140,Friday,11,355
1791,BAYF,2016-06-03 12:00:00,206,217,Friday,12,423
1792,BAYF,2016-06-03 13:00:00,227,202,Friday,13,429
1793,BAYF,2016-06-03 14:00:00,193,376,Friday,14,569
1794,BAYF,2016-06-03 15:00:00,234,419,Friday,15,653
1795,BAYF,2016-06-03 16:00:00,250,663,Friday,16,913
1796,BAYF,2016-06-03 17:00:00,207,931,Friday,17,1138
1797,BAYF,2016-06-03 18:00:00,209,817,Friday,18,1026
1798,BAYF,2016-06-03 19:00:00,169,445,Friday,19,614
1799,BAYF,2016-06-03 20:00:00,130,220,Friday,20,350
1800,BAYF,2016-06-03 21:00:00,115,237,Friday,21,352
1801,BAYF,2016-06-03 22:00:00,98,223,Friday,22,321
1802,BAYF,2016-06-03 23:00:00,60,145,Friday,23,205
1803,BAYF,2016-06-04 00:00:00,34,107,Saturday,0,141
1804,BAYF,2016-06-04 01:00:00,3,12,Saturday,1,15
1805,BAYF,2016-06-04 06:00:00,59,33,Saturday,6,92
1806,BAYF,2016-06-04 07:00:00,161,65,Saturday,7,226
1807,BAYF,2016-06-04 08:00:00,256,98,Saturday,8,354
1808,BAYF,2016-06-04 09:00:00,227,101,Saturday,9,328
1809,BAYF,2016-06-04 10:00:00,219,110,Saturday,10,329
1810,BAYF,2016-06-04 11:00:00,208,110,Saturday,11,318
1811,BAYF,2016-06-04 12:00:00,175,149,Saturday,12,324
1812,BAYF,2016-06-04 13:00:00,218,151,Saturday,13,369
1813,BAYF,2016-06-04 14:00:00,220,171,Saturday,14,391
1814,BAYF,2016-06-04 15:00:00,159,222,Saturday,15,381
1815,BAYF,2016-06-04 16:00:00,148,252,Saturday,16,400
1816,BAYF,2016-06-04 17:00:00,135,237,Saturday,17,372
1817,BAYF,2016-06-04 18:00:00,129,246,Saturday,18,375
1818,BAYF,2016-06-04 19:00:00,123,191,Saturday,19,314
1819,BAYF,2016-06-04 20:00:00,141,186,Saturday,20,327
1820,BAYF,2016-06-04 21:00:00,91,85,Saturday,21,176
1821,BAYF,2016-06-04 22:00:00,87,151,Saturday,22,238
1822,BAYF,2016-06-04 23:00:00,54,103,Saturday,23,157
1823,BAYF,2016-06-05 00:00:00,24,87,Sunday,0,111
1824,BAYF,2016-06-05 01:00:00,4,9,Sunday,1,13
1825,BAYF,2016-06-05 08:00:00,173,75,Sunday,8,248
1826,BAYF,2016-06-05 09:00:00,166,73,Sunday,9,239
1827,BAYF,2016-06-05 10:00:00,214,88,Sunday,10,302
1828,BAYF,2016-06-05 11:00:00,142,94,Sunday,11,236
1829,BAYF,2016-06-05 12:00:00,180,120,Sunday,12,300
1830,BAYF,2016-06-05 13:00:00,132,147,Sunday,13,279
1831,BAYF,2016-06-05 14:00:00,179,174,Sunday,14,353
1832,BAYF,2016-06-05 15:00:00,181,152,Sunday,15,333
1833,BAYF,2016-06-05 16:00:00,188,196,Sunday,16,384
1834,BAYF,2016-06-05 17:00:00,142,196,Sunday,17,338
1835,BAYF,2016-06-05 18:00:00,114,214,Sunday,18,328
1836,BAYF,2016-06-05 19:00:00,93,146,Sunday,19,239
1837,BAYF,2016-06-05 20:00:00,89,180,Sunday,20,269
1838,BAYF,2016-06-05 21:00:00,89,138,Sunday,21,227
1839,BAYF,2016-06-05 22:00:00,54,100,Sunday,22,154
1840,BAYF,2016-06-05 23:00:00,46,69,Sunday,23,115
1841,BAYF,2016-06-06 00:00:00,13,37,Monday,0,50
1842,BAYF,2016-06-06 01:00:00,5,10,Monday,1,15
1843,BAYF,2016-06-06 04:00:00,18,4,Monday,4,22
1844,BAYF,2016-06-06 05:00:00,174,27,Monday,5,201
1845,BAYF,2016-06-06 06:00:00,519,90,Monday,6,609
1846,BAYF,2016-06-06 07:00:00,877,160,Monday,7,1037
1847,BAYF,2016-06-06 08:00:00,1124,144,Monday,8,1268
1848,BAYF,2016-06-06 09:00:00,771,125,Monday,9,896
1849,BAYF,2016-06-06 10:00:00,314,156,Monday,10,470
1850,BAYF,2016-06-06 11:00:00,228,128,Monday,11,356
1851,BAYF,2016-06-06 12:00:00,184,175,Monday,12,359
1852,BAYF,2016-06-06 13:00:00,212,198,Monday,13,410
1853,BAYF,2016-06-06 14:00:00,224,276,Monday,14,500
1854,BAYF,2016-06-06 15:00:00,232,341,Monday,15,573
1855,BAYF,2016-06-06 16:00:00,203,796,Monday,16,999
1856,BAYF,2016-06-06 17:00:00,172,1086,Monday,17,1258
1857,BAYF,2016-06-06 18:00:00,143,935,Monday,18,1078
1858,BAYF,2016-06-06 19:00:00,125,437,Monday,19,562
1859,BAYF,2016-06-06 20:00:00,81,181,Monday,20,262
1860,BAYF,2016-06-06 21:00:00,79,324,Monday,21,403
1861,BAYF,2016-06-06 22:00:00,79,137,Monday,22,216
1862,BAYF,2016-06-06 23:00:00,41,117,Monday,23,158
1863,BAYF,2016-06-07 00:00:00,18,63,Tuesday,0,81
1864,BAYF,2016-06-07 01:00:00,2,10,Tuesday,1,12
1865,BAYF,2016-06-07 04:00:00,10,8,Tuesday,4,18
1866,BAYF,2016-06-07 05:00:00,210,36,Tuesday,5,246
1867,BAYF,2016-06-07 06:00:00,514,80,Tuesday,6,594
1868,BAYF,2016-06-07 07:00:00,948,156,Tuesday,7,1104
1869,BAYF,2016-06-07 08:00:00,1172,129,Tuesday,8,1301
1870,BAYF,2016-06-07 09:00:00,739,157,Tuesday,9,896
1871,BAYF,2016-06-07 10:00:00,326,132,Tuesday,10,458
1872,BAYF,2016-06-07 11:00:00,234,151,Tuesday,11,385
1873,BAYF,2016-06-07 12:00:00,233,185,Tuesday,12,418
1874,BAYF,2016-06-07 13:00:00,203,187,Tuesday,13,390
1875,BAYF,2016-06-07 14:00:00,214,252,Tuesday,14,466
1876,BAYF,2016-06-07 15:00:00,220,435,Tuesday,15,655
1877,BAYF,2016-06-07 16:00:00,222,803,Tuesday,16,1025
1878,BAYF,2016-06-07 17:00:00,204,1109,Tuesday,17,1313
1879,BAYF,2016-06-07 18:00:00,167,936,Tuesday,18,1103
1880,BAYF,2016-06-07 19:00:00,140,432,Tuesday,19,572
1881,BAYF,2016-06-07 20:00:00,106,235,Tuesday,20,341
1882,BAYF,2016-06-07 21:00:00,94,208,Tuesday,21,302
1883,BAYF,2016-06-07 22:00:00,71,194,Tuesday,22,265
1884,BAYF,2016-06-07 23:00:00,41,161,Tuesday,23,202
1885,BAYF,2016-06-08 00:00:00,19,70,Wednesday,0,89
1886,BAYF,2016-06-08 01:00:00,6,16,Wednesday,1,22
1887,BAYF,2016-06-08 04:00:00,14,3,Wednesday,4,17
1888,BAYF,2016-06-08 05:00:00,216,42,Wednesday,5,258
1889,BAYF,2016-06-08 06:00:00,492,76,Wednesday,6,568
1890,BAYF,2016-06-08 07:00:00,940,178,Wednesday,7,1118
1891,BAYF,2016-06-08 08:00:00,1045,156,Wednesday,8,1201
1892,BAYF,2016-06-08 09:00:00,804,138,Wednesday,9,942
1893,BAYF,2016-06-08 10:00:00,345,119,Wednesday,10,464
1894,BAYF,2016-06-08 11:00:00,230,142,Wednesday,11,372
1895,BAYF,2016-06-08 12:00:00,185,187,Wednesday,12,372
1896,BAYF,2016-06-08 13:00:00,176,175,Wednesday,13,351
1897,BAYF,2016-06-08 14:00:00,214,275,Wednesday,14,489
1898,BAYF,2016-06-08 15:00:00,261,400,Wednesday,15,661
1899,BAYF,2016-06-08 16:00:00,203,768,Wednesday,16,971
1900,BAYF,2016-06-08 17:00:00,319,1068,Wednesday,17,1387
1901,BAYF,2016-06-08 18:00:00,225,842,Wednesday,18,1067
1902,BAYF,2016-06-08 19:00:00,153,500,Wednesday,19,653
1903,BAYF,2016-06-08 20:00:00,78,271,Wednesday,20,349
1904,BAYF,2016-06-08 21:00:00,95,294,Wednesday,21,389
1905,BAYF,2016-06-08 22:00:00,68,189,Wednesday,22,257
1906,BAYF,2016-06-08 23:00:00,42,168,Wednesday,23,210
1907,BAYF,2016-06-09 00:00:00,19,67,Thursday,0,86
1908,BAYF,2016-06-09 01:00:00,4,21,Thursday,1,25
1909,BAYF,2016-06-09 04:00:00,7,9,Thursday,4,16
1910,BAYF,2016-06-09 05:00:00,200,39,Thursday,5,239
1911,BAYF,2016-06-09 06:00:00,459,87,Thursday,6,546
1912,BAYF,2016-06-09 07:00:00,842,143,Thursday,7,985
1913,BAYF,2016-06-09 08:00:00,1131,143,Thursday,8,1274
1914,BAYF,2016-06-09 09:00:00,737,123,Thursday,9,860
1915,BAYF,2016-06-09 10:00:00,324,137,Thursday,10,461
1916,BAYF,2016-06-09 11:00:00,211,126,Thursday,11,337
1917,BAYF,2016-06-09 12:00:00,192,187,Thursday,12,379
1918,BAYF,2016-06-09 13:00:00,198,203,Thursday,13,401
1919,BAYF,2016-06-09 14:00:00,225,248,Thursday,14,473
1920,BAYF,2016-06-09 15:00:00,215,374,Thursday,15,589
1921,BAYF,2016-06-09 16:00:00,212,748,Thursday,16,960
1922,BAYF,2016-06-09 17:00:00,230,1011,Thursday,17,1241
1923,BAYF,2016-06-09 18:00:00,161,830,Thursday,18,991
1924,BAYF,2016-06-09 19:00:00,141,479,Thursday,19,620
1925,BAYF,2016-06-09 20:00:00,96,201,Thursday,20,297
1926,BAYF,2016-06-09 21:00:00,107,287,Thursday,21,394
1927,BAYF,2016-06-09 22:00:00,74,199,Thursday,22,273
1928,BAYF,2016-06-09 23:00:00,47,126,Thursday,23,173
1929,BAYF,2016-06-10 00:00:00,18,69,Friday,0,87
1930,BAYF,2016-06-10 01:00:00,3,13,Friday,1,16
1931,BAYF,2016-06-10 04:00:00,5,4,Friday,4,9
1932,BAYF,2016-06-10 05:00:00,197,38,Friday,5,235
1933,BAYF,2016-06-10 06:00:00,467,95,Friday,6,562
1934,BAYF,2016-06-10 07:00:00,791,128,Friday,7,919
1935,BAYF,2016-06-10 08:00:00,1024,147,Friday,8,1171
1936,BAYF,2016-06-10 09:00:00,608,136,Friday,9,744
1937,BAYF,2016-06-10 10:00:00,300,120,Friday,10,420
1938,BAYF,2016-06-10 11:00:00,244,137,Friday,11,381
1939,BAYF,2016-06-10 12:00:00,240,199,Friday,12,439
1940,BAYF,2016-06-10 13:00:00,232,241,Friday,13,473
1941,BAYF,2016-06-10 14:00:00,241,294,Friday,14,535
1942,BAYF,2016-06-10 15:00:00,230,440,Friday,15,670
1943,BAYF,2016-06-10 16:00:00,244,688,Friday,16,932
1944,BAYF,2016-06-10 17:00:00,348,1127,Friday,17,1475
1945,BAYF,2016-06-10 18:00:00,242,767,Friday,18,1009
1946,BAYF,2016-06-10 19:00:00,151,322,Friday,19,473
1947,BAYF,2016-06-10 20:00:00,115,186,Friday,20,301
1948,BAYF,2016-06-10 21:00:00,119,338,Friday,21,457
1949,BAYF,2016-06-10 22:00:00,103,228,Friday,22,331
1950,BAYF,2016-06-10 23:00:00,40,174,Friday,23,214
1951,BAYF,2016-06-11 00:00:00,28,140,Saturday,0,168
1952,BAYF,2016-06-11 01:00:00,5,15,Saturday,1,20
1953,BAYF,2016-06-11 06:00:00,47,26,Saturday,6,73
1954,BAYF,2016-06-11 07:00:00,126,64,Saturday,7,190
1955,BAYF,2016-06-11 08:00:00,207,73,Saturday,8,280
1956,BAYF,2016-06-11 09:00:00,193,91,Saturday,9,284
1957,BAYF,2016-06-11 10:00:00,212,114,Saturday,10,326
1958,BAYF,2016-06-11 11:00:00,186,128,Saturday,11,314
1959,BAYF,2016-06-11 12:00:00,204,146,Saturday,12,350
1960,BAYF,2016-06-11 13:00:00,230,160,Saturday,13,390
1961,BAYF,2016-06-11 14:00:00,253,166,Saturday,14,419
1962,BAYF,2016-06-11 15:00:00,179,183,Saturday,15,362
1963,BAYF,2016-06-11 16:00:00,150,231,Saturday,16,381
1964,BAYF,2016-06-11 17:00:00,138,209,Saturday,17,347
1965,BAYF,2016-06-11 18:00:00,158,272,Saturday,18,430
1966,BAYF,2016-06-11 19:00:00,163,190,Saturday,19,353
1967,BAYF,2016-06-11 20:00:00,139,199,Saturday,20,338
1968,BAYF,2016-06-11 21:00:00,118,168,Saturday,21,286
1969,BAYF,2016-06-11 22:00:00,98,163,Saturday,22,261
1970,BAYF,2016-06-11 23:00:00,59,117,Saturday,23,176
1971,BAYF,2016-06-12 00:00:00,27,100,Sunday,0,127
1972,BAYF,2016-06-12 01:00:00,6,15,Sunday,1,21
1973,BAYF,2016-06-12 08:00:00,138,62,Sunday,8,200
1974,BAYF,2016-06-12 09:00:00,151,100,Sunday,9,251
1975,BAYF,2016-06-12 10:00:00,162,91,Sunday,10,253
1976,BAYF,2016-06-12 11:00:00,174,95,Sunday,11,269
1977,BAYF,2016-06-12 12:00:00,146,103,Sunday,12,249
1978,BAYF,2016-06-12 13:00:00,197,113,Sunday,13,310
1979,BAYF,2016-06-12 14:00:00,186,135,Sunday,14,321
1980,BAYF,2016-06-12 15:00:00,168,149,Sunday,15,317
1981,BAYF,2016-06-12 16:00:00,134,168,Sunday,16,302
1982,BAYF,2016-06-12 17:00:00,146,187,Sunday,17,333
1983,BAYF,2016-06-12 18:00:00,133,190,Sunday,18,323
1984,BAYF,2016-06-12 19:00:00,128,158,Sunday,19,286
1985,BAYF,2016-06-12 20:00:00,93,169,Sunday,20,262
1986,BAYF,2016-06-12 21:00:00,98,171,Sunday,21,269
1987,BAYF,2016-06-12 22:00:00,59,116,Sunday,22,175
1988,BAYF,2016-06-12 23:00:00,38,121,Sunday,23,159
1989,BAYF,2016-06-13 00:00:00,20,55,Monday,0,75
1990,BAYF,2016-06-13 01:00:00,1,9,Monday,1,10
1991,BAYF,2016-06-13 04:00:00,4,11,Monday,4,15
1992,BAYF,2016-06-13 05:00:00,197,36,Monday,5,233
1993,BAYF,2016-06-13 06:00:00,441,70,Monday,6,511
1994,BAYF,2016-06-13 07:00:00,917,133,Monday,7,1050
1995,BAYF,2016-06-13 08:00:00,1096,138,Monday,8,1234
1996,BAYF,2016-06-13 09:00:00,710,146,Monday,9,856
1997,BAYF,2016-06-13 10:00:00,299,123,Monday,10,422
1998,BAYF,2016-06-13 11:00:00,252,156,Monday,11,408
1999,BAYF,2016-06-13 12:00:00,207,139,Monday,12,346
2000,BAYF,2016-06-13 13:00:00,233,234,Monday,13,467
2001,BAYF,2016-06-13 14:00:00,213,230,Monday,14,443
2002,BAYF,2016-06-13 15:00:00,198,405,Monday,15,603
2003,BAYF,2016-06-13 16:00:00,262,662,Monday,16,924
2004,BAYF,2016-06-13 17:00:00,258,1157,Monday,17,1415
2005,BAYF,2016-06-13 18:00:00,248,882,Monday,18,1130
2006,BAYF,2016-06-13 19:00:00,131,403,Monday,19,534
2007,BAYF,2016-06-13 20:00:00,116,250,Monday,20,366
2008,BAYF,2016-06-13 21:00:00,78,331,Monday,21,409
2009,BAYF,2016-06-13 22:00:00,67,232,Monday,22,299
2010,BAYF,2016-06-13 23:00:00,37,157,Monday,23,194
2011,BAYF,2016-06-14 00:00:00,13,62,Tuesday,0,75
2012,BAYF,2016-06-14 04:00:00,13,9,Tuesday,4,22
2013,BAYF,2016-06-14 05:00:00,228,42,Tuesday,5,270
2014,BAYF,2016-06-14 06:00:00,480,80,Tuesday,6,560
2015,BAYF,2016-06-14 07:00:00,920,131,Tuesday,7,1051
2016,BAYF,2016-06-14 08:00:00,1031,132,Tuesday,8,1163
2017,BAYF,2016-06-14 09:00:00,838,115,Tuesday,9,953
2018,BAYF,2016-06-14 10:00:00,318,143,Tuesday,10,461
2019,BAYF,2016-06-14 11:00:00,234,124,Tuesday,11,358
2020,BAYF,2016-06-14 12:00:00,185,181,Tuesday,12,366
2021,BAYF,2016-06-14 13:00:00,208,168,Tuesday,13,376
2022,BAYF,2016-06-14 14:00:00,204,266,Tuesday,14,470
2023,BAYF,2016-06-14 15:00:00,209,438,Tuesday,15,647
2024,BAYF,2016-06-14 16:00:00,209,641,Tuesday,16,850
2025,BAYF,2016-06-14 17:00:00,211,1082,Tuesday,17,1293
2026,BAYF,2016-06-14 18:00:00,213,988,Tuesday,18,1201
2027,BAYF,2016-06-14 19:00:00,124,459,Tuesday,19,583
2028,BAYF,2016-06-14 20:00:00,99,243,Tuesday,20,342
2029,BAYF,2016-06-14 21:00:00,87,176,Tuesday,21,263
2030,BAYF,2016-06-14 22:00:00,81,257,Tuesday,22,338
2031,BAYF,2016-06-14 23:00:00,36,170,Tuesday,23,206
2032,CAST,2016-06-01 05:00:00,92,11,Wednesday,5,103
2033,CAST,2016-06-01 06:00:00,286,24,Wednesday,6,310
2034,CAST,2016-06-01 07:00:00,548,52,Wednesday,7,600
2035,CAST,2016-06-01 08:00:00,738,42,Wednesday,8,780
2036,CAST,2016-06-01 09:00:00,392,39,Wednesday,9,431
2037,CAST,2016-06-01 10:00:00,181,60,Wednesday,10,241
2038,CAST,2016-06-01 11:00:00,122,48,Wednesday,11,170
2039,CAST,2016-06-01 12:00:00,106,56,Wednesday,12,162
2040,CAST,2016-06-01 13:00:00,75,77,Wednesday,13,152
2041,CAST,2016-06-01 14:00:00,68,112,Wednesday,14,180
2042,CAST,2016-06-01 15:00:00,90,222,Wednesday,15,312
2043,CAST,2016-06-01 16:00:00,102,395,Wednesday,16,497
2044,CAST,2016-06-01 17:00:00,87,525,Wednesday,17,612
2045,CAST,2016-06-01 18:00:00,87,671,Wednesday,18,758
2046,CAST,2016-06-01 19:00:00,45,241,Wednesday,19,286
2047,CAST,2016-06-01 20:00:00,29,173,Wednesday,20,202
2048,CAST,2016-06-01 21:00:00,46,124,Wednesday,21,170
2049,CAST,2016-06-01 22:00:00,32,107,Wednesday,22,139
2050,CAST,2016-06-01 23:00:00,8,51,Wednesday,23,59
2051,CAST,2016-06-02 00:00:00,6,36,Thursday,0,42
2052,CAST,2016-06-02 01:00:00,1,3,Thursday,1,4
2053,CAST,2016-06-02 04:00:00,2,1,Thursday,4,3
2054,CAST,2016-06-02 05:00:00,90,10,Thursday,5,100
2055,CAST,2016-06-02 06:00:00,289,23,Thursday,6,312
2056,CAST,2016-06-02 07:00:00,538,61,Thursday,7,599
2057,CAST,2016-06-02 08:00:00,712,47,Thursday,8,759
2058,CAST,2016-06-02 09:00:00,395,39,Thursday,9,434
2059,CAST,2016-06-02 10:00:00,158,41,Thursday,10,199
2060,CAST,2016-06-02 11:00:00,120,36,Thursday,11,156
2061,CAST,2016-06-02 12:00:00,81,54,Thursday,12,135
2062,CAST,2016-06-02 13:00:00,56,82,Thursday,13,138
2063,CAST,2016-06-02 14:00:00,72,110,Thursday,14,182
2064,CAST,2016-06-02 15:00:00,79,181,Thursday,15,260
2065,CAST,2016-06-02 16:00:00,134,278,Thursday,16,412
2066,CAST,2016-06-02 17:00:00,132,640,Thursday,17,772
2067,CAST,2016-06-02 18:00:00,69,564,Thursday,18,633
2068,CAST,2016-06-02 19:00:00,43,316,Thursday,19,359
2069,CAST,2016-06-02 20:00:00,23,126,Thursday,20,149
2070,CAST,2016-06-02 21:00:00,40,212,Thursday,21,252
2071,CAST,2016-06-02 22:00:00,27,97,Thursday,22,124
2072,CAST,2016-06-02 23:00:00,15,166,Thursday,23,181
2073,CAST,2016-06-03 00:00:00,7,29,Friday,0,36
2074,CAST,2016-06-03 04:00:00,2,1,Friday,4,3
2075,CAST,2016-06-03 05:00:00,73,9,Friday,5,82
2076,CAST,2016-06-03 06:00:00,246,22,Friday,6,268
2077,CAST,2016-06-03 07:00:00,496,71,Friday,7,567
2078,CAST,2016-06-03 08:00:00,646,42,Friday,8,688
2079,CAST,2016-06-03 09:00:00,509,68,Friday,9,577
2080,CAST,2016-06-03 10:00:00,176,49,Friday,10,225
2081,CAST,2016-06-03 11:00:00,114,51,Friday,11,165
2082,CAST,2016-06-03 12:00:00,115,43,Friday,12,158
2083,CAST,2016-06-03 13:00:00,90,127,Friday,13,217
2084,CAST,2016-06-03 14:00:00,65,187,Friday,14,252
2085,CAST,2016-06-03 15:00:00,88,206,Friday,15,294
2086,CAST,2016-06-03 16:00:00,111,354,Friday,16,465
2087,CAST,2016-06-03 17:00:00,100,556,Friday,17,656
2088,CAST,2016-06-03 18:00:00,93,395,Friday,18,488
2089,CAST,2016-06-03 19:00:00,59,171,Friday,19,230
2090,CAST,2016-06-03 20:00:00,39,140,Friday,20,179
2091,CAST,2016-06-03 21:00:00,33,127,Friday,21,160
2092,CAST,2016-06-03 22:00:00,27,106,Friday,22,133
2093,CAST,2016-06-03 23:00:00,26,85,Friday,23,111
2094,CAST,2016-06-04 00:00:00,14,62,Saturday,0,76
2095,CAST,2016-06-04 01:00:00,5,2,Saturday,1,7
2096,CAST,2016-06-04 06:00:00,19,11,Saturday,6,30
2097,CAST,2016-06-04 07:00:00,64,23,Saturday,7,87
2098,CAST,2016-06-04 08:00:00,90,41,Saturday,8,131
2099,CAST,2016-06-04 09:00:00,91,44,Saturday,9,135
2100,CAST,2016-06-04 10:00:00,89,56,Saturday,10,145
2101,CAST,2016-06-04 11:00:00,100,27,Saturday,11,127
2102,CAST,2016-06-04 12:00:00,90,54,Saturday,12,144
2103,CAST,2016-06-04 13:00:00,95,58,Saturday,13,153
2104,CAST,2016-06-04 14:00:00,74,95,Saturday,14,169
2105,CAST,2016-06-04 15:00:00,77,64,Saturday,15,141
2106,CAST,2016-06-04 16:00:00,103,82,Saturday,16,185
2107,CAST,2016-06-04 17:00:00,94,119,Saturday,17,213
2108,CAST,2016-06-04 18:00:00,76,86,Saturday,18,162
2109,CAST,2016-06-04 19:00:00,55,88,Saturday,19,143
2110,CAST,2016-06-04 20:00:00,36,103,Saturday,20,139
2111,CAST,2016-06-04 21:00:00,43,76,Saturday,21,119
2112,CAST,2016-06-04 22:00:00,32,97,Saturday,22,129
2113,CAST,2016-06-04 23:00:00,19,63,Saturday,23,82
2114,CAST,2016-06-05 00:00:00,9,64,Sunday,0,73
2115,CAST,2016-06-05 01:00:00,1,5,Sunday,1,6
2116,CAST,2016-06-05 08:00:00,44,24,Sunday,8,68
2117,CAST,2016-06-05 09:00:00,93,35,Sunday,9,128
2118,CAST,2016-06-05 10:00:00,76,42,Sunday,10,118
2119,CAST,2016-06-05 11:00:00,125,43,Sunday,11,168
2120,CAST,2016-06-05 12:00:00,91,42,Sunday,12,133
2121,CAST,2016-06-05 13:00:00,69,44,Sunday,13,113
2122,CAST,2016-06-05 14:00:00,62,64,Sunday,14,126
2123,CAST,2016-06-05 15:00:00,102,73,Sunday,15,175
2124,CAST,2016-06-05 16:00:00,66,79,Sunday,16,145
2125,CAST,2016-06-05 17:00:00,48,116,Sunday,17,164
2126,CAST,2016-06-05 18:00:00,42,96,Sunday,18,138
2127,CAST,2016-06-05 19:00:00,20,78,Sunday,19,98
2128,CAST,2016-06-05 20:00:00,32,128,Sunday,20,160
2129,CAST,2016-06-05 21:00:00,22,52,Sunday,21,74
2130,CAST,2016-06-05 22:00:00,27,32,Sunday,22,59
2131,CAST,2016-06-05 23:00:00,8,39,Sunday,23,47
2132,CAST,2016-06-06 00:00:00,6,17,Monday,0,23
2133,CAST,2016-06-06 05:00:00,72,8,Monday,5,80
2134,CAST,2016-06-06 06:00:00,307,18,Monday,6,325
2135,CAST,2016-06-06 07:00:00,498,50,Monday,7,548
2136,CAST,2016-06-06 08:00:00,687,55,Monday,8,742
2137,CAST,2016-06-06 09:00:00,472,54,Monday,9,526
2138,CAST,2016-06-06 10:00:00,179,39,Monday,10,218
2139,CAST,2016-06-06 11:00:00,89,46,Monday,11,135
2140,CAST,2016-06-06 12:00:00,83,53,Monday,12,136
2141,CAST,2016-06-06 13:00:00,73,71,Monday,13,144
2142,CAST,2016-06-06 14:00:00,73,113,Monday,14,186
2143,CAST,2016-06-06 15:00:00,70,151,Monday,15,221
2144,CAST,2016-06-06 16:00:00,82,433,Monday,16,515
2145,CAST,2016-06-06 17:00:00,94,624,Monday,17,718
2146,CAST,2016-06-06 18:00:00,41,556,Monday,18,597
2147,CAST,2016-06-06 19:00:00,37,248,Monday,19,285
2148,CAST,2016-06-06 20:00:00,28,132,Monday,20,160
2149,CAST,2016-06-06 21:00:00,23,120,Monday,21,143
2150,CAST,2016-06-06 22:00:00,24,138,Monday,22,162
2151,CAST,2016-06-06 23:00:00,11,47,Monday,23,58
2152,CAST,2016-06-07 00:00:00,7,26,Tuesday,0,33
2153,CAST,2016-06-07 01:00:00,1,1,Tuesday,1,2
2154,CAST,2016-06-07 05:00:00,78,12,Tuesday,5,90
2155,CAST,2016-06-07 06:00:00,274,19,Tuesday,6,293
2156,CAST,2016-06-07 07:00:00,547,64,Tuesday,7,611
2157,CAST,2016-06-07 08:00:00,750,61,Tuesday,8,811
2158,CAST,2016-06-07 09:00:00,406,55,Tuesday,9,461
2159,CAST,2016-06-07 10:00:00,171,130,Tuesday,10,301
2160,CAST,2016-06-07 11:00:00,103,54,Tuesday,11,157
2161,CAST,2016-06-07 12:00:00,97,55,Tuesday,12,152
2162,CAST,2016-06-07 13:00:00,62,86,Tuesday,13,148
2163,CAST,2016-06-07 14:00:00,87,156,Tuesday,14,243
2164,CAST,2016-06-07 15:00:00,116,193,Tuesday,15,309
2165,CAST,2016-06-07 16:00:00,96,386,Tuesday,16,482
2166,CAST,2016-06-07 17:00:00,108,637,Tuesday,17,745
2167,CAST,2016-06-07 18:00:00,101,459,Tuesday,18,560
2168,CAST,2016-06-07 19:00:00,67,389,Tuesday,19,456
2169,CAST,2016-06-07 20:00:00,32,138,Tuesday,20,170
2170,CAST,2016-06-07 21:00:00,39,94,Tuesday,21,133
2171,CAST,2016-06-07 22:00:00,27,84,Tuesday,22,111
2172,CAST,2016-06-07 23:00:00,18,100,Tuesday,23,118
2173,CAST,2016-06-08 00:00:00,11,46,Wednesday,0,57
2174,CAST,2016-06-08 04:00:00,9,1,Wednesday,4,10
2175,CAST,2016-06-08 05:00:00,71,7,Wednesday,5,78
2176,CAST,2016-06-08 06:00:00,280,24,Wednesday,6,304
2177,CAST,2016-06-08 07:00:00,562,47,Wednesday,7,609
2178,CAST,2016-06-08 08:00:00,714,46,Wednesday,8,760
2179,CAST,2016-06-08 09:00:00,478,45,Wednesday,9,523
2180,CAST,2016-06-08 10:00:00,196,53,Wednesday,10,249
2181,CAST,2016-06-08 11:00:00,124,43,Wednesday,11,167
2182,CAST,2016-06-08 12:00:00,85,61,Wednesday,12,146
2183,CAST,2016-06-08 13:00:00,74,87,Wednesday,13,161
2184,CAST,2016-06-08 14:00:00,75,114,Wednesday,14,189
2185,CAST,2016-06-08 15:00:00,126,205,Wednesday,15,331
2186,CAST,2016-06-08 16:00:00,117,350,Wednesday,16,467
2187,CAST,2016-06-08 17:00:00,147,560,Wednesday,17,707
2188,CAST,2016-06-08 18:00:00,119,672,Wednesday,18,791
2189,CAST,2016-06-08 19:00:00,55,213,Wednesday,19,268
2190,CAST,2016-06-08 20:00:00,28,160,Wednesday,20,188
2191,CAST,2016-06-08 21:00:00,30,217,Wednesday,21,247
2192,CAST,2016-06-08 22:00:00,20,117,Wednesday,22,137
2193,CAST,2016-06-08 23:00:00,17,124,Wednesday,23,141
2194,CAST,2016-06-09 00:00:00,12,34,Thursday,0,46
2195,CAST,2016-06-09 04:00:00,2,3,Thursday,4,5
2196,CAST,2016-06-09 05:00:00,78,8,Thursday,5,86
2197,CAST,2016-06-09 06:00:00,265,28,Thursday,6,293
2198,CAST,2016-06-09 07:00:00,510,60,Thursday,7,570
2199,CAST,2016-06-09 08:00:00,704,38,Thursday,8,742
2200,CAST,2016-06-09 09:00:00,431,55,Thursday,9,486
2201,CAST,2016-06-09 10:00:00,162,42,Thursday,10,204
2202,CAST,2016-06-09 11:00:00,105,41,Thursday,11,146
2203,CAST,2016-06-09 12:00:00,80,54,Thursday,12,134
2204,CAST,2016-06-09 13:00:00,85,57,Thursday,13,142
2205,CAST,2016-06-09 14:00:00,76,97,Thursday,14,173
2206,CAST,2016-06-09 15:00:00,71,165,Thursday,15,236
2207,CAST,2016-06-09 16:00:00,95,419,Thursday,16,514
2208,CAST,2016-06-09 17:00:00,103,474,Thursday,17,577
2209,CAST,2016-06-09 18:00:00,74,629,Thursday,18,703
2210,CAST,2016-06-09 19:00:00,37,260,Thursday,19,297
2211,CAST,2016-06-09 20:00:00,35,171,Thursday,20,206
2212,CAST,2016-06-09 21:00:00,40,154,Thursday,21,194
2213,CAST,2016-06-09 22:00:00,27,103,Thursday,22,130
2214,CAST,2016-06-09 23:00:00,15,68,Thursday,23,83
2215,CAST,2016-06-10 00:00:00,5,48,Friday,0,53
2216,CAST,2016-06-10 04:00:00,2,1,Friday,4,3
2217,CAST,2016-06-10 05:00:00,74,9,Friday,5,83
2218,CAST,2016-06-10 06:00:00,273,25,Friday,6,298
2219,CAST,2016-06-10 07:00:00,455,53,Friday,7,508
2220,CAST,2016-06-10 08:00:00,585,41,Friday,8,626
2221,CAST,2016-06-10 09:00:00,380,64,Friday,9,444
2222,CAST,2016-06-10 10:00:00,170,34,Friday,10,204
2223,CAST,2016-06-10 11:00:00,105,55,Friday,11,160
2224,CAST,2016-06-10 12:00:00,98,54,Friday,12,152
2225,CAST,2016-06-10 13:00:00,81,88,Friday,13,169
2226,CAST,2016-06-10 14:00:00,78,158,Friday,14,236
2227,CAST,2016-06-10 15:00:00,96,204,Friday,15,300
2228,CAST,2016-06-10 16:00:00,136,258,Friday,16,394
2229,CAST,2016-06-10 17:00:00,179,628,Friday,17,807
2230,CAST,2016-06-10 18:00:00,156,405,Friday,18,561
2231,CAST,2016-06-10 19:00:00,85,188,Friday,19,273
2232,CAST,2016-06-10 20:00:00,37,111,Friday,20,148
2233,CAST,2016-06-10 21:00:00,39,165,Friday,21,204
2234,CAST,2016-06-10 22:00:00,36,145,Friday,22,181
2235,CAST,2016-06-10 23:00:00,19,161,Friday,23,180
2236,CAST,2016-06-11 00:00:00,8,82,Saturday,0,90
2237,CAST,2016-06-11 01:00:00,1,5,Saturday,1,6
2238,CAST,2016-06-11 06:00:00,15,15,Saturday,6,30
2239,CAST,2016-06-11 07:00:00,53,17,Saturday,7,70
2240,CAST,2016-06-11 08:00:00,74,37,Saturday,8,111
2241,CAST,2016-06-11 09:00:00,92,50,Saturday,9,142
2242,CAST,2016-06-11 10:00:00,100,47,Saturday,10,147
2243,CAST,2016-06-11 11:00:00,113,41,Saturday,11,154
2244,CAST,2016-06-11 12:00:00,90,53,Saturday,12,143
2245,CAST,2016-06-11 13:00:00,101,57,Saturday,13,158
2246,CAST,2016-06-11 14:00:00,103,62,Saturday,14,165
2247,CAST,2016-06-11 15:00:00,111,77,Saturday,15,188
2248,CAST,2016-06-11 16:00:00,93,98,Saturday,16,191
2249,CAST,2016-06-11 17:00:00,66,104,Saturday,17,170
2250,CAST,2016-06-11 18:00:00,76,100,Saturday,18,176
2251,CAST,2016-06-11 19:00:00,59,94,Saturday,19,153
2252,CAST,2016-06-11 20:00:00,31,89,Saturday,20,120
2253,CAST,2016-06-11 21:00:00,32,124,Saturday,21,156
2254,CAST,2016-06-11 22:00:00,31,111,Saturday,22,142
2255,CAST,2016-06-11 23:00:00,23,86,Saturday,23,109
2256,CAST,2016-06-12 00:00:00,11,48,Sunday,0,59
2257,CAST,2016-06-12 01:00:00,1,3,Sunday,1,4
2258,CAST,2016-06-12 08:00:00,51,38,Sunday,8,89
2259,CAST,2016-06-12 09:00:00,65,38,Sunday,9,103
2260,CAST,2016-06-12 10:00:00,92,31,Sunday,10,123
2261,CAST,2016-06-12 11:00:00,94,28,Sunday,11,122
2262,CAST,2016-06-12 12:00:00,78,40,Sunday,12,118
2263,CAST,2016-06-12 13:00:00,90,37,Sunday,13,127
2264,CAST,2016-06-12 14:00:00,73,60,Sunday,14,133
2265,CAST,2016-06-12 15:00:00,69,84,Sunday,15,153
2266,CAST,2016-06-12 16:00:00,96,71,Sunday,16,167
2267,CAST,2016-06-12 17:00:00,67,90,Sunday,17,157
2268,CAST,2016-06-12 18:00:00,64,95,Sunday,18,159
2269,CAST,2016-06-12 19:00:00,45,64,Sunday,19,109
2270,CAST,2016-06-12 20:00:00,17,78,Sunday,20,95
2271,CAST,2016-06-12 21:00:00,36,75,Sunday,21,111
2272,CAST,2016-06-12 22:00:00,27,117,Sunday,22,144
2273,CAST,2016-06-12 23:00:00,17,70,Sunday,23,87
2274,CAST,2016-06-13 00:00:00,15,25,Monday,0,40
2275,CAST,2016-06-13 01:00:00,2,3,Monday,1,5
2276,CAST,2016-06-13 04:00:00,3,1,Monday,4,4
2277,CAST,2016-06-13 05:00:00,80,10,Monday,5,90
2278,CAST,2016-06-13 06:00:00,281,24,Monday,6,305
2279,CAST,2016-06-13 07:00:00,491,47,Monday,7,538
2280,CAST,2016-06-13 08:00:00,714,47,Monday,8,761
2281,CAST,2016-06-13 09:00:00,425,39,Monday,9,464
2282,CAST,2016-06-13 10:00:00,165,39,Monday,10,204
2283,CAST,2016-06-13 11:00:00,123,57,Monday,11,180
2284,CAST,2016-06-13 12:00:00,89,66,Monday,12,155
2285,CAST,2016-06-13 13:00:00,102,65,Monday,13,167
2286,CAST,2016-06-13 14:00:00,88,100,Monday,14,188
2287,CAST,2016-06-13 15:00:00,97,182,Monday,15,279
2288,CAST,2016-06-13 16:00:00,136,403,Monday,16,539
2289,CAST,2016-06-13 17:00:00,156,486,Monday,17,642
2290,CAST,2016-06-13 18:00:00,129,719,Monday,18,848
2291,CAST,2016-06-13 19:00:00,49,181,Monday,19,230
2292,CAST,2016-06-13 20:00:00,27,136,Monday,20,163
2293,CAST,2016-06-13 21:00:00,27,194,Monday,21,221
2294,CAST,2016-06-13 22:00:00,23,189,Monday,22,212
2295,CAST,2016-06-13 23:00:00,13,93,Monday,23,106
2296,CAST,2016-06-14 00:00:00,8,39,Tuesday,0,47
2297,CAST,2016-06-14 01:00:00,2,4,Tuesday,1,6
2298,CAST,2016-06-14 05:00:00,79,15,Tuesday,5,94
2299,CAST,2016-06-14 06:00:00,273,26,Tuesday,6,299
2300,CAST,2016-06-14 07:00:00,506,39,Tuesday,7,545
2301,CAST,2016-06-14 08:00:00,674,45,Tuesday,8,719
2302,CAST,2016-06-14 09:00:00,473,40,Tuesday,9,513
2303,CAST,2016-06-14 10:00:00,158,38,Tuesday,10,196
2304,CAST,2016-06-14 11:00:00,102,57,Tuesday,11,159
2305,CAST,2016-06-14 12:00:00,86,64,Tuesday,12,150
2306,CAST,2016-06-14 13:00:00,80,94,Tuesday,13,174
2307,CAST,2016-06-14 14:00:00,91,96,Tuesday,14,187
2308,CAST,2016-06-14 15:00:00,115,136,Tuesday,15,251
2309,CAST,2016-06-14 16:00:00,105,407,Tuesday,16,512
2310,CAST,2016-06-14 17:00:00,134,524,Tuesday,17,658
2311,CAST,2016-06-14 18:00:00,122,647,Tuesday,18,769
2312,CAST,2016-06-14 19:00:00,84,276,Tuesday,19,360
2313,CAST,2016-06-14 20:00:00,30,216,Tuesday,20,246
2314,CAST,2016-06-14 21:00:00,30,88,Tuesday,21,118
2315,CAST,2016-06-14 22:00:00,16,168,Tuesday,22,184
2316,CAST,2016-06-14 23:00:00,13,128,Tuesday,23,141
2317,CIVC,2016-06-01 01:00:00,26,7,Wednesday,1,33
2318,CIVC,2016-06-01 04:00:00,16,32,Wednesday,4,48
2319,CIVC,2016-06-01 05:00:00,74,467,Wednesday,5,541
2320,CIVC,2016-06-01 06:00:00,212,1702,Wednesday,6,1914
2321,CIVC,2016-06-01 07:00:00,581,3839,Wednesday,7,4420
2322,CIVC,2016-06-01 08:00:00,963,4963,Wednesday,8,5926
2323,CIVC,2016-06-01 09:00:00,772,3211,Wednesday,9,3983
2324,CIVC,2016-06-01 10:00:00,619,1407,Wednesday,10,2026
2325,CIVC,2016-06-01 11:00:00,548,853,Wednesday,11,1401
2326,CIVC,2016-06-01 12:00:00,695,911,Wednesday,12,1606
2327,CIVC,2016-06-01 13:00:00,770,753,Wednesday,13,1523
2328,CIVC,2016-06-01 14:00:00,900,624,Wednesday,14,1524
2329,CIVC,2016-06-01 15:00:00,1550,645,Wednesday,15,2195
2330,CIVC,2016-06-01 16:00:00,2840,678,Wednesday,16,3518
2331,CIVC,2016-06-01 17:00:00,5038,1184,Wednesday,17,6222
2332,CIVC,2016-06-01 18:00:00,4792,996,Wednesday,18,5788
2333,CIVC,2016-06-01 19:00:00,2036,664,Wednesday,19,2700
2334,CIVC,2016-06-01 20:00:00,1155,329,Wednesday,20,1484
2335,CIVC,2016-06-01 21:00:00,807,283,Wednesday,21,1090
2336,CIVC,2016-06-01 22:00:00,696,231,Wednesday,22,927
2337,CIVC,2016-06-01 23:00:00,659,118,Wednesday,23,777
2338,CIVC,2016-06-02 00:00:00,270,62,Thursday,0,332
2339,CIVC,2016-06-02 01:00:00,34,4,Thursday,1,38
2340,CIVC,2016-06-02 04:00:00,13,32,Thursday,4,45
2341,CIVC,2016-06-02 05:00:00,67,480,Thursday,5,547
2342,CIVC,2016-06-02 06:00:00,198,1669,Thursday,6,1867
2343,CIVC,2016-06-02 07:00:00,505,3635,Thursday,7,4140
2344,CIVC,2016-06-02 08:00:00,932,4696,Thursday,8,5628
2345,CIVC,2016-06-02 09:00:00,787,3693,Thursday,9,4480
2346,CIVC,2016-06-02 10:00:00,525,1386,Thursday,10,1911
2347,CIVC,2016-06-02 11:00:00,555,902,Thursday,11,1457
2348,CIVC,2016-06-02 12:00:00,793,751,Thursday,12,1544
2349,CIVC,2016-06-02 13:00:00,726,721,Thursday,13,1447
2350,CIVC,2016-06-02 14:00:00,1061,683,Thursday,14,1744
2351,CIVC,2016-06-02 15:00:00,1650,656,Thursday,15,2306
2352,CIVC,2016-06-02 16:00:00,2752,782,Thursday,16,3534
2353,CIVC,2016-06-02 17:00:00,5813,1158,Thursday,17,6971
2354,CIVC,2016-06-02 18:00:00,4283,1051,Thursday,18,5334
2355,CIVC,2016-06-02 19:00:00,2006,689,Thursday,19,2695
2356,CIVC,2016-06-02 20:00:00,1190,418,Thursday,20,1608
2357,CIVC,2016-06-02 21:00:00,1062,479,Thursday,21,1541
2358,CIVC,2016-06-02 22:00:00,835,283,Thursday,22,1118
2359,CIVC,2016-06-02 23:00:00,642,161,Thursday,23,803
2360,CIVC,2016-06-03 00:00:00,356,81,Friday,0,437
2361,CIVC,2016-06-03 01:00:00,53,7,Friday,1,60
2362,CIVC,2016-06-03 04:00:00,15,19,Friday,4,34
2363,CIVC,2016-06-03 05:00:00,63,411,Friday,5,474
2364,CIVC,2016-06-03 06:00:00,184,1523,Friday,6,1707
2365,CIVC,2016-06-03 07:00:00,505,3513,Friday,7,4018
2366,CIVC,2016-06-03 08:00:00,888,4284,Friday,8,5172
2367,CIVC,2016-06-03 09:00:00,787,2671,Friday,9,3458
2368,CIVC,2016-06-03 10:00:00,513,1409,Friday,10,1922
2369,CIVC,2016-06-03 11:00:00,612,919,Friday,11,1531
2370,CIVC,2016-06-03 12:00:00,726,749,Friday,12,1475
2371,CIVC,2016-06-03 13:00:00,813,811,Friday,13,1624
2372,CIVC,2016-06-03 14:00:00,1031,807,Friday,14,1838
2373,CIVC,2016-06-03 15:00:00,1668,692,Friday,15,2360
2374,CIVC,2016-06-03 16:00:00,2832,873,Friday,16,3705
2375,CIVC,2016-06-03 17:00:00,4561,1220,Friday,17,5781
2376,CIVC,2016-06-03 18:00:00,4035,1037,Friday,18,5072
2377,CIVC,2016-06-03 19:00:00,1913,1054,Friday,19,2967
2378,CIVC,2016-06-03 20:00:00,1074,450,Friday,20,1524
2379,CIVC,2016-06-03 21:00:00,898,406,Friday,21,1304
2380,CIVC,2016-06-03 22:00:00,1255,394,Friday,22,1649
2381,CIVC,2016-06-03 23:00:00,787,345,Friday,23,1132
2382,CIVC,2016-06-04 00:00:00,470,194,Saturday,0,664
2383,CIVC,2016-06-04 01:00:00,68,24,Saturday,1,92
2384,CIVC,2016-06-04 06:00:00,59,216,Saturday,6,275
2385,CIVC,2016-06-04 07:00:00,153,373,Saturday,7,526
2386,CIVC,2016-06-04 08:00:00,258,484,Saturday,8,742
2387,CIVC,2016-06-04 09:00:00,343,591,Saturday,9,934
2388,CIVC,2016-06-04 10:00:00,398,548,Saturday,10,946
2389,CIVC,2016-06-04 11:00:00,443,577,Saturday,11,1020
2390,CIVC,2016-06-04 12:00:00,565,597,Saturday,12,1162
2391,CIVC,2016-06-04 13:00:00,520,751,Saturday,13,1271
2392,CIVC,2016-06-04 14:00:00,546,692,Saturday,14,1238
2393,CIVC,2016-06-04 15:00:00,664,608,Saturday,15,1272
2394,CIVC,2016-06-04 16:00:00,760,577,Saturday,16,1337
2395,CIVC,2016-06-04 17:00:00,836,797,Saturday,17,1633
2396,CIVC,2016-06-04 18:00:00,903,719,Saturday,18,1622
2397,CIVC,2016-06-04 19:00:00,643,846,Saturday,19,1489
2398,CIVC,2016-06-04 20:00:00,519,418,Saturday,20,937
2399,CIVC,2016-06-04 21:00:00,513,385,Saturday,21,898
2400,CIVC,2016-06-04 22:00:00,1120,322,Saturday,22,1442
2401,CIVC,2016-06-04 23:00:00,540,263,Saturday,23,803
2402,CIVC,2016-06-05 00:00:00,402,136,Sunday,0,538
2403,CIVC,2016-06-05 01:00:00,60,10,Sunday,1,70
2404,CIVC,2016-06-05 08:00:00,151,392,Sunday,8,543
2405,CIVC,2016-06-05 09:00:00,305,453,Sunday,9,758
2406,CIVC,2016-06-05 10:00:00,345,470,Sunday,10,815
2407,CIVC,2016-06-05 11:00:00,383,642,Sunday,11,1025
2408,CIVC,2016-06-05 12:00:00,474,643,Sunday,12,1117
2409,CIVC,2016-06-05 13:00:00,539,802,Sunday,13,1341
2410,CIVC,2016-06-05 14:00:00,525,598,Sunday,14,1123
2411,CIVC,2016-06-05 15:00:00,722,581,Sunday,15,1303
2412,CIVC,2016-06-05 16:00:00,984,481,Sunday,16,1465
2413,CIVC,2016-06-05 17:00:00,967,482,Sunday,17,1449
2414,CIVC,2016-06-05 18:00:00,613,406,Sunday,18,1019
2415,CIVC,2016-06-05 19:00:00,467,328,Sunday,19,795
2416,CIVC,2016-06-05 20:00:00,448,484,Sunday,20,932
2417,CIVC,2016-06-05 21:00:00,394,283,Sunday,21,677
2418,CIVC,2016-06-05 22:00:00,317,239,Sunday,22,556
2419,CIVC,2016-06-05 23:00:00,286,121,Sunday,23,407
2420,CIVC,2016-06-06 00:00:00,192,48,Monday,0,240
2421,CIVC,2016-06-06 01:00:00,11,7,Monday,1,18
2422,CIVC,2016-06-06 04:00:00,14,28,Monday,4,42
2423,CIVC,2016-06-06 05:00:00,64,451,Monday,5,515
2424,CIVC,2016-06-06 06:00:00,209,1609,Monday,6,1818
2425,CIVC,2016-06-06 07:00:00,475,3661,Monday,7,4136
2426,CIVC,2016-06-06 08:00:00,939,4817,Monday,8,5756
2427,CIVC,2016-06-06 09:00:00,836,3192,Monday,9,4028
2428,CIVC,2016-06-06 10:00:00,593,1285,Monday,10,1878
2429,CIVC,2016-06-06 11:00:00,546,803,Monday,11,1349
2430,CIVC,2016-06-06 12:00:00,623,672,Monday,12,1295
2431,CIVC,2016-06-06 13:00:00,650,705,Monday,13,1355
2432,CIVC,2016-06-06 14:00:00,830,611,Monday,14,1441
2433,CIVC,2016-06-06 15:00:00,1365,544,Monday,15,1909
2434,CIVC,2016-06-06 16:00:00,2832,689,Monday,16,3521
2435,CIVC,2016-06-06 17:00:00,4946,1084,Monday,17,6030
2436,CIVC,2016-06-06 18:00:00,4385,900,Monday,18,5285
2437,CIVC,2016-06-06 19:00:00,2061,534,Monday,19,2595
2438,CIVC,2016-06-06 20:00:00,1034,322,Monday,20,1356
2439,CIVC,2016-06-06 21:00:00,770,260,Monday,21,1030
2440,CIVC,2016-06-06 22:00:00,623,211,Monday,22,834
2441,CIVC,2016-06-06 23:00:00,393,121,Monday,23,514
2442,CIVC,2016-06-07 00:00:00,207,69,Tuesday,0,276
2443,CIVC,2016-06-07 01:00:00,34,9,Tuesday,1,43
2444,CIVC,2016-06-07 04:00:00,14,33,Tuesday,4,47
2445,CIVC,2016-06-07 05:00:00,79,509,Tuesday,5,588
2446,CIVC,2016-06-07 06:00:00,193,1579,Tuesday,6,1772
2447,CIVC,2016-06-07 07:00:00,517,3895,Tuesday,7,4412
2448,CIVC,2016-06-07 08:00:00,1019,4878,Tuesday,8,5897
2449,CIVC,2016-06-07 09:00:00,902,3260,Tuesday,9,4162
2450,CIVC,2016-06-07 10:00:00,578,1466,Tuesday,10,2044
2451,CIVC,2016-06-07 11:00:00,552,862,Tuesday,11,1414
2452,CIVC,2016-06-07 12:00:00,639,881,Tuesday,12,1520
2453,CIVC,2016-06-07 13:00:00,662,711,Tuesday,13,1373
2454,CIVC,2016-06-07 14:00:00,905,648,Tuesday,14,1553
2455,CIVC,2016-06-07 15:00:00,1566,652,Tuesday,15,2218
2456,CIVC,2016-06-07 16:00:00,2899,702,Tuesday,16,3601
2457,CIVC,2016-06-07 17:00:00,5321,1210,Tuesday,17,6531
2458,CIVC,2016-06-07 18:00:00,4479,1086,Tuesday,18,5565
2459,CIVC,2016-06-07 19:00:00,2216,627,Tuesday,19,2843
2460,CIVC,2016-06-07 20:00:00,1066,395,Tuesday,20,1461
2461,CIVC,2016-06-07 21:00:00,906,255,Tuesday,21,1161
2462,CIVC,2016-06-07 22:00:00,698,257,Tuesday,22,955
2463,CIVC,2016-06-07 23:00:00,494,128,Tuesday,23,622
2464,CIVC,2016-06-08 00:00:00,353,58,Wednesday,0,411
2465,CIVC,2016-06-08 01:00:00,54,5,Wednesday,1,59
2466,CIVC,2016-06-08 04:00:00,19,30,Wednesday,4,49
2467,CIVC,2016-06-08 05:00:00,73,483,Wednesday,5,556
2468,CIVC,2016-06-08 06:00:00,211,1719,Wednesday,6,1930
2469,CIVC,2016-06-08 07:00:00,557,3859,Wednesday,7,4416
2470,CIVC,2016-06-08 08:00:00,1019,4755,Wednesday,8,5774
2471,CIVC,2016-06-08 09:00:00,852,3185,Wednesday,9,4037
2472,CIVC,2016-06-08 10:00:00,619,1475,Wednesday,10,2094
2473,CIVC,2016-06-08 11:00:00,561,964,Wednesday,11,1525
2474,CIVC,2016-06-08 12:00:00,657,837,Wednesday,12,1494
2475,CIVC,2016-06-08 13:00:00,772,835,Wednesday,13,1607
2476,CIVC,2016-06-08 14:00:00,988,684,Wednesday,14,1672
2477,CIVC,2016-06-08 15:00:00,1493,652,Wednesday,15,2145
2478,CIVC,2016-06-08 16:00:00,3047,710,Wednesday,16,3757
2479,CIVC,2016-06-08 17:00:00,5374,1229,Wednesday,17,6603
2480,CIVC,2016-06-08 18:00:00,4754,1052,Wednesday,18,5806
2481,CIVC,2016-06-08 19:00:00,1965,661,Wednesday,19,2626
2482,CIVC,2016-06-08 20:00:00,1157,383,Wednesday,20,1540
2483,CIVC,2016-06-08 21:00:00,1096,364,Wednesday,21,1460
2484,CIVC,2016-06-08 22:00:00,856,254,Wednesday,22,1110
2485,CIVC,2016-06-08 23:00:00,632,180,Wednesday,23,812
2486,CIVC,2016-06-09 00:00:00,301,56,Thursday,0,357
2487,CIVC,2016-06-09 01:00:00,45,7,Thursday,1,52
2488,CIVC,2016-06-09 04:00:00,18,29,Thursday,4,47
2489,CIVC,2016-06-09 05:00:00,70,461,Thursday,5,531
2490,CIVC,2016-06-09 06:00:00,221,1621,Thursday,6,1842
2491,CIVC,2016-06-09 07:00:00,523,3608,Thursday,7,4131
2492,CIVC,2016-06-09 08:00:00,1000,4638,Thursday,8,5638
2493,CIVC,2016-06-09 09:00:00,786,3147,Thursday,9,3933
2494,CIVC,2016-06-09 10:00:00,585,1556,Thursday,10,2141
2495,CIVC,2016-06-09 11:00:00,595,1000,Thursday,11,1595
2496,CIVC,2016-06-09 12:00:00,724,916,Thursday,12,1640
2497,CIVC,2016-06-09 13:00:00,792,757,Thursday,13,1549
2498,CIVC,2016-06-09 14:00:00,957,679,Thursday,14,1636
2499,CIVC,2016-06-09 15:00:00,1557,636,Thursday,15,2193
2500,CIVC,2016-06-09 16:00:00,2939,774,Thursday,16,3713
2501,CIVC,2016-06-09 17:00:00,5050,1239,Thursday,17,6289
2502,CIVC,2016-06-09 18:00:00,4627,1124,Thursday,18,5751
2503,CIVC,2016-06-09 19:00:00,2167,697,Thursday,19,2864
2504,CIVC,2016-06-09 20:00:00,1238,422,Thursday,20,1660
2505,CIVC,2016-06-09 21:00:00,1046,335,Thursday,21,1381
2506,CIVC,2016-06-09 22:00:00,771,293,Thursday,22,1064
2507,CIVC,2016-06-09 23:00:00,654,180,Thursday,23,834
2508,CIVC,2016-06-10 00:00:00,344,63,Friday,0,407
2509,CIVC,2016-06-10 01:00:00,40,7,Friday,1,47
2510,CIVC,2016-06-10 04:00:00,25,31,Friday,4,56
2511,CIVC,2016-06-10 05:00:00,85,416,Friday,5,501
2512,CIVC,2016-06-10 06:00:00,185,1445,Friday,6,1630
2513,CIVC,2016-06-10 07:00:00,500,3311,Friday,7,3811
2514,CIVC,2016-06-10 08:00:00,865,4151,Friday,8,5016
2515,CIVC,2016-06-10 09:00:00,823,2662,Friday,9,3485
2516,CIVC,2016-06-10 10:00:00,533,1597,Friday,10,2130
2517,CIVC,2016-06-10 11:00:00,583,1000,Friday,11,1583
2518,CIVC,2016-06-10 12:00:00,698,788,Friday,12,1486
2519,CIVC,2016-06-10 13:00:00,848,831,Friday,13,1679
2520,CIVC,2016-06-10 14:00:00,1131,677,Friday,14,1808
2521,CIVC,2016-06-10 15:00:00,1703,663,Friday,15,2366
2522,CIVC,2016-06-10 16:00:00,2759,858,Friday,16,3617
2523,CIVC,2016-06-10 17:00:00,4839,1349,Friday,17,6188
2524,CIVC,2016-06-10 18:00:00,3787,1268,Friday,18,5055
2525,CIVC,2016-06-10 19:00:00,1555,766,Friday,19,2321
2526,CIVC,2016-06-10 20:00:00,918,436,Friday,20,1354
2527,CIVC,2016-06-10 21:00:00,1058,398,Friday,21,1456
2528,CIVC,2016-06-10 22:00:00,882,417,Friday,22,1299
2529,CIVC,2016-06-10 23:00:00,858,228,Friday,23,1086
2530,CIVC,2016-06-11 00:00:00,511,147,Saturday,0,658
2531,CIVC,2016-06-11 01:00:00,65,12,Saturday,1,77
2532,CIVC,2016-06-11 06:00:00,64,161,Saturday,6,225
2533,CIVC,2016-06-11 07:00:00,154,390,Saturday,7,544
2534,CIVC,2016-06-11 08:00:00,258,441,Saturday,8,699
2535,CIVC,2016-06-11 09:00:00,371,598,Saturday,9,969
2536,CIVC,2016-06-11 10:00:00,376,551,Saturday,10,927
2537,CIVC,2016-06-11 11:00:00,440,679,Saturday,11,1119
2538,CIVC,2016-06-11 12:00:00,507,812,Saturday,12,1319
2539,CIVC,2016-06-11 13:00:00,518,781,Saturday,13,1299
2540,CIVC,2016-06-11 14:00:00,573,668,Saturday,14,1241
2541,CIVC,2016-06-11 15:00:00,607,572,Saturday,15,1179
2542,CIVC,2016-06-11 16:00:00,870,551,Saturday,16,1421
2543,CIVC,2016-06-11 17:00:00,916,699,Saturday,17,1615
2544,CIVC,2016-06-11 18:00:00,873,825,Saturday,18,1698
2545,CIVC,2016-06-11 19:00:00,695,753,Saturday,19,1448
2546,CIVC,2016-06-11 20:00:00,516,335,Saturday,20,851
2547,CIVC,2016-06-11 21:00:00,596,403,Saturday,21,999
2548,CIVC,2016-06-11 22:00:00,854,266,Saturday,22,1120
2549,CIVC,2016-06-11 23:00:00,770,261,Saturday,23,1031
2550,CIVC,2016-06-12 00:00:00,350,182,Sunday,0,532
2551,CIVC,2016-06-12 01:00:00,68,18,Sunday,1,86
2552,CIVC,2016-06-12 07:00:00,1,1,Sunday,7,2
2553,CIVC,2016-06-12 08:00:00,154,385,Sunday,8,539
2554,CIVC,2016-06-12 09:00:00,293,493,Sunday,9,786
2555,CIVC,2016-06-12 10:00:00,378,550,Sunday,10,928
2556,CIVC,2016-06-12 11:00:00,432,939,Sunday,11,1371
2557,CIVC,2016-06-12 12:00:00,418,1022,Sunday,12,1440
2558,CIVC,2016-06-12 13:00:00,479,978,Sunday,13,1457
2559,CIVC,2016-06-12 14:00:00,491,624,Sunday,14,1115
2560,CIVC,2016-06-12 15:00:00,535,597,Sunday,15,1132
2561,CIVC,2016-06-12 16:00:00,735,480,Sunday,16,1215
2562,CIVC,2016-06-12 17:00:00,997,506,Sunday,17,1503
2563,CIVC,2016-06-12 18:00:00,1081,486,Sunday,18,1567
2564,CIVC,2016-06-12 19:00:00,690,406,Sunday,19,1096
2565,CIVC,2016-06-12 20:00:00,503,323,Sunday,20,826
2566,CIVC,2016-06-12 21:00:00,467,295,Sunday,21,762
2567,CIVC,2016-06-12 22:00:00,797,274,Sunday,22,1071
2568,CIVC,2016-06-12 23:00:00,307,122,Sunday,23,429
2569,CIVC,2016-06-13 00:00:00,199,112,Monday,0,311
2570,CIVC,2016-06-13 01:00:00,18,5,Monday,1,23
2571,CIVC,2016-06-13 04:00:00,9,38,Monday,4,47
2572,CIVC,2016-06-13 05:00:00,72,502,Monday,5,574
2573,CIVC,2016-06-13 06:00:00,178,1519,Monday,6,1697
2574,CIVC,2016-06-13 07:00:00,509,3763,Monday,7,4272
2575,CIVC,2016-06-13 08:00:00,1031,5005,Monday,8,6036
2576,CIVC,2016-06-13 09:00:00,825,3306,Monday,9,4131
2577,CIVC,2016-06-13 10:00:00,517,1381,Monday,10,1898
2578,CIVC,2016-06-13 11:00:00,520,869,Monday,11,1389
2579,CIVC,2016-06-13 12:00:00,721,763,Monday,12,1484
2580,CIVC,2016-06-13 13:00:00,682,719,Monday,13,1401
2581,CIVC,2016-06-13 14:00:00,874,673,Monday,14,1547
2582,CIVC,2016-06-13 15:00:00,1550,635,Monday,15,2185
2583,CIVC,2016-06-13 16:00:00,3014,752,Monday,16,3766
2584,CIVC,2016-06-13 17:00:00,5581,1263,Monday,17,6844
2585,CIVC,2016-06-13 18:00:00,4559,960,Monday,18,5519
2586,CIVC,2016-06-13 19:00:00,1827,574,Monday,19,2401
2587,CIVC,2016-06-13 20:00:00,880,298,Monday,20,1178
2588,CIVC,2016-06-13 21:00:00,957,469,Monday,21,1426
2589,CIVC,2016-06-13 22:00:00,790,311,Monday,22,1101
2590,CIVC,2016-06-13 23:00:00,409,195,Monday,23,604
2591,CIVC,2016-06-14 00:00:00,205,61,Tuesday,0,266
2592,CIVC,2016-06-14 01:00:00,27,3,Tuesday,1,30
2593,CIVC,2016-06-14 04:00:00,11,27,Tuesday,4,38
2594,CIVC,2016-06-14 05:00:00,80,500,Tuesday,5,580
2595,CIVC,2016-06-14 06:00:00,213,1735,Tuesday,6,1948
2596,CIVC,2016-06-14 07:00:00,524,3858,Tuesday,7,4382
2597,CIVC,2016-06-14 08:00:00,1076,4780,Tuesday,8,5856
2598,CIVC,2016-06-14 09:00:00,895,3453,Tuesday,9,4348
2599,CIVC,2016-06-14 10:00:00,529,1507,Tuesday,10,2036
2600,CIVC,2016-06-14 11:00:00,583,862,Tuesday,11,1445
2601,CIVC,2016-06-14 12:00:00,632,761,Tuesday,12,1393
2602,CIVC,2016-06-14 13:00:00,628,684,Tuesday,13,1312
2603,CIVC,2016-06-14 14:00:00,860,684,Tuesday,14,1544
2604,CIVC,2016-06-14 15:00:00,1598,641,Tuesday,15,2239
2605,CIVC,2016-06-14 16:00:00,2984,752,Tuesday,16,3736
2606,CIVC,2016-06-14 17:00:00,5522,1301,Tuesday,17,6823
2607,CIVC,2016-06-14 18:00:00,4375,1137,Tuesday,18,5512
2608,CIVC,2016-06-14 19:00:00,2232,568,Tuesday,19,2800
2609,CIVC,2016-06-14 20:00:00,1377,268,Tuesday,20,1645
2610,CIVC,2016-06-14 21:00:00,878,328,Tuesday,21,1206
2611,CIVC,2016-06-14 22:00:00,749,311,Tuesday,22,1060
2612,CIVC,2016-06-14 23:00:00,661,134,Tuesday,23,795
2613,COLM,2016-06-01 04:00:00,28,3,Wednesday,4,31
2614,COLM,2016-06-01 05:00:00,90,16,Wednesday,5,106
2615,COLM,2016-06-01 06:00:00,298,60,Wednesday,6,358
2616,COLM,2016-06-01 07:00:00,888,72,Wednesday,7,960
2617,COLM,2016-06-01 08:00:00,1347,87,Wednesday,8,1434
2618,COLM,2016-06-01 09:00:00,695,58,Wednesday,9,753
2619,COLM,2016-06-01 10:00:00,276,73,Wednesday,10,349
2620,COLM,2016-06-01 11:00:00,167,74,Wednesday,11,241
2621,COLM,2016-06-01 12:00:00,147,87,Wednesday,12,234
2622,COLM,2016-06-01 13:00:00,121,129,Wednesday,13,250
2623,COLM,2016-06-01 14:00:00,104,135,Wednesday,14,239
2624,COLM,2016-06-01 15:00:00,107,284,Wednesday,15,391
2625,COLM,2016-06-01 16:00:00,115,554,Wednesday,16,669
2626,COLM,2016-06-01 17:00:00,138,1279,Wednesday,17,1417
2627,COLM,2016-06-01 18:00:00,109,886,Wednesday,18,995
2628,COLM,2016-06-01 19:00:00,92,415,Wednesday,19,507
2629,COLM,2016-06-01 20:00:00,50,230,Wednesday,20,280
2630,COLM,2016-06-01 21:00:00,40,169,Wednesday,21,209
2631,COLM,2016-06-01 22:00:00,28,104,Wednesday,22,132
2632,COLM,2016-06-01 23:00:00,21,73,Wednesday,23,94
2633,COLM,2016-06-02 00:00:00,9,39,Thursday,0,48
2634,COLM,2016-06-02 01:00:00,1,6,Thursday,1,7
2635,COLM,2016-06-02 05:00:00,77,14,Thursday,5,91
2636,COLM,2016-06-02 06:00:00,278,63,Thursday,6,341
2637,COLM,2016-06-02 07:00:00,849,85,Thursday,7,934
2638,COLM,2016-06-02 08:00:00,1129,63,Thursday,8,1192
2639,COLM,2016-06-02 09:00:00,912,62,Thursday,9,974
2640,COLM,2016-06-02 10:00:00,310,64,Thursday,10,374
2641,COLM,2016-06-02 11:00:00,154,68,Thursday,11,222
2642,COLM,2016-06-02 12:00:00,130,71,Thursday,12,201
2643,COLM,2016-06-02 13:00:00,117,137,Thursday,13,254
2644,COLM,2016-06-02 14:00:00,140,232,Thursday,14,372
2645,COLM,2016-06-02 15:00:00,99,269,Thursday,15,368
2646,COLM,2016-06-02 16:00:00,128,578,Thursday,16,706
2647,COLM,2016-06-02 17:00:00,156,1225,Thursday,17,1381
2648,COLM,2016-06-02 18:00:00,125,784,Thursday,18,909
2649,COLM,2016-06-02 19:00:00,87,375,Thursday,19,462
2650,COLM,2016-06-02 20:00:00,54,219,Thursday,20,273
2651,COLM,2016-06-02 21:00:00,33,194,Thursday,21,227
2652,COLM,2016-06-02 22:00:00,40,121,Thursday,22,161
2653,COLM,2016-06-02 23:00:00,22,92,Thursday,23,114
2654,COLM,2016-06-03 00:00:00,10,43,Friday,0,53
2655,COLM,2016-06-03 01:00:00,1,8,Friday,1,9
2656,COLM,2016-06-03 04:00:00,23,1,Friday,4,24
2657,COLM,2016-06-03 05:00:00,91,17,Friday,5,108
2658,COLM,2016-06-03 06:00:00,285,53,Friday,6,338
2659,COLM,2016-06-03 07:00:00,751,90,Friday,7,841
2660,COLM,2016-06-03 08:00:00,1130,74,Friday,8,1204
2661,COLM,2016-06-03 09:00:00,595,82,Friday,9,677
2662,COLM,2016-06-03 10:00:00,324,80,Friday,10,404
2663,COLM,2016-06-03 11:00:00,175,68,Friday,11,243
2664,COLM,2016-06-03 12:00:00,122,78,Friday,12,200
2665,COLM,2016-06-03 13:00:00,146,155,Friday,13,301
2666,COLM,2016-06-03 14:00:00,135,201,Friday,14,336
2667,COLM,2016-06-03 15:00:00,106,276,Friday,15,382
2668,COLM,2016-06-03 16:00:00,123,598,Friday,16,721
2669,COLM,2016-06-03 17:00:00,178,988,Friday,17,1166
2670,COLM,2016-06-03 18:00:00,156,633,Friday,18,789
2671,COLM,2016-06-03 19:00:00,85,326,Friday,19,411
2672,COLM,2016-06-03 20:00:00,62,212,Friday,20,274
2673,COLM,2016-06-03 21:00:00,38,133,Friday,21,171
2674,COLM,2016-06-03 22:00:00,37,117,Friday,22,154
2675,COLM,2016-06-03 23:00:00,21,114,Friday,23,135
2676,COLM,2016-06-04 00:00:00,12,58,Saturday,0,70
2677,COLM,2016-06-04 01:00:00,1,12,Saturday,1,13
2678,COLM,2016-06-04 06:00:00,45,13,Saturday,6,58
2679,COLM,2016-06-04 07:00:00,86,24,Saturday,7,110
2680,COLM,2016-06-04 08:00:00,101,42,Saturday,8,143
2681,COLM,2016-06-04 09:00:00,130,65,Saturday,9,195
2682,COLM,2016-06-04 10:00:00,105,57,Saturday,10,162
2683,COLM,2016-06-04 11:00:00,97,58,Saturday,11,155
2684,COLM,2016-06-04 12:00:00,119,65,Saturday,12,184
2685,COLM,2016-06-04 13:00:00,111,91,Saturday,13,202
2686,COLM,2016-06-04 14:00:00,110,98,Saturday,14,208
2687,COLM,2016-06-04 15:00:00,95,98,Saturday,15,193
2688,COLM,2016-06-04 16:00:00,83,119,Saturday,16,202
2689,COLM,2016-06-04 17:00:00,96,131,Saturday,17,227
2690,COLM,2016-06-04 18:00:00,68,122,Saturday,18,190
2691,COLM,2016-06-04 19:00:00,57,111,Saturday,19,168
2692,COLM,2016-06-04 20:00:00,55,62,Saturday,20,117
2693,COLM,2016-06-04 21:00:00,34,68,Saturday,21,102
2694,COLM,2016-06-04 22:00:00,35,88,Saturday,22,123
2695,COLM,2016-06-04 23:00:00,20,46,Saturday,23,66
2696,COLM,2016-06-05 00:00:00,8,46,Sunday,0,54
2697,COLM,2016-06-05 01:00:00,1,11,Sunday,1,12
2698,COLM,2016-06-05 08:00:00,48,20,Sunday,8,68
2699,COLM,2016-06-05 09:00:00,107,43,Sunday,9,150
2700,COLM,2016-06-05 10:00:00,78,61,Sunday,10,139
2701,COLM,2016-06-05 11:00:00,82,42,Sunday,11,124
2702,COLM,2016-06-05 12:00:00,67,47,Sunday,12,114
2703,COLM,2016-06-05 13:00:00,109,72,Sunday,13,181
2704,COLM,2016-06-05 14:00:00,97,70,Sunday,14,167
2705,COLM,2016-06-05 15:00:00,101,98,Sunday,15,199
2706,COLM,2016-06-05 16:00:00,87,99,Sunday,16,186
2707,COLM,2016-06-05 17:00:00,50,114,Sunday,17,164
2708,COLM,2016-06-05 18:00:00,44,89,Sunday,18,133
2709,COLM,2016-06-05 19:00:00,33,100,Sunday,19,133
2710,COLM,2016-06-05 20:00:00,48,76,Sunday,20,124
2711,COLM,2016-06-05 21:00:00,47,80,Sunday,21,127
2712,COLM,2016-06-05 22:00:00,22,52,Sunday,22,74
2713,COLM,2016-06-05 23:00:00,16,45,Sunday,23,61
2714,COLM,2016-06-06 00:00:00,7,22,Monday,0,29
2715,COLM,2016-06-06 01:00:00,1,4,Monday,1,5
2716,COLM,2016-06-06 04:00:00,22,2,Monday,4,24
2717,COLM,2016-06-06 05:00:00,88,19,Monday,5,107
2718,COLM,2016-06-06 06:00:00,267,64,Monday,6,331
2719,COLM,2016-06-06 07:00:00,746,72,Monday,7,818
2720,COLM,2016-06-06 08:00:00,1324,69,Monday,8,1393
2721,COLM,2016-06-06 09:00:00,743,59,Monday,9,802
2722,COLM,2016-06-06 10:00:00,242,69,Monday,10,311
2723,COLM,2016-06-06 11:00:00,153,78,Monday,11,231
2724,COLM,2016-06-06 12:00:00,139,84,Monday,12,223
2725,COLM,2016-06-06 13:00:00,139,110,Monday,13,249
2726,COLM,2016-06-06 14:00:00,91,147,Monday,14,238
2727,COLM,2016-06-06 15:00:00,100,238,Monday,15,338
2728,COLM,2016-06-06 16:00:00,115,570,Monday,16,685
2729,COLM,2016-06-06 17:00:00,117,1063,Monday,17,1180
2730,COLM,2016-06-06 18:00:00,116,968,Monday,18,1084
2731,COLM,2016-06-06 19:00:00,71,408,Monday,19,479
2732,COLM,2016-06-06 20:00:00,52,216,Monday,20,268
2733,COLM,2016-06-06 21:00:00,44,115,Monday,21,159
2734,COLM,2016-06-06 22:00:00,39,95,Monday,22,134
2735,COLM,2016-06-06 23:00:00,15,68,Monday,23,83
2736,COLM,2016-06-07 00:00:00,7,33,Tuesday,0,40
2737,COLM,2016-06-07 04:00:00,23,4,Tuesday,4,27
2738,COLM,2016-06-07 05:00:00,95,20,Tuesday,5,115
2739,COLM,2016-06-07 06:00:00,273,57,Tuesday,6,330
2740,COLM,2016-06-07 07:00:00,889,83,Tuesday,7,972
2741,COLM,2016-06-07 08:00:00,1301,87,Tuesday,8,1388
2742,COLM,2016-06-07 09:00:00,792,65,Tuesday,9,857
2743,COLM,2016-06-07 10:00:00,333,70,Tuesday,10,403
2744,COLM,2016-06-07 11:00:00,168,82,Tuesday,11,250
2745,COLM,2016-06-07 12:00:00,118,130,Tuesday,12,248
2746,COLM,2016-06-07 13:00:00,136,102,Tuesday,13,238
2747,COLM,2016-06-07 14:00:00,143,167,Tuesday,14,310
2748,COLM,2016-06-07 15:00:00,131,327,Tuesday,15,458
2749,COLM,2016-06-07 16:00:00,131,602,Tuesday,16,733
2750,COLM,2016-06-07 17:00:00,145,1151,Tuesday,17,1296
2751,COLM,2016-06-07 18:00:00,150,842,Tuesday,18,992
2752,COLM,2016-06-07 19:00:00,85,479,Tuesday,19,564
2753,COLM,2016-06-07 20:00:00,51,182,Tuesday,20,233
2754,COLM,2016-06-07 21:00:00,36,154,Tuesday,21,190
2755,COLM,2016-06-07 22:00:00,30,131,Tuesday,22,161
2756,COLM,2016-06-07 23:00:00,20,123,Tuesday,23,143
2757,COLM,2016-06-08 00:00:00,5,35,Wednesday,0,40
2758,COLM,2016-06-08 04:00:00,16,1,Wednesday,4,17
2759,COLM,2016-06-08 05:00:00,82,21,Wednesday,5,103
2760,COLM,2016-06-08 06:00:00,296,59,Wednesday,6,355
2761,COLM,2016-06-08 07:00:00,822,74,Wednesday,7,896
2762,COLM,2016-06-08 08:00:00,1254,88,Wednesday,8,1342
2763,COLM,2016-06-08 09:00:00,758,68,Wednesday,9,826
2764,COLM,2016-06-08 10:00:00,355,66,Wednesday,10,421
2765,COLM,2016-06-08 11:00:00,164,66,Wednesday,11,230
2766,COLM,2016-06-08 12:00:00,151,89,Wednesday,12,240
2767,COLM,2016-06-08 13:00:00,111,148,Wednesday,13,259
2768,COLM,2016-06-08 14:00:00,121,167,Wednesday,14,288
2769,COLM,2016-06-08 15:00:00,112,250,Wednesday,15,362
2770,COLM,2016-06-08 16:00:00,136,627,Wednesday,16,763
2771,COLM,2016-06-08 17:00:00,153,1159,Wednesday,17,1312
2772,COLM,2016-06-08 18:00:00,144,823,Wednesday,18,967
2773,COLM,2016-06-08 19:00:00,78,363,Wednesday,19,441
2774,COLM,2016-06-08 20:00:00,62,208,Wednesday,20,270
2775,COLM,2016-06-08 21:00:00,39,184,Wednesday,21,223
2776,COLM,2016-06-08 22:00:00,31,124,Wednesday,22,155
2777,COLM,2016-06-08 23:00:00,13,113,Wednesday,23,126
2778,COLM,2016-06-09 00:00:00,8,40,Thursday,0,48
2779,COLM,2016-06-09 01:00:00,1,8,Thursday,1,9
2780,COLM,2016-06-09 04:00:00,17,2,Thursday,4,19
2781,COLM,2016-06-09 05:00:00,84,27,Thursday,5,111
2782,COLM,2016-06-09 06:00:00,268,57,Thursday,6,325
2783,COLM,2016-06-09 07:00:00,817,72,Thursday,7,889
2784,COLM,2016-06-09 08:00:00,1236,89,Thursday,8,1325
2785,COLM,2016-06-09 09:00:00,792,63,Thursday,9,855
2786,COLM,2016-06-09 10:00:00,270,75,Thursday,10,345
2787,COLM,2016-06-09 11:00:00,169,60,Thursday,11,229
2788,COLM,2016-06-09 12:00:00,140,95,Thursday,12,235
2789,COLM,2016-06-09 13:00:00,121,107,Thursday,13,228
2790,COLM,2016-06-09 14:00:00,141,164,Thursday,14,305
2791,COLM,2016-06-09 15:00:00,130,243,Thursday,15,373
2792,COLM,2016-06-09 16:00:00,115,593,Thursday,16,708
2793,COLM,2016-06-09 17:00:00,134,1086,Thursday,17,1220
2794,COLM,2016-06-09 18:00:00,133,828,Thursday,18,961
2795,COLM,2016-06-09 19:00:00,73,431,Thursday,19,504
2796,COLM,2016-06-09 20:00:00,57,194,Thursday,20,251
2797,COLM,2016-06-09 21:00:00,38,188,Thursday,21,226
2798,COLM,2016-06-09 22:00:00,28,120,Thursday,22,148
2799,COLM,2016-06-09 23:00:00,23,84,Thursday,23,107
2800,COLM,2016-06-10 00:00:00,7,41,Friday,0,48
2801,COLM,2016-06-10 01:00:00,3,5,Friday,1,8
2802,COLM,2016-06-10 04:00:00,17,3,Friday,4,20
2803,COLM,2016-06-10 05:00:00,80,16,Friday,5,96
2804,COLM,2016-06-10 06:00:00,242,53,Friday,6,295
2805,COLM,2016-06-10 07:00:00,790,72,Friday,7,862
2806,COLM,2016-06-10 08:00:00,1052,67,Friday,8,1119
2807,COLM,2016-06-10 09:00:00,593,85,Friday,9,678
2808,COLM,2016-06-10 10:00:00,268,56,Friday,10,324
2809,COLM,2016-06-10 11:00:00,169,74,Friday,11,243
2810,COLM,2016-06-10 12:00:00,128,97,Friday,12,225
2811,COLM,2016-06-10 13:00:00,142,112,Friday,13,254
2812,COLM,2016-06-10 14:00:00,133,181,Friday,14,314
2813,COLM,2016-06-10 15:00:00,129,289,Friday,15,418
2814,COLM,2016-06-10 16:00:00,156,638,Friday,16,794
2815,COLM,2016-06-10 17:00:00,184,885,Friday,17,1069
2816,COLM,2016-06-10 18:00:00,180,660,Friday,18,840
2817,COLM,2016-06-10 19:00:00,80,318,Friday,19,398
2818,COLM,2016-06-10 20:00:00,48,143,Friday,20,191
2819,COLM,2016-06-10 21:00:00,40,97,Friday,21,137
2820,COLM,2016-06-10 22:00:00,43,212,Friday,22,255
2821,COLM,2016-06-10 23:00:00,20,122,Friday,23,142
2822,COLM,2016-06-11 00:00:00,9,67,Saturday,0,76
2823,COLM,2016-06-11 01:00:00,1,14,Saturday,1,15
2824,COLM,2016-06-11 06:00:00,36,2,Saturday,6,38
2825,COLM,2016-06-11 07:00:00,79,42,Saturday,7,121
2826,COLM,2016-06-11 08:00:00,97,43,Saturday,8,140
2827,COLM,2016-06-11 09:00:00,109,49,Saturday,9,158
2828,COLM,2016-06-11 10:00:00,86,52,Saturday,10,138
2829,COLM,2016-06-11 11:00:00,108,55,Saturday,11,163
2830,COLM,2016-06-11 12:00:00,108,37,Saturday,12,145
2831,COLM,2016-06-11 13:00:00,139,81,Saturday,13,220
2832,COLM,2016-06-11 14:00:00,112,82,Saturday,14,194
2833,COLM,2016-06-11 15:00:00,98,110,Saturday,15,208
2834,COLM,2016-06-11 16:00:00,100,102,Saturday,16,202
2835,COLM,2016-06-11 17:00:00,72,119,Saturday,17,191
2836,COLM,2016-06-11 18:00:00,77,90,Saturday,18,167
2837,COLM,2016-06-11 19:00:00,54,133,Saturday,19,187
2838,COLM,2016-06-11 20:00:00,50,71,Saturday,20,121
2839,COLM,2016-06-11 21:00:00,40,74,Saturday,21,114
2840,COLM,2016-06-11 22:00:00,34,110,Saturday,22,144
2841,COLM,2016-06-11 23:00:00,18,63,Saturday,23,81
2842,COLM,2016-06-12 00:00:00,12,48,Sunday,0,60
2843,COLM,2016-06-12 01:00:00,1,8,Sunday,1,9
2844,COLM,2016-06-12 08:00:00,49,29,Sunday,8,78
2845,COLM,2016-06-12 09:00:00,110,47,Sunday,9,157
2846,COLM,2016-06-12 10:00:00,85,59,Sunday,10,144
2847,COLM,2016-06-12 11:00:00,92,54,Sunday,11,146
2848,COLM,2016-06-12 12:00:00,118,56,Sunday,12,174
2849,COLM,2016-06-12 13:00:00,133,84,Sunday,13,217
2850,COLM,2016-06-12 14:00:00,93,62,Sunday,14,155
2851,COLM,2016-06-12 15:00:00,112,75,Sunday,15,187
2852,COLM,2016-06-12 16:00:00,60,104,Sunday,16,164
2853,COLM,2016-06-12 17:00:00,79,135,Sunday,17,214
2854,COLM,2016-06-12 18:00:00,81,119,Sunday,18,200
2855,COLM,2016-06-12 19:00:00,50,107,Sunday,19,157
2856,COLM,2016-06-12 20:00:00,56,105,Sunday,20,161
2857,COLM,2016-06-12 21:00:00,41,85,Sunday,21,126
2858,COLM,2016-06-12 22:00:00,33,50,Sunday,22,83
2859,COLM,2016-06-12 23:00:00,13,55,Sunday,23,68
2860,COLM,2016-06-13 00:00:00,7,51,Monday,0,58
2861,COLM,2016-06-13 01:00:00,1,5,Monday,1,6
2862,COLM,2016-06-13 04:00:00,18,1,Monday,4,19
2863,COLM,2016-06-13 05:00:00,112,13,Monday,5,125
2864,COLM,2016-06-13 06:00:00,271,62,Monday,6,333
2865,COLM,2016-06-13 07:00:00,796,75,Monday,7,871
2866,COLM,2016-06-13 08:00:00,1285,67,Monday,8,1352
2867,COLM,2016-06-13 09:00:00,742,67,Monday,9,809
2868,COLM,2016-06-13 10:00:00,265,71,Monday,10,336
2869,COLM,2016-06-13 11:00:00,176,83,Monday,11,259
2870,COLM,2016-06-13 12:00:00,127,76,Monday,12,203
2871,COLM,2016-06-13 13:00:00,118,117,Monday,13,235
2872,COLM,2016-06-13 14:00:00,117,167,Monday,14,284
2873,COLM,2016-06-13 15:00:00,120,263,Monday,15,383
2874,COLM,2016-06-13 16:00:00,149,621,Monday,16,770
2875,COLM,2016-06-13 17:00:00,165,1068,Monday,17,1233
2876,COLM,2016-06-13 18:00:00,126,930,Monday,18,1056
2877,COLM,2016-06-13 19:00:00,64,360,Monday,19,424
2878,COLM,2016-06-13 20:00:00,38,155,Monday,20,193
2879,COLM,2016-06-13 21:00:00,37,191,Monday,21,228
2880,COLM,2016-06-13 22:00:00,38,121,Monday,22,159
2881,COLM,2016-06-13 23:00:00,23,123,Monday,23,146
2882,COLM,2016-06-14 00:00:00,4,33,Tuesday,0,37
2883,COLM,2016-06-14 05:00:00,106,22,Tuesday,5,128
2884,COLM,2016-06-14 06:00:00,312,68,Tuesday,6,380
2885,COLM,2016-06-14 07:00:00,852,73,Tuesday,7,925
2886,COLM,2016-06-14 08:00:00,1376,86,Tuesday,8,1462
2887,COLM,2016-06-14 09:00:00,745,68,Tuesday,9,813
2888,COLM,2016-06-14 10:00:00,277,61,Tuesday,10,338
2889,COLM,2016-06-14 11:00:00,163,84,Tuesday,11,247
2890,COLM,2016-06-14 12:00:00,139,111,Tuesday,12,250
2891,COLM,2016-06-14 13:00:00,119,128,Tuesday,13,247
2892,COLM,2016-06-14 14:00:00,126,187,Tuesday,14,313
2893,COLM,2016-06-14 15:00:00,123,242,Tuesday,15,365
2894,COLM,2016-06-14 16:00:00,125,610,Tuesday,16,735
2895,COLM,2016-06-14 17:00:00,146,1123,Tuesday,17,1269
2896,COLM,2016-06-14 18:00:00,143,833,Tuesday,18,976
2897,COLM,2016-06-14 19:00:00,100,504,Tuesday,19,604
2898,COLM,2016-06-14 20:00:00,51,218,Tuesday,20,269
2899,COLM,2016-06-14 21:00:00,36,145,Tuesday,21,181
2900,COLM,2016-06-14 22:00:00,35,143,Tuesday,22,178
2901,COLM,2016-06-14 23:00:00,21,109,Tuesday,23,130
2902,COLS,2016-06-01 01:00:00,3,7,Wednesday,1,10
2903,COLS,2016-06-01 04:00:00,2,9,Wednesday,4,11
2904,COLS,2016-06-01 05:00:00,183,62,Wednesday,5,245
2905,COLS,2016-06-01 06:00:00,414,197,Wednesday,6,611
2906,COLS,2016-06-01 07:00:00,677,323,Wednesday,7,1000
2907,COLS,2016-06-01 08:00:00,781,266,Wednesday,8,1047
2908,COLS,2016-06-01 09:00:00,562,220,Wednesday,9,782
2909,COLS,2016-06-01 10:00:00,270,413,Wednesday,10,683
2910,COLS,2016-06-01 11:00:00,224,786,Wednesday,11,1010
2911,COLS,2016-06-01 12:00:00,213,886,Wednesday,12,1099
2912,COLS,2016-06-01 13:00:00,211,283,Wednesday,13,494
2913,COLS,2016-06-01 14:00:00,318,256,Wednesday,14,574
2914,COLS,2016-06-01 15:00:00,1258,400,Wednesday,15,1658
2915,COLS,2016-06-01 16:00:00,876,586,Wednesday,16,1462
2916,COLS,2016-06-01 17:00:00,369,698,Wednesday,17,1067
2917,COLS,2016-06-01 18:00:00,295,566,Wednesday,18,861
2918,COLS,2016-06-01 19:00:00,108,299,Wednesday,19,407
2919,COLS,2016-06-01 20:00:00,101,188,Wednesday,20,289
2920,COLS,2016-06-01 21:00:00,77,188,Wednesday,21,265
2921,COLS,2016-06-01 22:00:00,85,141,Wednesday,22,226
2922,COLS,2016-06-01 23:00:00,49,111,Wednesday,23,160
2923,COLS,2016-06-02 00:00:00,26,73,Thursday,0,99
2924,COLS,2016-06-02 01:00:00,11,10,Thursday,1,21
2925,COLS,2016-06-02 04:00:00,9,8,Thursday,4,17
2926,COLS,2016-06-02 05:00:00,181,69,Thursday,5,250
2927,COLS,2016-06-02 06:00:00,428,185,Thursday,6,613
2928,COLS,2016-06-02 07:00:00,675,325,Thursday,7,1000
2929,COLS,2016-06-02 08:00:00,796,254,Thursday,8,1050
2930,COLS,2016-06-02 09:00:00,551,132,Thursday,9,683
2931,COLS,2016-06-02 10:00:00,314,131,Thursday,10,445
2932,COLS,2016-06-02 11:00:00,178,154,Thursday,11,332
2933,COLS,2016-06-02 12:00:00,211,183,Thursday,12,394
2934,COLS,2016-06-02 13:00:00,196,236,Thursday,13,432
2935,COLS,2016-06-02 14:00:00,181,401,Thursday,14,582
2936,COLS,2016-06-02 15:00:00,260,857,Thursday,15,1117
2937,COLS,2016-06-02 16:00:00,303,2430,Thursday,16,2733
2938,COLS,2016-06-02 17:00:00,383,3279,Thursday,17,3662
2939,COLS,2016-06-02 18:00:00,289,989,Thursday,18,1278
2940,COLS,2016-06-02 19:00:00,206,298,Thursday,19,504
2941,COLS,2016-06-02 20:00:00,196,212,Thursday,20,408
2942,COLS,2016-06-02 21:00:00,3667,241,Thursday,21,3908
2943,COLS,2016-06-02 22:00:00,720,155,Thursday,22,875
2944,COLS,2016-06-02 23:00:00,96,83,Thursday,23,179
2945,COLS,2016-06-03 00:00:00,30,64,Friday,0,94
2946,COLS,2016-06-03 01:00:00,5,10,Friday,1,15
2947,COLS,2016-06-03 04:00:00,5,5,Friday,4,10
2948,COLS,2016-06-03 05:00:00,177,65,Friday,5,242
2949,COLS,2016-06-03 06:00:00,370,166,Friday,6,536
2950,COLS,2016-06-03 07:00:00,641,316,Friday,7,957
2951,COLS,2016-06-03 08:00:00,717,245,Friday,8,962
2952,COLS,2016-06-03 09:00:00,560,141,Friday,9,701
2953,COLS,2016-06-03 10:00:00,249,130,Friday,10,379
2954,COLS,2016-06-03 11:00:00,243,177,Friday,11,420
2955,COLS,2016-06-03 12:00:00,209,229,Friday,12,438
2956,COLS,2016-06-03 13:00:00,219,286,Friday,13,505
2957,COLS,2016-06-03 14:00:00,240,360,Friday,14,600
2958,COLS,2016-06-03 15:00:00,229,360,Friday,15,589
2959,COLS,2016-06-03 16:00:00,365,603,Friday,16,968
2960,COLS,2016-06-03 17:00:00,336,595,Friday,17,931
2961,COLS,2016-06-03 18:00:00,202,486,Friday,18,688
2962,COLS,2016-06-03 19:00:00,140,296,Friday,19,436
2963,COLS,2016-06-03 20:00:00,99,235,Friday,20,334
2964,COLS,2016-06-03 21:00:00,106,204,Friday,21,310
2965,COLS,2016-06-03 22:00:00,82,161,Friday,22,243
2966,COLS,2016-06-03 23:00:00,68,117,Friday,23,185
2967,COLS,2016-06-04 00:00:00,43,78,Saturday,0,121
2968,COLS,2016-06-04 01:00:00,2,13,Saturday,1,15
2969,COLS,2016-06-04 06:00:00,101,27,Saturday,6,128
2970,COLS,2016-06-04 07:00:00,131,79,Saturday,7,210
2971,COLS,2016-06-04 08:00:00,174,94,Saturday,8,268
2972,COLS,2016-06-04 09:00:00,178,71,Saturday,9,249
2973,COLS,2016-06-04 10:00:00,202,90,Saturday,10,292
2974,COLS,2016-06-04 11:00:00,160,98,Saturday,11,258
2975,COLS,2016-06-04 12:00:00,171,150,Saturday,12,321
2976,COLS,2016-06-04 13:00:00,214,164,Saturday,13,378
2977,COLS,2016-06-04 14:00:00,193,169,Saturday,14,362
2978,COLS,2016-06-04 15:00:00,163,174,Saturday,15,337
2979,COLS,2016-06-04 16:00:00,143,200,Saturday,16,343
2980,COLS,2016-06-04 17:00:00,148,198,Saturday,17,346
2981,COLS,2016-06-04 18:00:00,109,202,Saturday,18,311
2982,COLS,2016-06-04 19:00:00,118,156,Saturday,19,274
2983,COLS,2016-06-04 20:00:00,88,131,Saturday,20,219
2984,COLS,2016-06-04 21:00:00,70,101,Saturday,21,171
2985,COLS,2016-06-04 22:00:00,61,141,Saturday,22,202
2986,COLS,2016-06-04 23:00:00,41,86,Saturday,23,127
2987,COLS,2016-06-05 00:00:00,19,68,Sunday,0,87
2988,COLS,2016-06-05 01:00:00,5,4,Sunday,1,9
2989,COLS,2016-06-05 06:00:00,1,1,Sunday,6,2
2990,COLS,2016-06-05 08:00:00,140,69,Sunday,8,209
2991,COLS,2016-06-05 09:00:00,127,42,Sunday,9,169
2992,COLS,2016-06-05 10:00:00,156,109,Sunday,10,265
2993,COLS,2016-06-05 11:00:00,168,136,Sunday,11,304
2994,COLS,2016-06-05 12:00:00,134,163,Sunday,12,297
2995,COLS,2016-06-05 13:00:00,159,323,Sunday,13,482
2996,COLS,2016-06-05 14:00:00,179,652,Sunday,14,831
2997,COLS,2016-06-05 15:00:00,125,1704,Sunday,15,1829
2998,COLS,2016-06-05 16:00:00,168,1882,Sunday,16,2050
2999,COLS,2016-06-05 17:00:00,190,317,Sunday,17,507
3000,COLS,2016-06-05 18:00:00,193,176,Sunday,18,369
3001,COLS,2016-06-05 19:00:00,289,143,Sunday,19,432
3002,COLS,2016-06-05 20:00:00,3129,152,Sunday,20,3281
3003,COLS,2016-06-05 21:00:00,556,109,Sunday,21,665
3004,COLS,2016-06-05 22:00:00,73,84,Sunday,22,157
3005,COLS,2016-06-05 23:00:00,43,91,Sunday,23,134
3006,COLS,2016-06-06 00:00:00,17,55,Monday,0,72
3007,COLS,2016-06-06 01:00:00,3,6,Monday,1,9
3008,COLS,2016-06-06 04:00:00,10,12,Monday,4,22
3009,COLS,2016-06-06 05:00:00,157,48,Monday,5,205
3010,COLS,2016-06-06 06:00:00,371,168,Monday,6,539
3011,COLS,2016-06-06 07:00:00,619,287,Monday,7,906
3012,COLS,2016-06-06 08:00:00,742,251,Monday,8,993
3013,COLS,2016-06-06 09:00:00,513,130,Monday,9,643
3014,COLS,2016-06-06 10:00:00,260,106,Monday,10,366
3015,COLS,2016-06-06 11:00:00,210,140,Monday,11,350
3016,COLS,2016-06-06 12:00:00,214,182,Monday,12,396
3017,COLS,2016-06-06 13:00:00,228,220,Monday,13,448
3018,COLS,2016-06-06 14:00:00,235,214,Monday,14,449
3019,COLS,2016-06-06 15:00:00,204,317,Monday,15,521
3020,COLS,2016-06-06 16:00:00,321,580,Monday,16,901
3021,COLS,2016-06-06 17:00:00,320,705,Monday,17,1025
3022,COLS,2016-06-06 18:00:00,244,574,Monday,18,818
3023,COLS,2016-06-06 19:00:00,117,276,Monday,19,393
3024,COLS,2016-06-06 20:00:00,81,181,Monday,20,262
3025,COLS,2016-06-06 21:00:00,83,197,Monday,21,280
3026,COLS,2016-06-06 22:00:00,70,133,Monday,22,203
3027,COLS,2016-06-06 23:00:00,52,101,Monday,23,153
3028,COLS,2016-06-07 00:00:00,35,48,Tuesday,0,83
3029,COLS,2016-06-07 01:00:00,5,6,Tuesday,1,11
3030,COLS,2016-06-07 04:00:00,2,10,Tuesday,4,12
3031,COLS,2016-06-07 05:00:00,195,45,Tuesday,5,240
3032,COLS,2016-06-07 06:00:00,374,199,Tuesday,6,573
3033,COLS,2016-06-07 07:00:00,679,314,Tuesday,7,993
3034,COLS,2016-06-07 08:00:00,795,241,Tuesday,8,1036
3035,COLS,2016-06-07 09:00:00,544,135,Tuesday,9,679
3036,COLS,2016-06-07 10:00:00,272,135,Tuesday,10,407
3037,COLS,2016-06-07 11:00:00,204,130,Tuesday,11,334
3038,COLS,2016-06-07 12:00:00,201,170,Tuesday,12,371
3039,COLS,2016-06-07 13:00:00,216,188,Tuesday,13,404
3040,COLS,2016-06-07 14:00:00,225,272,Tuesday,14,497
3041,COLS,2016-06-07 15:00:00,249,386,Tuesday,15,635
3042,COLS,2016-06-07 16:00:00,329,548,Tuesday,16,877
3043,COLS,2016-06-07 17:00:00,396,771,Tuesday,17,1167
3044,COLS,2016-06-07 18:00:00,263,554,Tuesday,18,817
3045,COLS,2016-06-07 19:00:00,112,287,Tuesday,19,399
3046,COLS,2016-06-07 20:00:00,89,200,Tuesday,20,289
3047,COLS,2016-06-07 21:00:00,85,180,Tuesday,21,265
3048,COLS,2016-06-07 22:00:00,71,158,Tuesday,22,229
3049,COLS,2016-06-07 23:00:00,43,122,Tuesday,23,165
3050,COLS,2016-06-08 00:00:00,24,64,Wednesday,0,88
3051,COLS,2016-06-08 01:00:00,6,4,Wednesday,1,10
3052,COLS,2016-06-08 04:00:00,9,10,Wednesday,4,19
3053,COLS,2016-06-08 05:00:00,187,56,Wednesday,5,243
3054,COLS,2016-06-08 06:00:00,378,190,Wednesday,6,568
3055,COLS,2016-06-08 07:00:00,681,321,Wednesday,7,1002
3056,COLS,2016-06-08 08:00:00,720,247,Wednesday,8,967
3057,COLS,2016-06-08 09:00:00,571,132,Wednesday,9,703
3058,COLS,2016-06-08 10:00:00,241,137,Wednesday,10,378
3059,COLS,2016-06-08 11:00:00,225,141,Wednesday,11,366
3060,COLS,2016-06-08 12:00:00,209,179,Wednesday,12,388
3061,COLS,2016-06-08 13:00:00,188,240,Wednesday,13,428
3062,COLS,2016-06-08 14:00:00,234,316,Wednesday,14,550
3063,COLS,2016-06-08 15:00:00,224,416,Wednesday,15,640
3064,COLS,2016-06-08 16:00:00,309,1066,Wednesday,16,1375
3065,COLS,2016-06-08 17:00:00,377,3063,Wednesday,17,3440
3066,COLS,2016-06-08 18:00:00,251,1612,Wednesday,18,1863
3067,COLS,2016-06-08 19:00:00,114,365,Wednesday,19,479
3068,COLS,2016-06-08 20:00:00,542,179,Wednesday,20,721
3069,COLS,2016-06-08 21:00:00,2973,200,Wednesday,21,3173
3070,COLS,2016-06-08 22:00:00,306,181,Wednesday,22,487
3071,COLS,2016-06-08 23:00:00,49,136,Wednesday,23,185
3072,COLS,2016-06-09 00:00:00,21,47,Thursday,0,68
3073,COLS,2016-06-09 01:00:00,4,5,Thursday,1,9
3074,COLS,2016-06-09 04:00:00,6,10,Thursday,4,16
3075,COLS,2016-06-09 05:00:00,194,55,Thursday,5,249
3076,COLS,2016-06-09 06:00:00,369,175,Thursday,6,544
3077,COLS,2016-06-09 07:00:00,625,259,Thursday,7,884
3078,COLS,2016-06-09 08:00:00,794,278,Thursday,8,1072
3079,COLS,2016-06-09 09:00:00,557,120,Thursday,9,677
3080,COLS,2016-06-09 10:00:00,331,121,Thursday,10,452
3081,COLS,2016-06-09 11:00:00,198,133,Thursday,11,331
3082,COLS,2016-06-09 12:00:00,168,169,Thursday,12,337
3083,COLS,2016-06-09 13:00:00,215,166,Thursday,13,381
3084,COLS,2016-06-09 14:00:00,217,323,Thursday,14,540
3085,COLS,2016-06-09 15:00:00,238,369,Thursday,15,607
3086,COLS,2016-06-09 16:00:00,310,582,Thursday,16,892
3087,COLS,2016-06-09 17:00:00,330,714,Thursday,17,1044
3088,COLS,2016-06-09 18:00:00,232,521,Thursday,18,753
3089,COLS,2016-06-09 19:00:00,109,364,Thursday,19,473
3090,COLS,2016-06-09 20:00:00,69,208,Thursday,20,277
3091,COLS,2016-06-09 21:00:00,102,186,Thursday,21,288
3092,COLS,2016-06-09 22:00:00,66,160,Thursday,22,226
3093,COLS,2016-06-09 23:00:00,48,97,Thursday,23,145
3094,COLS,2016-06-10 00:00:00,22,58,Friday,0,80
3095,COLS,2016-06-10 01:00:00,5,4,Friday,1,9
3096,COLS,2016-06-10 04:00:00,8,8,Friday,4,16
3097,COLS,2016-06-10 05:00:00,172,49,Friday,5,221
3098,COLS,2016-06-10 06:00:00,350,166,Friday,6,516
3099,COLS,2016-06-10 07:00:00,614,280,Friday,7,894
3100,COLS,2016-06-10 08:00:00,686,257,Friday,8,943
3101,COLS,2016-06-10 09:00:00,430,141,Friday,9,571
3102,COLS,2016-06-10 10:00:00,291,123,Friday,10,414
3103,COLS,2016-06-10 11:00:00,217,114,Friday,11,331
3104,COLS,2016-06-10 12:00:00,227,193,Friday,12,420
3105,COLS,2016-06-10 13:00:00,249,264,Friday,13,513
3106,COLS,2016-06-10 14:00:00,238,322,Friday,14,560
3107,COLS,2016-06-10 15:00:00,261,441,Friday,15,702
3108,COLS,2016-06-10 16:00:00,312,1069,Friday,16,1381
3109,COLS,2016-06-10 17:00:00,360,3479,Friday,17,3839
3110,COLS,2016-06-10 18:00:00,237,2097,Friday,18,2334
3111,COLS,2016-06-10 19:00:00,131,365,Friday,19,496
3112,COLS,2016-06-10 20:00:00,123,241,Friday,20,364
3113,COLS,2016-06-10 21:00:00,2454,218,Friday,21,2672
3114,COLS,2016-06-10 22:00:00,1759,151,Friday,22,1910
3115,COLS,2016-06-10 23:00:00,101,157,Friday,23,258
3116,COLS,2016-06-11 00:00:00,41,64,Saturday,0,105
3117,COLS,2016-06-11 01:00:00,6,10,Saturday,1,16
3118,COLS,2016-06-11 06:00:00,95,44,Saturday,6,139
3119,COLS,2016-06-11 07:00:00,127,80,Saturday,7,207
3120,COLS,2016-06-11 08:00:00,163,91,Saturday,8,254
3121,COLS,2016-06-11 09:00:00,160,68,Saturday,9,228
3122,COLS,2016-06-11 10:00:00,173,90,Saturday,10,263
3123,COLS,2016-06-11 11:00:00,170,90,Saturday,11,260
3124,COLS,2016-06-11 12:00:00,184,108,Saturday,12,292
3125,COLS,2016-06-11 13:00:00,167,131,Saturday,13,298
3126,COLS,2016-06-11 14:00:00,175,116,Saturday,14,291
3127,COLS,2016-06-11 15:00:00,191,166,Saturday,15,357
3128,COLS,2016-06-11 16:00:00,146,160,Saturday,16,306
3129,COLS,2016-06-11 17:00:00,111,195,Saturday,17,306
3130,COLS,2016-06-11 18:00:00,99,179,Saturday,18,278
3131,COLS,2016-06-11 19:00:00,101,159,Saturday,19,260
3132,COLS,2016-06-11 20:00:00,75,137,Saturday,20,212
3133,COLS,2016-06-11 21:00:00,66,135,Saturday,21,201
3134,COLS,2016-06-11 22:00:00,66,132,Saturday,22,198
3135,COLS,2016-06-11 23:00:00,54,118,Saturday,23,172
3136,COLS,2016-06-12 00:00:00,30,69,Sunday,0,99
3137,COLS,2016-06-12 01:00:00,2,11,Sunday,1,13
3138,COLS,2016-06-12 07:00:00,1,2,Sunday,7,3
3139,COLS,2016-06-12 08:00:00,138,78,Sunday,8,216
3140,COLS,2016-06-12 09:00:00,135,64,Sunday,9,199
3141,COLS,2016-06-12 10:00:00,154,87,Sunday,10,241
3142,COLS,2016-06-12 11:00:00,153,109,Sunday,11,262
3143,COLS,2016-06-12 12:00:00,132,109,Sunday,12,241
3144,COLS,2016-06-12 13:00:00,161,93,Sunday,13,254
3145,COLS,2016-06-12 14:00:00,165,124,Sunday,14,289
3146,COLS,2016-06-12 15:00:00,153,109,Sunday,15,262
3147,COLS,2016-06-12 16:00:00,122,167,Sunday,16,289
3148,COLS,2016-06-12 17:00:00,100,286,Sunday,17,386
3149,COLS,2016-06-12 18:00:00,94,848,Sunday,18,942
3150,COLS,2016-06-12 19:00:00,67,1451,Sunday,19,1518
3151,COLS,2016-06-12 20:00:00,80,337,Sunday,20,417
3152,COLS,2016-06-12 21:00:00,89,171,Sunday,21,260
3153,COLS,2016-06-12 22:00:00,128,123,Sunday,22,251
3154,COLS,2016-06-12 23:00:00,650,91,Sunday,23,741
3155,COLS,2016-06-13 00:00:00,1412,53,Monday,0,1465
3156,COLS,2016-06-13 01:00:00,69,4,Monday,1,73
3157,COLS,2016-06-13 04:00:00,13,18,Monday,4,31
3158,COLS,2016-06-13 05:00:00,172,70,Monday,5,242
3159,COLS,2016-06-13 06:00:00,333,164,Monday,6,497
3160,COLS,2016-06-13 07:00:00,593,284,Monday,7,877
3161,COLS,2016-06-13 08:00:00,674,226,Monday,8,900
3162,COLS,2016-06-13 09:00:00,465,120,Monday,9,585
3163,COLS,2016-06-13 10:00:00,251,134,Monday,10,385
3164,COLS,2016-06-13 11:00:00,262,153,Monday,11,415
3165,COLS,2016-06-13 12:00:00,188,179,Monday,12,367
3166,COLS,2016-06-13 13:00:00,207,258,Monday,13,465
3167,COLS,2016-06-13 14:00:00,230,436,Monday,14,666
3168,COLS,2016-06-13 15:00:00,252,927,Monday,15,1179
3169,COLS,2016-06-13 16:00:00,307,2858,Monday,16,3165
3170,COLS,2016-06-13 17:00:00,390,3909,Monday,17,4299
3171,COLS,2016-06-13 18:00:00,334,2524,Monday,18,2858
3172,COLS,2016-06-13 19:00:00,201,790,Monday,19,991
3173,COLS,2016-06-13 20:00:00,204,299,Monday,20,503
3174,COLS,2016-06-13 21:00:00,4163,226,Monday,21,4389
3175,COLS,2016-06-13 22:00:00,2582,170,Monday,22,2752
3176,COLS,2016-06-13 23:00:00,786,117,Monday,23,903
3177,COLS,2016-06-14 00:00:00,51,78,Tuesday,0,129
3178,COLS,2016-06-14 01:00:00,6,7,Tuesday,1,13
3179,COLS,2016-06-14 04:00:00,14,12,Tuesday,4,26
3180,COLS,2016-06-14 05:00:00,185,63,Tuesday,5,248
3181,COLS,2016-06-14 06:00:00,369,196,Tuesday,6,565
3182,COLS,2016-06-14 07:00:00,684,304,Tuesday,7,988
3183,COLS,2016-06-14 08:00:00,723,256,Tuesday,8,979
3184,COLS,2016-06-14 09:00:00,514,143,Tuesday,9,657
3185,COLS,2016-06-14 10:00:00,270,116,Tuesday,10,386
3186,COLS,2016-06-14 11:00:00,197,137,Tuesday,11,334
3187,COLS,2016-06-14 12:00:00,215,148,Tuesday,12,363
3188,COLS,2016-06-14 13:00:00,190,226,Tuesday,13,416
3189,COLS,2016-06-14 14:00:00,232,223,Tuesday,14,455
3190,COLS,2016-06-14 15:00:00,240,432,Tuesday,15,672
3191,COLS,2016-06-14 16:00:00,279,629,Tuesday,16,908
3192,COLS,2016-06-14 17:00:00,394,1184,Tuesday,17,1578
3193,COLS,2016-06-14 18:00:00,216,1543,Tuesday,18,1759
3194,COLS,2016-06-14 19:00:00,120,586,Tuesday,19,706
3195,COLS,2016-06-14 20:00:00,124,236,Tuesday,20,360
3196,COLS,2016-06-14 21:00:00,439,192,Tuesday,21,631
3197,COLS,2016-06-14 22:00:00,953,166,Tuesday,22,1119
3198,COLS,2016-06-14 23:00:00,431,119,Tuesday,23,550
3199,CONC,2016-06-01 01:00:00,3,11,Wednesday,1,14
3200,CONC,2016-06-01 04:00:00,14,2,Wednesday,4,16
3201,CONC,2016-06-01 05:00:00,253,21,Wednesday,5,274
3202,CONC,2016-06-01 06:00:00,642,116,Wednesday,6,758
3203,CONC,2016-06-01 07:00:00,1229,179,Wednesday,7,1408
3204,CONC,2016-06-01 08:00:00,1429,186,Wednesday,8,1615
3205,CONC,2016-06-01 09:00:00,785,143,Wednesday,9,928
3206,CONC,2016-06-01 10:00:00,380,116,Wednesday,10,496
3207,CONC,2016-06-01 11:00:00,208,101,Wednesday,11,309
3208,CONC,2016-06-01 12:00:00,243,116,Wednesday,12,359
3209,CONC,2016-06-01 13:00:00,162,138,Wednesday,13,300
3210,CONC,2016-06-01 14:00:00,149,268,Wednesday,14,417
3211,CONC,2016-06-01 15:00:00,187,412,Wednesday,15,599
3212,CONC,2016-06-01 16:00:00,161,755,Wednesday,16,916
3213,CONC,2016-06-01 17:00:00,234,980,Wednesday,17,1214
3214,CONC,2016-06-01 18:00:00,197,1498,Wednesday,18,1695
3215,CONC,2016-06-01 19:00:00,117,586,Wednesday,19,703
3216,CONC,2016-06-01 20:00:00,90,267,Wednesday,20,357
3217,CONC,2016-06-01 21:00:00,71,230,Wednesday,21,301
3218,CONC,2016-06-01 22:00:00,68,171,Wednesday,22,239
3219,CONC,2016-06-01 23:00:00,31,130,Wednesday,23,161
3220,CONC,2016-06-02 00:00:00,24,79,Thursday,0,103
3221,CONC,2016-06-02 01:00:00,1,8,Thursday,1,9
3222,CONC,2016-06-02 04:00:00,18,2,Thursday,4,20
3223,CONC,2016-06-02 05:00:00,236,14,Thursday,5,250
3224,CONC,2016-06-02 06:00:00,628,118,Thursday,6,746
3225,CONC,2016-06-02 07:00:00,1179,178,Thursday,7,1357
3226,CONC,2016-06-02 08:00:00,1317,183,Thursday,8,1500
3227,CONC,2016-06-02 09:00:00,837,145,Thursday,9,982
3228,CONC,2016-06-02 10:00:00,322,108,Thursday,10,430
3229,CONC,2016-06-02 11:00:00,253,93,Thursday,11,346
3230,CONC,2016-06-02 12:00:00,167,125,Thursday,12,292
3231,CONC,2016-06-02 13:00:00,155,149,Thursday,13,304
3232,CONC,2016-06-02 14:00:00,160,189,Thursday,14,349
3233,CONC,2016-06-02 15:00:00,166,426,Thursday,15,592
3234,CONC,2016-06-02 16:00:00,197,489,Thursday,16,686
3235,CONC,2016-06-02 17:00:00,236,1393,Thursday,17,1629
3236,CONC,2016-06-02 18:00:00,193,1284,Thursday,18,1477
3237,CONC,2016-06-02 19:00:00,119,456,Thursday,19,575
3238,CONC,2016-06-02 20:00:00,75,324,Thursday,20,399
3239,CONC,2016-06-02 21:00:00,76,201,Thursday,21,277
3240,CONC,2016-06-02 22:00:00,59,239,Thursday,22,298
3241,CONC,2016-06-02 23:00:00,34,115,Thursday,23,149
3242,CONC,2016-06-03 00:00:00,17,93,Friday,0,110
3243,CONC,2016-06-03 01:00:00,4,8,Friday,1,12
3244,CONC,2016-06-03 03:00:00,1,1,Friday,3,2
3245,CONC,2016-06-03 04:00:00,10,3,Friday,4,13
3246,CONC,2016-06-03 05:00:00,205,24,Friday,5,229
3247,CONC,2016-06-03 06:00:00,553,106,Friday,6,659
3248,CONC,2016-06-03 07:00:00,995,170,Friday,7,1165
3249,CONC,2016-06-03 08:00:00,1104,161,Friday,8,1265
3250,CONC,2016-06-03 09:00:00,720,89,Friday,9,809
3251,CONC,2016-06-03 10:00:00,304,102,Friday,10,406
3252,CONC,2016-06-03 11:00:00,218,101,Friday,11,319
3253,CONC,2016-06-03 12:00:00,150,130,Friday,12,280
3254,CONC,2016-06-03 13:00:00,171,201,Friday,13,372
3255,CONC,2016-06-03 14:00:00,164,270,Friday,14,434
3256,CONC,2016-06-03 15:00:00,201,437,Friday,15,638
3257,CONC,2016-06-03 16:00:00,208,704,Friday,16,912
3258,CONC,2016-06-03 17:00:00,216,973,Friday,17,1189
3259,CONC,2016-06-03 18:00:00,242,909,Friday,18,1151
3260,CONC,2016-06-03 19:00:00,139,470,Friday,19,609
3261,CONC,2016-06-03 20:00:00,101,245,Friday,20,346
3262,CONC,2016-06-03 21:00:00,72,261,Friday,21,333
3263,CONC,2016-06-03 22:00:00,83,168,Friday,22,251
3264,CONC,2016-06-03 23:00:00,39,144,Friday,23,183
3265,CONC,2016-06-04 00:00:00,30,138,Saturday,0,168
3266,CONC,2016-06-04 01:00:00,8,23,Saturday,1,31
3267,CONC,2016-06-04 06:00:00,63,16,Saturday,6,79
3268,CONC,2016-06-04 07:00:00,137,54,Saturday,7,191
3269,CONC,2016-06-04 08:00:00,180,75,Saturday,8,255
3270,CONC,2016-06-04 09:00:00,163,95,Saturday,9,258
3271,CONC,2016-06-04 10:00:00,151,77,Saturday,10,228
3272,CONC,2016-06-04 11:00:00,153,103,Saturday,11,256
3273,CONC,2016-06-04 12:00:00,143,90,Saturday,12,233
3274,CONC,2016-06-04 13:00:00,149,117,Saturday,13,266
3275,CONC,2016-06-04 14:00:00,174,106,Saturday,14,280
3276,CONC,2016-06-04 15:00:00,125,152,Saturday,15,277
3277,CONC,2016-06-04 16:00:00,109,155,Saturday,16,264
3278,CONC,2016-06-04 17:00:00,112,191,Saturday,17,303
3279,CONC,2016-06-04 18:00:00,121,186,Saturday,18,307
3280,CONC,2016-06-04 19:00:00,92,153,Saturday,19,245
3281,CONC,2016-06-04 20:00:00,59,135,Saturday,20,194
3282,CONC,2016-06-04 21:00:00,69,113,Saturday,21,182
3283,CONC,2016-06-04 22:00:00,48,144,Saturday,22,192
3284,CONC,2016-06-04 23:00:00,28,107,Saturday,23,135
3285,CONC,2016-06-05 00:00:00,19,95,Sunday,0,114
3286,CONC,2016-06-05 01:00:00,8,17,Sunday,1,25
3287,CONC,2016-06-05 08:00:00,104,52,Sunday,8,156
3288,CONC,2016-06-05 09:00:00,144,72,Sunday,9,216
3289,CONC,2016-06-05 10:00:00,160,81,Sunday,10,241
3290,CONC,2016-06-05 11:00:00,156,85,Sunday,11,241
3291,CONC,2016-06-05 12:00:00,123,97,Sunday,12,220
3292,CONC,2016-06-05 13:00:00,125,106,Sunday,13,231
3293,CONC,2016-06-05 14:00:00,122,93,Sunday,14,215
3294,CONC,2016-06-05 15:00:00,116,97,Sunday,15,213
3295,CONC,2016-06-05 16:00:00,77,138,Sunday,16,215
3296,CONC,2016-06-05 17:00:00,73,119,Sunday,17,192
3297,CONC,2016-06-05 18:00:00,65,167,Sunday,18,232
3298,CONC,2016-06-05 19:00:00,72,103,Sunday,19,175
3299,CONC,2016-06-05 20:00:00,76,122,Sunday,20,198
3300,CONC,2016-06-05 21:00:00,74,103,Sunday,21,177
3301,CONC,2016-06-05 22:00:00,54,75,Sunday,22,129
3302,CONC,2016-06-05 23:00:00,22,67,Sunday,23,89
3303,CONC,2016-06-06 00:00:00,17,50,Monday,0,67
3304,CONC,2016-06-06 01:00:00,4,16,Monday,1,20
3305,CONC,2016-06-06 04:00:00,31,3,Monday,4,34
3306,CONC,2016-06-06 05:00:00,198,17,Monday,5,215
3307,CONC,2016-06-06 06:00:00,594,94,Monday,6,688
3308,CONC,2016-06-06 07:00:00,1176,208,Monday,7,1384
3309,CONC,2016-06-06 08:00:00,1304,181,Monday,8,1485
3310,CONC,2016-06-06 09:00:00,799,123,Monday,9,922
3311,CONC,2016-06-06 10:00:00,299,106,Monday,10,405
3312,CONC,2016-06-06 11:00:00,216,98,Monday,11,314
3313,CONC,2016-06-06 12:00:00,145,96,Monday,12,241
3314,CONC,2016-06-06 13:00:00,149,138,Monday,13,287
3315,CONC,2016-06-06 14:00:00,178,218,Monday,14,396
3316,CONC,2016-06-06 15:00:00,193,385,Monday,15,578
3317,CONC,2016-06-06 16:00:00,209,704,Monday,16,913
3318,CONC,2016-06-06 17:00:00,225,1031,Monday,17,1256
3319,CONC,2016-06-06 18:00:00,217,1404,Monday,18,1621
3320,CONC,2016-06-06 19:00:00,96,599,Monday,19,695
3321,CONC,2016-06-06 20:00:00,70,245,Monday,20,315
3322,CONC,2016-06-06 21:00:00,64,213,Monday,21,277
3323,CONC,2016-06-06 22:00:00,51,136,Monday,22,187
3324,CONC,2016-06-06 23:00:00,17,102,Monday,23,119
3325,CONC,2016-06-07 00:00:00,18,70,Tuesday,0,88
3326,CONC,2016-06-07 01:00:00,2,10,Tuesday,1,12
3327,CONC,2016-06-07 04:00:00,24,3,Tuesday,4,27
3328,CONC,2016-06-07 05:00:00,225,19,Tuesday,5,244
3329,CONC,2016-06-07 06:00:00,628,100,Tuesday,6,728
3330,CONC,2016-06-07 07:00:00,1166,202,Tuesday,7,1368
3331,CONC,2016-06-07 08:00:00,1413,182,Tuesday,8,1595
3332,CONC,2016-06-07 09:00:00,812,126,Tuesday,9,938
3333,CONC,2016-06-07 10:00:00,332,106,Tuesday,10,438
3334,CONC,2016-06-07 11:00:00,204,112,Tuesday,11,316
3335,CONC,2016-06-07 12:00:00,187,127,Tuesday,12,314
3336,CONC,2016-06-07 13:00:00,189,178,Tuesday,13,367
3337,CONC,2016-06-07 14:00:00,147,210,Tuesday,14,357
3338,CONC,2016-06-07 15:00:00,172,418,Tuesday,15,590
3339,CONC,2016-06-07 16:00:00,210,769,Tuesday,16,979
3340,CONC,2016-06-07 17:00:00,272,1047,Tuesday,17,1319
3341,CONC,2016-06-07 18:00:00,249,1471,Tuesday,18,1720
3342,CONC,2016-06-07 19:00:00,130,564,Tuesday,19,694
3343,CONC,2016-06-07 20:00:00,64,263,Tuesday,20,327
3344,CONC,2016-06-07 21:00:00,86,181,Tuesday,21,267
3345,CONC,2016-06-07 22:00:00,68,205,Tuesday,22,273
3346,CONC,2016-06-07 23:00:00,23,197,Tuesday,23,220
3347,CONC,2016-06-08 00:00:00,17,141,Wednesday,0,158
3348,CONC,2016-06-08 01:00:00,7,12,Wednesday,1,19
3349,CONC,2016-06-08 04:00:00,23,2,Wednesday,4,25
3350,CONC,2016-06-08 05:00:00,238,19,Wednesday,5,257
3351,CONC,2016-06-08 06:00:00,650,106,Wednesday,6,756
3352,CONC,2016-06-08 07:00:00,1208,177,Wednesday,7,1385
3353,CONC,2016-06-08 08:00:00,1332,189,Wednesday,8,1521
3354,CONC,2016-06-08 09:00:00,769,143,Wednesday,9,912
3355,CONC,2016-06-08 10:00:00,366,104,Wednesday,10,470
3356,CONC,2016-06-08 11:00:00,208,102,Wednesday,11,310
3357,CONC,2016-06-08 12:00:00,187,146,Wednesday,12,333
3358,CONC,2016-06-08 13:00:00,196,147,Wednesday,13,343
3359,CONC,2016-06-08 14:00:00,161,238,Wednesday,14,399
3360,CONC,2016-06-08 15:00:00,192,442,Wednesday,15,634
3361,CONC,2016-06-08 16:00:00,221,713,Wednesday,16,934
3362,CONC,2016-06-08 17:00:00,319,1240,Wednesday,17,1559
3363,CONC,2016-06-08 18:00:00,268,1247,Wednesday,18,1515
3364,CONC,2016-06-08 19:00:00,127,527,Wednesday,19,654
3365,CONC,2016-06-08 20:00:00,72,239,Wednesday,20,311
3366,CONC,2016-06-08 21:00:00,76,258,Wednesday,21,334
3367,CONC,2016-06-08 22:00:00,61,209,Wednesday,22,270
3368,CONC,2016-06-08 23:00:00,39,251,Wednesday,23,290
3369,CONC,2016-06-09 00:00:00,21,95,Thursday,0,116
3370,CONC,2016-06-09 01:00:00,3,20,Thursday,1,23
3371,CONC,2016-06-09 04:00:00,11,4,Thursday,4,15
3372,CONC,2016-06-09 05:00:00,245,19,Thursday,5,264
3373,CONC,2016-06-09 06:00:00,595,113,Thursday,6,708
3374,CONC,2016-06-09 07:00:00,1130,202,Thursday,7,1332
3375,CONC,2016-06-09 08:00:00,1327,192,Thursday,8,1519
3376,CONC,2016-06-09 09:00:00,806,114,Thursday,9,920
3377,CONC,2016-06-09 10:00:00,342,86,Thursday,10,428
3378,CONC,2016-06-09 11:00:00,203,99,Thursday,11,302
3379,CONC,2016-06-09 12:00:00,184,145,Thursday,12,329
3380,CONC,2016-06-09 13:00:00,169,161,Thursday,13,330
3381,CONC,2016-06-09 14:00:00,151,199,Thursday,14,350
3382,CONC,2016-06-09 15:00:00,169,420,Thursday,15,589
3383,CONC,2016-06-09 16:00:00,205,670,Thursday,16,875
3384,CONC,2016-06-09 17:00:00,254,1180,Thursday,17,1434
3385,CONC,2016-06-09 18:00:00,227,1241,Thursday,18,1468
3386,CONC,2016-06-09 19:00:00,107,614,Thursday,19,721
3387,CONC,2016-06-09 20:00:00,86,253,Thursday,20,339
3388,CONC,2016-06-09 21:00:00,82,224,Thursday,21,306
3389,CONC,2016-06-09 22:00:00,69,204,Thursday,22,273
3390,CONC,2016-06-09 23:00:00,34,135,Thursday,23,169
3391,CONC,2016-06-10 00:00:00,13,106,Friday,0,119
3392,CONC,2016-06-10 01:00:00,1,15,Friday,1,16
3393,CONC,2016-06-10 04:00:00,11,3,Friday,4,14
3394,CONC,2016-06-10 05:00:00,189,25,Friday,5,214
3395,CONC,2016-06-10 06:00:00,544,102,Friday,6,646
3396,CONC,2016-06-10 07:00:00,1003,164,Friday,7,1167
3397,CONC,2016-06-10 08:00:00,1060,169,Friday,8,1229
3398,CONC,2016-06-10 09:00:00,627,113,Friday,9,740
3399,CONC,2016-06-10 10:00:00,310,71,Friday,10,381
3400,CONC,2016-06-10 11:00:00,222,120,Friday,11,342
3401,CONC,2016-06-10 12:00:00,177,137,Friday,12,314
3402,CONC,2016-06-10 13:00:00,182,160,Friday,13,342
3403,CONC,2016-06-10 14:00:00,159,232,Friday,14,391
3404,CONC,2016-06-10 15:00:00,218,404,Friday,15,622
3405,CONC,2016-06-10 16:00:00,231,690,Friday,16,921
3406,CONC,2016-06-10 17:00:00,352,928,Friday,17,1280
3407,CONC,2016-06-10 18:00:00,290,976,Friday,18,1266
3408,CONC,2016-06-10 19:00:00,121,382,Friday,19,503
3409,CONC,2016-06-10 20:00:00,81,199,Friday,20,280
3410,CONC,2016-06-10 21:00:00,49,209,Friday,21,258
3411,CONC,2016-06-10 22:00:00,78,245,Friday,22,323
3412,CONC,2016-06-10 23:00:00,54,287,Friday,23,341
3413,CONC,2016-06-11 00:00:00,31,153,Saturday,0,184
3414,CONC,2016-06-11 01:00:00,2,25,Saturday,1,27
3415,CONC,2016-06-11 06:00:00,36,15,Saturday,6,51
3416,CONC,2016-06-11 07:00:00,170,48,Saturday,7,218
3417,CONC,2016-06-11 08:00:00,150,62,Saturday,8,212
3418,CONC,2016-06-11 09:00:00,166,90,Saturday,9,256
3419,CONC,2016-06-11 10:00:00,131,91,Saturday,10,222
3420,CONC,2016-06-11 11:00:00,198,105,Saturday,11,303
3421,CONC,2016-06-11 12:00:00,157,125,Saturday,12,282
3422,CONC,2016-06-11 13:00:00,165,86,Saturday,13,251
3423,CONC,2016-06-11 14:00:00,164,130,Saturday,14,294
3424,CONC,2016-06-11 15:00:00,125,137,Saturday,15,262
3425,CONC,2016-06-11 16:00:00,137,166,Saturday,16,303
3426,CONC,2016-06-11 17:00:00,124,169,Saturday,17,293
3427,CONC,2016-06-11 18:00:00,108,199,Saturday,18,307
3428,CONC,2016-06-11 19:00:00,105,136,Saturday,19,241
3429,CONC,2016-06-11 20:00:00,87,129,Saturday,20,216
3430,CONC,2016-06-11 21:00:00,79,124,Saturday,21,203
3431,CONC,2016-06-11 22:00:00,65,186,Saturday,22,251
3432,CONC,2016-06-11 23:00:00,32,111,Saturday,23,143
3433,CONC,2016-06-12 00:00:00,24,79,Sunday,0,103
3434,CONC,2016-06-12 01:00:00,7,23,Sunday,1,30
3435,CONC,2016-06-12 08:00:00,102,47,Sunday,8,149
3436,CONC,2016-06-12 09:00:00,122,69,Sunday,9,191
3437,CONC,2016-06-12 10:00:00,131,71,Sunday,10,202
3438,CONC,2016-06-12 11:00:00,167,87,Sunday,11,254
3439,CONC,2016-06-12 12:00:00,152,85,Sunday,12,237
3440,CONC,2016-06-12 13:00:00,115,108,Sunday,13,223
3441,CONC,2016-06-12 14:00:00,125,115,Sunday,14,240
3442,CONC,2016-06-12 15:00:00,152,129,Sunday,15,281
3443,CONC,2016-06-12 16:00:00,145,127,Sunday,16,272
3444,CONC,2016-06-12 17:00:00,110,148,Sunday,17,258
3445,CONC,2016-06-12 18:00:00,95,146,Sunday,18,241
3446,CONC,2016-06-12 19:00:00,96,126,Sunday,19,222
3447,CONC,2016-06-12 20:00:00,65,114,Sunday,20,179
3448,CONC,2016-06-12 21:00:00,70,142,Sunday,21,212
3449,CONC,2016-06-12 22:00:00,69,207,Sunday,22,276
3450,CONC,2016-06-12 23:00:00,32,82,Sunday,23,114
3451,CONC,2016-06-13 00:00:00,23,64,Monday,0,87
3452,CONC,2016-06-13 01:00:00,4,10,Monday,1,14
3453,CONC,2016-06-13 04:00:00,26,6,Monday,4,32
3454,CONC,2016-06-13 05:00:00,228,17,Monday,5,245
3455,CONC,2016-06-13 06:00:00,544,88,Monday,6,632
3456,CONC,2016-06-13 07:00:00,1158,145,Monday,7,1303
3457,CONC,2016-06-13 08:00:00,1295,205,Monday,8,1500
3458,CONC,2016-06-13 09:00:00,752,99,Monday,9,851
3459,CONC,2016-06-13 10:00:00,330,94,Monday,10,424
3460,CONC,2016-06-13 11:00:00,214,95,Monday,11,309
3461,CONC,2016-06-13 12:00:00,165,108,Monday,12,273
3462,CONC,2016-06-13 13:00:00,169,155,Monday,13,324
3463,CONC,2016-06-13 14:00:00,158,201,Monday,14,359
3464,CONC,2016-06-13 15:00:00,197,429,Monday,15,626
3465,CONC,2016-06-13 16:00:00,182,741,Monday,16,923
3466,CONC,2016-06-13 17:00:00,327,958,Monday,17,1285
3467,CONC,2016-06-13 18:00:00,292,1459,Monday,18,1751
3468,CONC,2016-06-13 19:00:00,110,514,Monday,19,624
3469,CONC,2016-06-13 20:00:00,73,201,Monday,20,274
3470,CONC,2016-06-13 21:00:00,65,190,Monday,21,255
3471,CONC,2016-06-13 22:00:00,72,288,Monday,22,360
3472,CONC,2016-06-13 23:00:00,23,193,Monday,23,216
3473,CONC,2016-06-14 00:00:00,17,146,Tuesday,0,163
3474,CONC,2016-06-14 01:00:00,5,8,Tuesday,1,13
3475,CONC,2016-06-14 04:00:00,31,4,Tuesday,4,35
3476,CONC,2016-06-14 05:00:00,227,22,Tuesday,5,249
3477,CONC,2016-06-14 06:00:00,642,103,Tuesday,6,745
3478,CONC,2016-06-14 07:00:00,1151,190,Tuesday,7,1341
3479,CONC,2016-06-14 08:00:00,1417,192,Tuesday,8,1609
3480,CONC,2016-06-14 09:00:00,792,102,Tuesday,9,894
3481,CONC,2016-06-14 10:00:00,310,90,Tuesday,10,400
3482,CONC,2016-06-14 11:00:00,231,106,Tuesday,11,337
3483,CONC,2016-06-14 12:00:00,163,131,Tuesday,12,294
3484,CONC,2016-06-14 13:00:00,169,131,Tuesday,13,300
3485,CONC,2016-06-14 14:00:00,142,224,Tuesday,14,366
3486,CONC,2016-06-14 15:00:00,166,440,Tuesday,15,606
3487,CONC,2016-06-14 16:00:00,212,741,Tuesday,16,953
3488,CONC,2016-06-14 17:00:00,335,1167,Tuesday,17,1502
3489,CONC,2016-06-14 18:00:00,289,1316,Tuesday,18,1605
3490,CONC,2016-06-14 19:00:00,116,602,Tuesday,19,718
3491,CONC,2016-06-14 20:00:00,62,237,Tuesday,20,299
3492,CONC,2016-06-14 21:00:00,80,203,Tuesday,21,283
3493,CONC,2016-06-14 22:00:00,60,199,Tuesday,22,259
3494,CONC,2016-06-14 23:00:00,39,190,Tuesday,23,229
3495,DALY,2016-06-01 01:00:00,1,20,Wednesday,1,21
3496,DALY,2016-06-01 04:00:00,53,1,Wednesday,4,54
3497,DALY,2016-06-01 05:00:00,207,45,Wednesday,5,252
3498,DALY,2016-06-01 06:00:00,629,107,Wednesday,6,736
3499,DALY,2016-06-01 07:00:00,1535,222,Wednesday,7,1757
3500,DALY,2016-06-01 08:00:00,1749,237,Wednesday,8,1986
3501,DALY,2016-06-01 09:00:00,901,184,Wednesday,9,1085
3502,DALY,2016-06-01 10:00:00,497,149,Wednesday,10,646
3503,DALY,2016-06-01 11:00:00,360,191,Wednesday,11,551
3504,DALY,2016-06-01 12:00:00,265,185,Wednesday,12,450
3505,DALY,2016-06-01 13:00:00,263,245,Wednesday,13,508
3506,DALY,2016-06-01 14:00:00,254,346,Wednesday,14,600
3507,DALY,2016-06-01 15:00:00,286,541,Wednesday,15,827
3508,DALY,2016-06-01 16:00:00,319,751,Wednesday,16,1070
3509,DALY,2016-06-01 17:00:00,337,1847,Wednesday,17,2184
3510,DALY,2016-06-01 18:00:00,348,1272,Wednesday,18,1620
3511,DALY,2016-06-01 19:00:00,179,605,Wednesday,19,784
3512,DALY,2016-06-01 20:00:00,119,363,Wednesday,20,482
3513,DALY,2016-06-01 21:00:00,91,383,Wednesday,21,474
3514,DALY,2016-06-01 22:00:00,82,327,Wednesday,22,409
3515,DALY,2016-06-01 23:00:00,37,196,Wednesday,23,233
3516,DALY,2016-06-02 00:00:00,12,103,Thursday,0,115
3517,DALY,2016-06-02 01:00:00,3,16,Thursday,1,19
3518,DALY,2016-06-02 04:00:00,41,2,Thursday,4,43
3519,DALY,2016-06-02 05:00:00,211,56,Thursday,5,267
3520,DALY,2016-06-02 06:00:00,587,118,Thursday,6,705
3521,DALY,2016-06-02 07:00:00,1485,216,Thursday,7,1701
3522,DALY,2016-06-02 08:00:00,1562,207,Thursday,8,1769
3523,DALY,2016-06-02 09:00:00,1076,172,Thursday,9,1248
3524,DALY,2016-06-02 10:00:00,528,140,Thursday,10,668
3525,DALY,2016-06-02 11:00:00,325,157,Thursday,11,482
3526,DALY,2016-06-02 12:00:00,282,191,Thursday,12,473
3527,DALY,2016-06-02 13:00:00,267,259,Thursday,13,526
3528,DALY,2016-06-02 14:00:00,281,336,Thursday,14,617
3529,DALY,2016-06-02 15:00:00,326,551,Thursday,15,877
3530,DALY,2016-06-02 16:00:00,391,970,Thursday,16,1361
3531,DALY,2016-06-02 17:00:00,515,1538,Thursday,17,2053
3532,DALY,2016-06-02 18:00:00,369,1320,Thursday,18,1689
3533,DALY,2016-06-02 19:00:00,191,544,Thursday,19,735
3534,DALY,2016-06-02 20:00:00,119,417,Thursday,20,536
3535,DALY,2016-06-02 21:00:00,96,596,Thursday,21,692
3536,DALY,2016-06-02 22:00:00,88,395,Thursday,22,483
3537,DALY,2016-06-02 23:00:00,40,192,Thursday,23,232
3538,DALY,2016-06-03 00:00:00,23,127,Friday,0,150
3539,DALY,2016-06-03 01:00:00,8,28,Friday,1,36
3540,DALY,2016-06-03 04:00:00,43,3,Friday,4,46
3541,DALY,2016-06-03 05:00:00,184,31,Friday,5,215
3542,DALY,2016-06-03 06:00:00,550,104,Friday,6,654
3543,DALY,2016-06-03 07:00:00,1347,184,Friday,7,1531
3544,DALY,2016-06-03 08:00:00,1630,194,Friday,8,1824
3545,DALY,2016-06-03 09:00:00,857,195,Friday,9,1052
3546,DALY,2016-06-03 10:00:00,540,129,Friday,10,669
3547,DALY,2016-06-03 11:00:00,356,189,Friday,11,545
3548,DALY,2016-06-03 12:00:00,271,222,Friday,12,493
3549,DALY,2016-06-03 13:00:00,306,302,Friday,13,608
3550,DALY,2016-06-03 14:00:00,248,404,Friday,14,652
3551,DALY,2016-06-03 15:00:00,324,555,Friday,15,879
3552,DALY,2016-06-03 16:00:00,408,940,Friday,16,1348
3553,DALY,2016-06-03 17:00:00,361,1385,Friday,17,1746
3554,DALY,2016-06-03 18:00:00,412,1061,Friday,18,1473
3555,DALY,2016-06-03 19:00:00,225,666,Friday,19,891
3556,DALY,2016-06-03 20:00:00,158,404,Friday,20,562
3557,DALY,2016-06-03 21:00:00,134,362,Friday,21,496
3558,DALY,2016-06-03 22:00:00,100,379,Friday,22,479
3559,DALY,2016-06-03 23:00:00,53,296,Friday,23,349
3560,DALY,2016-06-04 00:00:00,34,197,Saturday,0,231
3561,DALY,2016-06-04 01:00:00,6,26,Saturday,1,32
3562,DALY,2016-06-04 06:00:00,108,22,Saturday,6,130
3563,DALY,2016-06-04 07:00:00,225,59,Saturday,7,284
3564,DALY,2016-06-04 08:00:00,308,92,Saturday,8,400
3565,DALY,2016-06-04 09:00:00,351,106,Saturday,9,457
3566,DALY,2016-06-04 10:00:00,402,132,Saturday,10,534
3567,DALY,2016-06-04 11:00:00,381,134,Saturday,11,515
3568,DALY,2016-06-04 12:00:00,320,161,Saturday,12,481
3569,DALY,2016-06-04 13:00:00,348,193,Saturday,13,541
3570,DALY,2016-06-04 14:00:00,308,254,Saturday,14,562
3571,DALY,2016-06-04 15:00:00,307,353,Saturday,15,660
3572,DALY,2016-06-04 16:00:00,240,349,Saturday,16,589
3573,DALY,2016-06-04 17:00:00,231,452,Saturday,17,683
3574,DALY,2016-06-04 18:00:00,212,397,Saturday,18,609
3575,DALY,2016-06-04 19:00:00,207,339,Saturday,19,546
3576,DALY,2016-06-04 20:00:00,137,248,Saturday,20,385
3577,DALY,2016-06-04 21:00:00,105,318,Saturday,21,423
3578,DALY,2016-06-04 22:00:00,110,246,Saturday,22,356
3579,DALY,2016-06-04 23:00:00,52,258,Saturday,23,310
3580,DALY,2016-06-05 00:00:00,31,160,Sunday,0,191
3581,DALY,2016-06-05 01:00:00,7,19,Sunday,1,26
3582,DALY,2016-06-05 08:00:00,205,59,Sunday,8,264
3583,DALY,2016-06-05 09:00:00,263,106,Sunday,9,369
3584,DALY,2016-06-05 10:00:00,297,121,Sunday,10,418
3585,DALY,2016-06-05 11:00:00,292,125,Sunday,11,417
3586,DALY,2016-06-05 12:00:00,241,147,Sunday,12,388
3587,DALY,2016-06-05 13:00:00,319,158,Sunday,13,477
3588,DALY,2016-06-05 14:00:00,296,188,Sunday,14,484
3589,DALY,2016-06-05 15:00:00,305,245,Sunday,15,550
3590,DALY,2016-06-05 16:00:00,243,291,Sunday,16,534
3591,DALY,2016-06-05 17:00:00,154,330,Sunday,17,484
3592,DALY,2016-06-05 18:00:00,123,303,Sunday,18,426
3593,DALY,2016-06-05 19:00:00,96,257,Sunday,19,353
3594,DALY,2016-06-05 20:00:00,93,351,Sunday,20,444
3595,DALY,2016-06-05 21:00:00,90,245,Sunday,21,335
3596,DALY,2016-06-05 22:00:00,92,152,Sunday,22,244
3597,DALY,2016-06-05 23:00:00,45,157,Sunday,23,202
3598,DALY,2016-06-06 00:00:00,15,79,Monday,0,94
3599,DALY,2016-06-06 01:00:00,1,12,Monday,1,13
3600,DALY,2016-06-06 04:00:00,53,3,Monday,4,56
3601,DALY,2016-06-06 05:00:00,187,34,Monday,5,221
3602,DALY,2016-06-06 06:00:00,625,82,Monday,6,707
3603,DALY,2016-06-06 07:00:00,1477,212,Monday,7,1689
3604,DALY,2016-06-06 08:00:00,1731,352,Monday,8,2083
3605,DALY,2016-06-06 09:00:00,905,231,Monday,9,1136
3606,DALY,2016-06-06 10:00:00,540,184,Monday,10,724
3607,DALY,2016-06-06 11:00:00,296,183,Monday,11,479
3608,DALY,2016-06-06 12:00:00,263,228,Monday,12,491
3609,DALY,2016-06-06 13:00:00,275,256,Monday,13,531
3610,DALY,2016-06-06 14:00:00,299,363,Monday,14,662
3611,DALY,2016-06-06 15:00:00,317,537,Monday,15,854
3612,DALY,2016-06-06 16:00:00,302,996,Monday,16,1298
3613,DALY,2016-06-06 17:00:00,336,1700,Monday,17,2036
3614,DALY,2016-06-06 18:00:00,328,1238,Monday,18,1566
3615,DALY,2016-06-06 19:00:00,183,671,Monday,19,854
3616,DALY,2016-06-06 20:00:00,113,368,Monday,20,481
3617,DALY,2016-06-06 21:00:00,93,300,Monday,21,393
3618,DALY,2016-06-06 22:00:00,81,258,Monday,22,339
3619,DALY,2016-06-06 23:00:00,41,186,Monday,23,227
3620,DALY,2016-06-07 00:00:00,18,85,Tuesday,0,103
3621,DALY,2016-06-07 04:00:00,61,3,Tuesday,4,64
3622,DALY,2016-06-07 05:00:00,190,39,Tuesday,5,229
3623,DALY,2016-06-07 06:00:00,637,84,Tuesday,6,721
3624,DALY,2016-06-07 07:00:00,1567,214,Tuesday,7,1781
3625,DALY,2016-06-07 08:00:00,1741,339,Tuesday,8,2080
3626,DALY,2016-06-07 09:00:00,942,190,Tuesday,9,1132
3627,DALY,2016-06-07 10:00:00,551,164,Tuesday,10,715
3628,DALY,2016-06-07 11:00:00,295,224,Tuesday,11,519
3629,DALY,2016-06-07 12:00:00,284,216,Tuesday,12,500
3630,DALY,2016-06-07 13:00:00,306,192,Tuesday,13,498
3631,DALY,2016-06-07 14:00:00,327,385,Tuesday,14,712
3632,DALY,2016-06-07 15:00:00,336,481,Tuesday,15,817
3633,DALY,2016-06-07 16:00:00,377,995,Tuesday,16,1372
3634,DALY,2016-06-07 17:00:00,387,1684,Tuesday,17,2071
3635,DALY,2016-06-07 18:00:00,391,1257,Tuesday,18,1648
3636,DALY,2016-06-07 19:00:00,201,814,Tuesday,19,1015
3637,DALY,2016-06-07 20:00:00,108,358,Tuesday,20,466
3638,DALY,2016-06-07 21:00:00,95,400,Tuesday,21,495
3639,DALY,2016-06-07 22:00:00,98,301,Tuesday,22,399
3640,DALY,2016-06-07 23:00:00,57,272,Tuesday,23,329
3641,DALY,2016-06-08 00:00:00,20,104,Wednesday,0,124
3642,DALY,2016-06-08 01:00:00,6,18,Wednesday,1,24
3643,DALY,2016-06-08 04:00:00,59,2,Wednesday,4,61
3644,DALY,2016-06-08 05:00:00,208,45,Wednesday,5,253
3645,DALY,2016-06-08 06:00:00,609,103,Wednesday,6,712
3646,DALY,2016-06-08 07:00:00,1555,237,Wednesday,7,1792
3647,DALY,2016-06-08 08:00:00,1771,342,Wednesday,8,2113
3648,DALY,2016-06-08 09:00:00,883,205,Wednesday,9,1088
3649,DALY,2016-06-08 10:00:00,531,160,Wednesday,10,691
3650,DALY,2016-06-08 11:00:00,311,167,Wednesday,11,478
3651,DALY,2016-06-08 12:00:00,272,210,Wednesday,12,482
3652,DALY,2016-06-08 13:00:00,325,266,Wednesday,13,591
3653,DALY,2016-06-08 14:00:00,296,372,Wednesday,14,668
3654,DALY,2016-06-08 15:00:00,309,463,Wednesday,15,772
3655,DALY,2016-06-08 16:00:00,415,1117,Wednesday,16,1532
3656,DALY,2016-06-08 17:00:00,548,1569,Wednesday,17,2117
3657,DALY,2016-06-08 18:00:00,483,1407,Wednesday,18,1890
3658,DALY,2016-06-08 19:00:00,201,579,Wednesday,19,780
3659,DALY,2016-06-08 20:00:00,104,372,Wednesday,20,476
3660,DALY,2016-06-08 21:00:00,90,621,Wednesday,21,711
3661,DALY,2016-06-08 22:00:00,91,391,Wednesday,22,482
3662,DALY,2016-06-08 23:00:00,52,277,Wednesday,23,329
3663,DALY,2016-06-09 00:00:00,16,129,Thursday,0,145
3664,DALY,2016-06-09 01:00:00,2,26,Thursday,1,28
3665,DALY,2016-06-09 04:00:00,55,3,Thursday,4,58
3666,DALY,2016-06-09 05:00:00,198,42,Thursday,5,240
3667,DALY,2016-06-09 06:00:00,575,117,Thursday,6,692
3668,DALY,2016-06-09 07:00:00,1453,232,Thursday,7,1685
3669,DALY,2016-06-09 08:00:00,1665,279,Thursday,8,1944
3670,DALY,2016-06-09 09:00:00,982,216,Thursday,9,1198
3671,DALY,2016-06-09 10:00:00,528,149,Thursday,10,677
3672,DALY,2016-06-09 11:00:00,305,175,Thursday,11,480
3673,DALY,2016-06-09 12:00:00,288,249,Thursday,12,537
3674,DALY,2016-06-09 13:00:00,305,230,Thursday,13,535
3675,DALY,2016-06-09 14:00:00,304,338,Thursday,14,642
3676,DALY,2016-06-09 15:00:00,374,508,Thursday,15,882
3677,DALY,2016-06-09 16:00:00,315,876,Thursday,16,1191
3678,DALY,2016-06-09 17:00:00,389,1610,Thursday,17,1999
3679,DALY,2016-06-09 18:00:00,376,1381,Thursday,18,1757
3680,DALY,2016-06-09 19:00:00,213,672,Thursday,19,885
3681,DALY,2016-06-09 20:00:00,103,465,Thursday,20,568
3682,DALY,2016-06-09 21:00:00,122,371,Thursday,21,493
3683,DALY,2016-06-09 22:00:00,92,340,Thursday,22,432
3684,DALY,2016-06-09 23:00:00,50,265,Thursday,23,315
3685,DALY,2016-06-10 00:00:00,20,135,Friday,0,155
3686,DALY,2016-06-10 01:00:00,5,24,Friday,1,29
3687,DALY,2016-06-10 04:00:00,46,1,Friday,4,47
3688,DALY,2016-06-10 05:00:00,179,46,Friday,5,225
3689,DALY,2016-06-10 06:00:00,535,94,Friday,6,629
3690,DALY,2016-06-10 07:00:00,1363,210,Friday,7,1573
3691,DALY,2016-06-10 08:00:00,1581,227,Friday,8,1808
3692,DALY,2016-06-10 09:00:00,880,217,Friday,9,1097
3693,DALY,2016-06-10 10:00:00,534,152,Friday,10,686
3694,DALY,2016-06-10 11:00:00,347,178,Friday,11,525
3695,DALY,2016-06-10 12:00:00,321,206,Friday,12,527
3696,DALY,2016-06-10 13:00:00,332,263,Friday,13,595
3697,DALY,2016-06-10 14:00:00,281,394,Friday,14,675
3698,DALY,2016-06-10 15:00:00,359,618,Friday,15,977
3699,DALY,2016-06-10 16:00:00,439,977,Friday,16,1416
3700,DALY,2016-06-10 17:00:00,578,1391,Friday,17,1969
3701,DALY,2016-06-10 18:00:00,540,1147,Friday,18,1687
3702,DALY,2016-06-10 19:00:00,255,462,Friday,19,717
3703,DALY,2016-06-10 20:00:00,152,299,Friday,20,451
3704,DALY,2016-06-10 21:00:00,137,472,Friday,21,609
3705,DALY,2016-06-10 22:00:00,119,523,Friday,22,642
3706,DALY,2016-06-10 23:00:00,65,335,Friday,23,400
3707,DALY,2016-06-11 00:00:00,25,206,Saturday,0,231
3708,DALY,2016-06-11 01:00:00,5,49,Saturday,1,54
3709,DALY,2016-06-11 06:00:00,111,29,Saturday,6,140
3710,DALY,2016-06-11 07:00:00,214,78,Saturday,7,292
3711,DALY,2016-06-11 08:00:00,319,106,Saturday,8,425
3712,DALY,2016-06-11 09:00:00,317,113,Saturday,9,430
3713,DALY,2016-06-11 10:00:00,338,139,Saturday,10,477
3714,DALY,2016-06-11 11:00:00,393,159,Saturday,11,552
3715,DALY,2016-06-11 12:00:00,397,190,Saturday,12,587
3716,DALY,2016-06-11 13:00:00,379,197,Saturday,13,576
3717,DALY,2016-06-11 14:00:00,364,272,Saturday,14,636
3718,DALY,2016-06-11 15:00:00,362,332,Saturday,15,694
3719,DALY,2016-06-11 16:00:00,282,383,Saturday,16,665
3720,DALY,2016-06-11 17:00:00,260,421,Saturday,17,681
3721,DALY,2016-06-11 18:00:00,274,389,Saturday,18,663
3722,DALY,2016-06-11 19:00:00,188,349,Saturday,19,537
3723,DALY,2016-06-11 20:00:00,177,302,Saturday,20,479
3724,DALY,2016-06-11 21:00:00,126,320,Saturday,21,446
3725,DALY,2016-06-11 22:00:00,101,305,Saturday,22,406
3726,DALY,2016-06-11 23:00:00,81,277,Saturday,23,358
3727,DALY,2016-06-12 00:00:00,35,186,Sunday,0,221
3728,DALY,2016-06-12 01:00:00,3,36,Sunday,1,39
3729,DALY,2016-06-12 07:00:00,1,1,Sunday,7,2
3730,DALY,2016-06-12 08:00:00,183,69,Sunday,8,252
3731,DALY,2016-06-12 09:00:00,241,96,Sunday,9,337
3732,DALY,2016-06-12 10:00:00,247,107,Sunday,10,354
3733,DALY,2016-06-12 11:00:00,317,121,Sunday,11,438
3734,DALY,2016-06-12 12:00:00,341,133,Sunday,12,474
3735,DALY,2016-06-12 13:00:00,314,155,Sunday,13,469
3736,DALY,2016-06-12 14:00:00,325,178,Sunday,14,503
3737,DALY,2016-06-12 15:00:00,280,226,Sunday,15,506
3738,DALY,2016-06-12 16:00:00,213,331,Sunday,16,544
3739,DALY,2016-06-12 17:00:00,206,377,Sunday,17,583
3740,DALY,2016-06-12 18:00:00,232,328,Sunday,18,560
3741,DALY,2016-06-12 19:00:00,245,347,Sunday,19,592
3742,DALY,2016-06-12 20:00:00,141,245,Sunday,20,386
3743,DALY,2016-06-12 21:00:00,84,286,Sunday,21,370
3744,DALY,2016-06-12 22:00:00,69,221,Sunday,22,290
3745,DALY,2016-06-12 23:00:00,40,158,Sunday,23,198
3746,DALY,2016-06-13 00:00:00,20,316,Monday,0,336
3747,DALY,2016-06-13 04:00:00,52,1,Monday,4,53
3748,DALY,2016-06-13 05:00:00,182,39,Monday,5,221
3749,DALY,2016-06-13 06:00:00,565,95,Monday,6,660
3750,DALY,2016-06-13 07:00:00,1453,256,Monday,7,1709
3751,DALY,2016-06-13 08:00:00,1802,345,Monday,8,2147
3752,DALY,2016-06-13 09:00:00,897,217,Monday,9,1114
3753,DALY,2016-06-13 10:00:00,482,159,Monday,10,641
3754,DALY,2016-06-13 11:00:00,291,212,Monday,11,503
3755,DALY,2016-06-13 12:00:00,264,227,Monday,12,491
3756,DALY,2016-06-13 13:00:00,279,206,Monday,13,485
3757,DALY,2016-06-13 14:00:00,273,375,Monday,14,648
3758,DALY,2016-06-13 15:00:00,366,497,Monday,15,863
3759,DALY,2016-06-13 16:00:00,414,994,Monday,16,1408
3760,DALY,2016-06-13 17:00:00,575,1761,Monday,17,2336
3761,DALY,2016-06-13 18:00:00,486,1221,Monday,18,1707
3762,DALY,2016-06-13 19:00:00,199,590,Monday,19,789
3763,DALY,2016-06-13 20:00:00,114,326,Monday,20,440
3764,DALY,2016-06-13 21:00:00,88,586,Monday,21,674
3765,DALY,2016-06-13 22:00:00,90,488,Monday,22,578
3766,DALY,2016-06-13 23:00:00,47,305,Monday,23,352
3767,DALY,2016-06-14 00:00:00,19,97,Tuesday,0,116
3768,DALY,2016-06-14 01:00:00,3,20,Tuesday,1,23
3769,DALY,2016-06-14 04:00:00,48,3,Tuesday,4,51
3770,DALY,2016-06-14 05:00:00,208,40,Tuesday,5,248
3771,DALY,2016-06-14 06:00:00,619,112,Tuesday,6,731
3772,DALY,2016-06-14 07:00:00,1513,244,Tuesday,7,1757
3773,DALY,2016-06-14 08:00:00,1831,345,Tuesday,8,2176
3774,DALY,2016-06-14 09:00:00,906,170,Tuesday,9,1076
3775,DALY,2016-06-14 10:00:00,544,170,Tuesday,10,714
3776,DALY,2016-06-14 11:00:00,305,180,Tuesday,11,485
3777,DALY,2016-06-14 12:00:00,266,207,Tuesday,12,473
3778,DALY,2016-06-14 13:00:00,269,242,Tuesday,13,511
3779,DALY,2016-06-14 14:00:00,280,353,Tuesday,14,633
3780,DALY,2016-06-14 15:00:00,355,543,Tuesday,15,898
3781,DALY,2016-06-14 16:00:00,338,952,Tuesday,16,1290
3782,DALY,2016-06-14 17:00:00,415,1773,Tuesday,17,2188
3783,DALY,2016-06-14 18:00:00,442,1243,Tuesday,18,1685
3784,DALY,2016-06-14 19:00:00,210,636,Tuesday,19,846
3785,DALY,2016-06-14 20:00:00,121,459,Tuesday,20,580
3786,DALY,2016-06-14 21:00:00,114,347,Tuesday,21,461
3787,DALY,2016-06-14 22:00:00,108,400,Tuesday,22,508
3788,DALY,2016-06-14 23:00:00,57,312,Tuesday,23,369
3789,DBRK,2016-06-01 04:00:00,3,8,Wednesday,4,11
3790,DBRK,2016-06-01 05:00:00,44,76,Wednesday,5,120
3791,DBRK,2016-06-01 06:00:00,151,278,Wednesday,6,429
3792,DBRK,2016-06-01 07:00:00,511,985,Wednesday,7,1496
3793,DBRK,2016-06-01 08:00:00,1137,1692,Wednesday,8,2829
3794,DBRK,2016-06-01 09:00:00,960,1143,Wednesday,9,2103
3795,DBRK,2016-06-01 10:00:00,512,707,Wednesday,10,1219
3796,DBRK,2016-06-01 11:00:00,387,602,Wednesday,11,989
3797,DBRK,2016-06-01 12:00:00,642,418,Wednesday,12,1060
3798,DBRK,2016-06-01 13:00:00,523,621,Wednesday,13,1144
3799,DBRK,2016-06-01 14:00:00,508,458,Wednesday,14,966
3800,DBRK,2016-06-01 15:00:00,688,616,Wednesday,15,1304
3801,DBRK,2016-06-01 16:00:00,935,782,Wednesday,16,1717
3802,DBRK,2016-06-01 17:00:00,1549,1146,Wednesday,17,2695
3803,DBRK,2016-06-01 18:00:00,1377,1573,Wednesday,18,2950
3804,DBRK,2016-06-01 19:00:00,740,722,Wednesday,19,1462
3805,DBRK,2016-06-01 20:00:00,409,539,Wednesday,20,948
3806,DBRK,2016-06-01 21:00:00,398,392,Wednesday,21,790
3807,DBRK,2016-06-01 22:00:00,342,186,Wednesday,22,528
3808,DBRK,2016-06-01 23:00:00,197,149,Wednesday,23,346
3809,DBRK,2016-06-02 00:00:00,59,93,Thursday,0,152
3810,DBRK,2016-06-02 04:00:00,4,5,Thursday,4,9
3811,DBRK,2016-06-02 05:00:00,48,63,Thursday,5,111
3812,DBRK,2016-06-02 06:00:00,160,274,Thursday,6,434
3813,DBRK,2016-06-02 07:00:00,510,950,Thursday,7,1460
3814,DBRK,2016-06-02 08:00:00,1070,1592,Thursday,8,2662
3815,DBRK,2016-06-02 09:00:00,1117,1199,Thursday,9,2316
3816,DBRK,2016-06-02 10:00:00,504,773,Thursday,10,1277
3817,DBRK,2016-06-02 11:00:00,428,521,Thursday,11,949
3818,DBRK,2016-06-02 12:00:00,413,570,Thursday,12,983
3819,DBRK,2016-06-02 13:00:00,504,580,Thursday,13,1084
3820,DBRK,2016-06-02 14:00:00,530,418,Thursday,14,948
3821,DBRK,2016-06-02 15:00:00,775,530,Thursday,15,1305
3822,DBRK,2016-06-02 16:00:00,946,701,Thursday,16,1647
3823,DBRK,2016-06-02 17:00:00,1793,1182,Thursday,17,2975
3824,DBRK,2016-06-02 18:00:00,1325,1539,Thursday,18,2864
3825,DBRK,2016-06-02 19:00:00,753,756,Thursday,19,1509
3826,DBRK,2016-06-02 20:00:00,380,536,Thursday,20,916
3827,DBRK,2016-06-02 21:00:00,397,480,Thursday,21,877
3828,DBRK,2016-06-02 22:00:00,359,270,Thursday,22,629
3829,DBRK,2016-06-02 23:00:00,284,149,Thursday,23,433
3830,DBRK,2016-06-03 00:00:00,98,114,Friday,0,212
3831,DBRK,2016-06-03 01:00:00,23,7,Friday,1,30
3832,DBRK,2016-06-03 04:00:00,7,17,Friday,4,24
3833,DBRK,2016-06-03 05:00:00,36,62,Friday,5,98
3834,DBRK,2016-06-03 06:00:00,170,258,Friday,6,428
3835,DBRK,2016-06-03 07:00:00,467,814,Friday,7,1281
3836,DBRK,2016-06-03 08:00:00,1086,1454,Friday,8,2540
3837,DBRK,2016-06-03 09:00:00,987,1184,Friday,9,2171
3838,DBRK,2016-06-03 10:00:00,508,771,Friday,10,1279
3839,DBRK,2016-06-03 11:00:00,429,529,Friday,11,958
3840,DBRK,2016-06-03 12:00:00,477,497,Friday,12,974
3841,DBRK,2016-06-03 13:00:00,584,538,Friday,13,1122
3842,DBRK,2016-06-03 14:00:00,861,533,Friday,14,1394
3843,DBRK,2016-06-03 15:00:00,854,647,Friday,15,1501
3844,DBRK,2016-06-03 16:00:00,1027,968,Friday,16,1995
3845,DBRK,2016-06-03 17:00:00,1475,1471,Friday,17,2946
3846,DBRK,2016-06-03 18:00:00,1238,1952,Friday,18,3190
3847,DBRK,2016-06-03 19:00:00,820,1084,Friday,19,1904
3848,DBRK,2016-06-03 20:00:00,467,473,Friday,20,940
3849,DBRK,2016-06-03 21:00:00,438,435,Friday,21,873
3850,DBRK,2016-06-03 22:00:00,738,260,Friday,22,998
3851,DBRK,2016-06-03 23:00:00,934,324,Friday,23,1258
3852,DBRK,2016-06-04 00:00:00,246,202,Saturday,0,448
3853,DBRK,2016-06-04 06:00:00,31,37,Saturday,6,68
3854,DBRK,2016-06-04 07:00:00,108,206,Saturday,7,314
3855,DBRK,2016-06-04 08:00:00,157,415,Saturday,8,572
3856,DBRK,2016-06-04 09:00:00,260,641,Saturday,9,901
3857,DBRK,2016-06-04 10:00:00,335,751,Saturday,10,1086
3858,DBRK,2016-06-04 11:00:00,460,920,Saturday,11,1380
3859,DBRK,2016-06-04 12:00:00,502,805,Saturday,12,1307
3860,DBRK,2016-06-04 13:00:00,701,941,Saturday,13,1642
3861,DBRK,2016-06-04 14:00:00,723,652,Saturday,14,1375
3862,DBRK,2016-06-04 15:00:00,859,616,Saturday,15,1475
3863,DBRK,2016-06-04 16:00:00,905,673,Saturday,16,1578
3864,DBRK,2016-06-04 17:00:00,927,841,Saturday,17,1768
3865,DBRK,2016-06-04 18:00:00,894,813,Saturday,18,1707
3866,DBRK,2016-06-04 19:00:00,650,468,Saturday,19,1118
3867,DBRK,2016-06-04 20:00:00,470,341,Saturday,20,811
3868,DBRK,2016-06-04 21:00:00,418,361,Saturday,21,779
3869,DBRK,2016-06-04 22:00:00,653,288,Saturday,22,941
3870,DBRK,2016-06-04 23:00:00,623,203,Saturday,23,826
3871,DBRK,2016-06-05 00:00:00,175,164,Sunday,0,339
3872,DBRK,2016-06-05 08:00:00,118,198,Sunday,8,316
3873,DBRK,2016-06-05 09:00:00,226,410,Sunday,9,636
3874,DBRK,2016-06-05 10:00:00,304,536,Sunday,10,840
3875,DBRK,2016-06-05 11:00:00,323,693,Sunday,11,1016
3876,DBRK,2016-06-05 12:00:00,367,517,Sunday,12,884
3877,DBRK,2016-06-05 13:00:00,499,695,Sunday,13,1194
3878,DBRK,2016-06-05 14:00:00,607,537,Sunday,14,1144
3879,DBRK,2016-06-05 15:00:00,651,555,Sunday,15,1206
3880,DBRK,2016-06-05 16:00:00,735,513,Sunday,16,1248
3881,DBRK,2016-06-05 17:00:00,765,540,Sunday,17,1305
3882,DBRK,2016-06-05 18:00:00,582,447,Sunday,18,1029
3883,DBRK,2016-06-05 19:00:00,422,309,Sunday,19,731
3884,DBRK,2016-06-05 20:00:00,342,376,Sunday,20,718
3885,DBRK,2016-06-05 21:00:00,288,282,Sunday,21,570
3886,DBRK,2016-06-05 22:00:00,237,195,Sunday,22,432
3887,DBRK,2016-06-05 23:00:00,141,120,Sunday,23,261
3888,DBRK,2016-06-06 00:00:00,51,59,Monday,0,110
3889,DBRK,2016-06-06 01:00:00,13,10,Monday,1,23
3890,DBRK,2016-06-06 04:00:00,3,14,Monday,4,17
3891,DBRK,2016-06-06 05:00:00,43,78,Monday,5,121
3892,DBRK,2016-06-06 06:00:00,175,245,Monday,6,420
3893,DBRK,2016-06-06 07:00:00,552,881,Monday,7,1433
3894,DBRK,2016-06-06 08:00:00,1258,1467,Monday,8,2725
3895,DBRK,2016-06-06 09:00:00,1067,1352,Monday,9,2419
3896,DBRK,2016-06-06 10:00:00,495,737,Monday,10,1232
3897,DBRK,2016-06-06 11:00:00,412,554,Monday,11,966
3898,DBRK,2016-06-06 12:00:00,442,444,Monday,12,886
3899,DBRK,2016-06-06 13:00:00,500,484,Monday,13,984
3900,DBRK,2016-06-06 14:00:00,459,431,Monday,14,890
3901,DBRK,2016-06-06 15:00:00,698,531,Monday,15,1229
3902,DBRK,2016-06-06 16:00:00,1038,736,Monday,16,1774
3903,DBRK,2016-06-06 17:00:00,1549,1101,Monday,17,2650
3904,DBRK,2016-06-06 18:00:00,1224,1518,Monday,18,2742
3905,DBRK,2016-06-06 19:00:00,693,825,Monday,19,1518
3906,DBRK,2016-06-06 20:00:00,407,507,Monday,20,914
3907,DBRK,2016-06-06 21:00:00,290,358,Monday,21,648
3908,DBRK,2016-06-06 22:00:00,313,196,Monday,22,509
3909,DBRK,2016-06-06 23:00:00,129,144,Monday,23,273
3910,DBRK,2016-06-07 00:00:00,58,82,Tuesday,0,140
3911,DBRK,2016-06-07 04:00:00,6,17,Tuesday,4,23
3912,DBRK,2016-06-07 05:00:00,49,74,Tuesday,5,123
3913,DBRK,2016-06-07 06:00:00,170,248,Tuesday,6,418
3914,DBRK,2016-06-07 07:00:00,573,924,Tuesday,7,1497
3915,DBRK,2016-06-07 08:00:00,1364,1635,Tuesday,8,2999
3916,DBRK,2016-06-07 09:00:00,1071,1160,Tuesday,9,2231
3917,DBRK,2016-06-07 10:00:00,548,672,Tuesday,10,1220
3918,DBRK,2016-06-07 11:00:00,366,539,Tuesday,11,905
3919,DBRK,2016-06-07 12:00:00,495,451,Tuesday,12,946
3920,DBRK,2016-06-07 13:00:00,513,459,Tuesday,13,972
3921,DBRK,2016-06-07 14:00:00,606,487,Tuesday,14,1093
3922,DBRK,2016-06-07 15:00:00,783,561,Tuesday,15,1344
3923,DBRK,2016-06-07 16:00:00,1050,724,Tuesday,16,1774
3924,DBRK,2016-06-07 17:00:00,1682,1143,Tuesday,17,2825
3925,DBRK,2016-06-07 18:00:00,1340,1654,Tuesday,18,2994
3926,DBRK,2016-06-07 19:00:00,707,906,Tuesday,19,1613
3927,DBRK,2016-06-07 20:00:00,386,506,Tuesday,20,892
3928,DBRK,2016-06-07 21:00:00,352,375,Tuesday,21,727
3929,DBRK,2016-06-07 22:00:00,359,330,Tuesday,22,689
3930,DBRK,2016-06-07 23:00:00,163,237,Tuesday,23,400
3931,DBRK,2016-06-08 00:00:00,93,69,Wednesday,0,162
3932,DBRK,2016-06-08 01:00:00,24,4,Wednesday,1,28
3933,DBRK,2016-06-08 04:00:00,6,13,Wednesday,4,19
3934,DBRK,2016-06-08 05:00:00,53,59,Wednesday,5,112
3935,DBRK,2016-06-08 06:00:00,174,249,Wednesday,6,423
3936,DBRK,2016-06-08 07:00:00,591,954,Wednesday,7,1545
3937,DBRK,2016-06-08 08:00:00,1293,1677,Wednesday,8,2970
3938,DBRK,2016-06-08 09:00:00,1113,1209,Wednesday,9,2322
3939,DBRK,2016-06-08 10:00:00,528,664,Wednesday,10,1192
3940,DBRK,2016-06-08 11:00:00,472,526,Wednesday,11,998
3941,DBRK,2016-06-08 12:00:00,493,515,Wednesday,12,1008
3942,DBRK,2016-06-08 13:00:00,473,496,Wednesday,13,969
3943,DBRK,2016-06-08 14:00:00,536,533,Wednesday,14,1069
3944,DBRK,2016-06-08 15:00:00,727,510,Wednesday,15,1237
3945,DBRK,2016-06-08 16:00:00,1094,891,Wednesday,16,1985
3946,DBRK,2016-06-08 17:00:00,1763,1228,Wednesday,17,2991
3947,DBRK,2016-06-08 18:00:00,1373,1639,Wednesday,18,3012
3948,DBRK,2016-06-08 19:00:00,669,737,Wednesday,19,1406
3949,DBRK,2016-06-08 20:00:00,418,470,Wednesday,20,888
3950,DBRK,2016-06-08 21:00:00,435,545,Wednesday,21,980
3951,DBRK,2016-06-08 22:00:00,346,273,Wednesday,22,619
3952,DBRK,2016-06-08 23:00:00,181,236,Wednesday,23,417
3953,DBRK,2016-06-09 00:00:00,66,135,Thursday,0,201
3954,DBRK,2016-06-09 04:00:00,13,12,Thursday,4,25
3955,DBRK,2016-06-09 05:00:00,43,70,Thursday,5,113
3956,DBRK,2016-06-09 06:00:00,173,245,Thursday,6,418
3957,DBRK,2016-06-09 07:00:00,531,974,Thursday,7,1505
3958,DBRK,2016-06-09 08:00:00,1267,1617,Thursday,8,2884
3959,DBRK,2016-06-09 09:00:00,1086,1107,Thursday,9,2193
3960,DBRK,2016-06-09 10:00:00,589,651,Thursday,10,1240
3961,DBRK,2016-06-09 11:00:00,309,433,Thursday,11,742
3962,DBRK,2016-06-09 12:00:00,451,459,Thursday,12,910
3963,DBRK,2016-06-09 13:00:00,541,601,Thursday,13,1142
3964,DBRK,2016-06-09 14:00:00,570,469,Thursday,14,1039
3965,DBRK,2016-06-09 15:00:00,707,553,Thursday,15,1260
3966,DBRK,2016-06-09 16:00:00,1054,944,Thursday,16,1998
3967,DBRK,2016-06-09 17:00:00,1588,1428,Thursday,17,3016
3968,DBRK,2016-06-09 18:00:00,1359,2023,Thursday,18,3382
3969,DBRK,2016-06-09 19:00:00,768,835,Thursday,19,1603
3970,DBRK,2016-06-09 20:00:00,418,606,Thursday,20,1024
3971,DBRK,2016-06-09 21:00:00,434,503,Thursday,21,937
3972,DBRK,2016-06-09 22:00:00,642,353,Thursday,22,995
3973,DBRK,2016-06-09 23:00:00,723,174,Thursday,23,897
3974,DBRK,2016-06-10 00:00:00,154,103,Friday,0,257
3975,DBRK,2016-06-10 04:00:00,5,16,Friday,4,21
3976,DBRK,2016-06-10 05:00:00,42,55,Friday,5,97
3977,DBRK,2016-06-10 06:00:00,186,238,Friday,6,424
3978,DBRK,2016-06-10 07:00:00,518,844,Friday,7,1362
3979,DBRK,2016-06-10 08:00:00,1180,1463,Friday,8,2643
3980,DBRK,2016-06-10 09:00:00,989,991,Friday,9,1980
3981,DBRK,2016-06-10 10:00:00,628,691,Friday,10,1319
3982,DBRK,2016-06-10 11:00:00,421,474,Friday,11,895
3983,DBRK,2016-06-10 12:00:00,499,599,Friday,12,1098
3984,DBRK,2016-06-10 13:00:00,603,548,Friday,13,1151
3985,DBRK,2016-06-10 14:00:00,632,551,Friday,14,1183
3986,DBRK,2016-06-10 15:00:00,802,667,Friday,15,1469
3987,DBRK,2016-06-10 16:00:00,1113,884,Friday,16,1997
3988,DBRK,2016-06-10 17:00:00,1555,1234,Friday,17,2789
3989,DBRK,2016-06-10 18:00:00,1351,1684,Friday,18,3035
3990,DBRK,2016-06-10 19:00:00,709,839,Friday,19,1548
3991,DBRK,2016-06-10 20:00:00,431,501,Friday,20,932
3992,DBRK,2016-06-10 21:00:00,378,518,Friday,21,896
3993,DBRK,2016-06-10 22:00:00,498,282,Friday,22,780
3994,DBRK,2016-06-10 23:00:00,442,326,Friday,23,768
3995,DBRK,2016-06-11 00:00:00,458,212,Saturday,0,670
3996,DBRK,2016-06-11 05:00:00,1,1,Saturday,5,2
3997,DBRK,2016-06-11 06:00:00,29,52,Saturday,6,81
3998,DBRK,2016-06-11 07:00:00,98,105,Saturday,7,203
3999,DBRK,2016-06-11 08:00:00,151,265,Saturday,8,416
4000,DBRK,2016-06-11 09:00:00,279,339,Saturday,9,618
4001,DBRK,2016-06-11 10:00:00,429,389,Saturday,10,818
4002,DBRK,2016-06-11 11:00:00,554,439,Saturday,11,993
4003,DBRK,2016-06-11 12:00:00,574,537,Saturday,12,1111
4004,DBRK,2016-06-11 13:00:00,589,548,Saturday,13,1137
4005,DBRK,2016-06-11 14:00:00,608,479,Saturday,14,1087
4006,DBRK,2016-06-11 15:00:00,549,431,Saturday,15,980
4007,DBRK,2016-06-11 16:00:00,542,616,Saturday,16,1158
4008,DBRK,2016-06-11 17:00:00,565,619,Saturday,17,1184
4009,DBRK,2016-06-11 18:00:00,552,698,Saturday,18,1250
4010,DBRK,2016-06-11 19:00:00,394,756,Saturday,19,1150
4011,DBRK,2016-06-11 20:00:00,324,292,Saturday,20,616
4012,DBRK,2016-06-11 21:00:00,360,462,Saturday,21,822
4013,DBRK,2016-06-11 22:00:00,359,337,Saturday,22,696
4014,DBRK,2016-06-11 23:00:00,501,302,Saturday,23,803
4015,DBRK,2016-06-12 00:00:00,357,188,Sunday,0,545
4016,DBRK,2016-06-12 08:00:00,141,126,Sunday,8,267
4017,DBRK,2016-06-12 09:00:00,193,200,Sunday,9,393
4018,DBRK,2016-06-12 10:00:00,252,274,Sunday,10,526
4019,DBRK,2016-06-12 11:00:00,323,334,Sunday,11,657
4020,DBRK,2016-06-12 12:00:00,387,356,Sunday,12,743
4021,DBRK,2016-06-12 13:00:00,375,374,Sunday,13,749
4022,DBRK,2016-06-12 14:00:00,432,381,Sunday,14,813
4023,DBRK,2016-06-12 15:00:00,340,401,Sunday,15,741
4024,DBRK,2016-06-12 16:00:00,416,436,Sunday,16,852
4025,DBRK,2016-06-12 17:00:00,445,432,Sunday,17,877
4026,DBRK,2016-06-12 18:00:00,378,495,Sunday,18,873
4027,DBRK,2016-06-12 19:00:00,357,334,Sunday,19,691
4028,DBRK,2016-06-12 20:00:00,267,296,Sunday,20,563
4029,DBRK,2016-06-12 21:00:00,263,301,Sunday,21,564
4030,DBRK,2016-06-12 22:00:00,236,280,Sunday,22,516
4031,DBRK,2016-06-12 23:00:00,156,137,Sunday,23,293
4032,DBRK,2016-06-13 00:00:00,40,92,Monday,0,132
4033,DBRK,2016-06-13 01:00:00,9,1,Monday,1,10
4034,DBRK,2016-06-13 04:00:00,7,13,Monday,4,20
4035,DBRK,2016-06-13 05:00:00,48,72,Monday,5,120
4036,DBRK,2016-06-13 06:00:00,189,274,Monday,6,463
4037,DBRK,2016-06-13 07:00:00,625,942,Monday,7,1567
4038,DBRK,2016-06-13 08:00:00,1388,1581,Monday,8,2969
4039,DBRK,2016-06-13 09:00:00,1136,1416,Monday,9,2552
4040,DBRK,2016-06-13 10:00:00,548,726,Monday,10,1274
4041,DBRK,2016-06-13 11:00:00,393,482,Monday,11,875
4042,DBRK,2016-06-13 12:00:00,396,455,Monday,12,851
4043,DBRK,2016-06-13 13:00:00,453,462,Monday,13,915
4044,DBRK,2016-06-13 14:00:00,505,484,Monday,14,989
4045,DBRK,2016-06-13 15:00:00,687,525,Monday,15,1212
4046,DBRK,2016-06-13 16:00:00,1187,628,Monday,16,1815
4047,DBRK,2016-06-13 17:00:00,1674,1590,Monday,17,3264
4048,DBRK,2016-06-13 18:00:00,1422,1232,Monday,18,2654
4049,DBRK,2016-06-13 19:00:00,697,911,Monday,19,1608
4050,DBRK,2016-06-13 20:00:00,312,452,Monday,20,764
4051,DBRK,2016-06-13 21:00:00,420,580,Monday,21,1000
4052,DBRK,2016-06-13 22:00:00,312,245,Monday,22,557
4053,DBRK,2016-06-13 23:00:00,164,215,Monday,23,379
4054,DBRK,2016-06-14 00:00:00,56,83,Tuesday,0,139
4055,DBRK,2016-06-14 04:00:00,6,14,Tuesday,4,20
4056,DBRK,2016-06-14 05:00:00,40,69,Tuesday,5,109
4057,DBRK,2016-06-14 06:00:00,191,276,Tuesday,6,467
4058,DBRK,2016-06-14 07:00:00,589,1094,Tuesday,7,1683
4059,DBRK,2016-06-14 08:00:00,1346,1738,Tuesday,8,3084
4060,DBRK,2016-06-14 09:00:00,1147,1315,Tuesday,9,2462
4061,DBRK,2016-06-14 10:00:00,530,672,Tuesday,10,1202
4062,DBRK,2016-06-14 11:00:00,398,541,Tuesday,11,939
4063,DBRK,2016-06-14 12:00:00,493,458,Tuesday,12,951
4064,DBRK,2016-06-14 13:00:00,619,500,Tuesday,13,1119
4065,DBRK,2016-06-14 14:00:00,568,499,Tuesday,14,1067
4066,DBRK,2016-06-14 15:00:00,715,573,Tuesday,15,1288
4067,DBRK,2016-06-14 16:00:00,1155,710,Tuesday,16,1865
4068,DBRK,2016-06-14 17:00:00,1746,1245,Tuesday,17,2991
4069,DBRK,2016-06-14 18:00:00,1489,1656,Tuesday,18,3145
4070,DBRK,2016-06-14 19:00:00,740,934,Tuesday,19,1674
4071,DBRK,2016-06-14 20:00:00,384,538,Tuesday,20,922
4072,DBRK,2016-06-14 21:00:00,358,392,Tuesday,21,750
4073,DBRK,2016-06-14 22:00:00,349,367,Tuesday,22,716
4074,DBRK,2016-06-14 23:00:00,170,257,Tuesday,23,427
4075,DELN,2016-06-01 01:00:00,1,15,Wednesday,1,16
4076,DELN,2016-06-01 04:00:00,56,4,Wednesday,4,60
4077,DELN,2016-06-01 05:00:00,338,37,Wednesday,5,375
4078,DELN,2016-06-01 06:00:00,898,86,Wednesday,6,984
4079,DELN,2016-06-01 07:00:00,1606,203,Wednesday,7,1809
4080,DELN,2016-06-01 08:00:00,1785,173,Wednesday,8,1958
4081,DELN,2016-06-01 09:00:00,1009,148,Wednesday,9,1157
4082,DELN,2016-06-01 10:00:00,537,117,Wednesday,10,654
4083,DELN,2016-06-01 11:00:00,280,131,Wednesday,11,411
4084,DELN,2016-06-01 12:00:00,305,210,Wednesday,12,515
4085,DELN,2016-06-01 13:00:00,271,279,Wednesday,13,550
4086,DELN,2016-06-01 14:00:00,268,420,Wednesday,14,688
4087,DELN,2016-06-01 15:00:00,230,758,Wednesday,15,988
4088,DELN,2016-06-01 16:00:00,240,1158,Wednesday,16,1398
4089,DELN,2016-06-01 17:00:00,286,1648,Wednesday,17,1934
4090,DELN,2016-06-01 18:00:00,197,1731,Wednesday,18,1928
4091,DELN,2016-06-01 19:00:00,117,793,Wednesday,19,910
4092,DELN,2016-06-01 20:00:00,95,417,Wednesday,20,512
4093,DELN,2016-06-01 21:00:00,82,348,Wednesday,21,430
4094,DELN,2016-06-01 22:00:00,78,208,Wednesday,22,286
4095,DELN,2016-06-01 23:00:00,23,168,Wednesday,23,191
4096,DELN,2016-06-02 00:00:00,16,97,Thursday,0,113
4097,DELN,2016-06-02 01:00:00,2,22,Thursday,1,24
4098,DELN,2016-06-02 04:00:00,50,3,Thursday,4,53
4099,DELN,2016-06-02 05:00:00,355,44,Thursday,5,399
4100,DELN,2016-06-02 06:00:00,871,99,Thursday,6,970
4101,DELN,2016-06-02 07:00:00,1589,205,Thursday,7,1794
4102,DELN,2016-06-02 08:00:00,1807,162,Thursday,8,1969
4103,DELN,2016-06-02 09:00:00,1008,124,Thursday,9,1132
4104,DELN,2016-06-02 10:00:00,483,106,Thursday,10,589
4105,DELN,2016-06-02 11:00:00,321,153,Thursday,11,474
4106,DELN,2016-06-02 12:00:00,264,195,Thursday,12,459
4107,DELN,2016-06-02 13:00:00,284,257,Thursday,13,541
4108,DELN,2016-06-02 14:00:00,311,415,Thursday,14,726
4109,DELN,2016-06-02 15:00:00,259,724,Thursday,15,983
4110,DELN,2016-06-02 16:00:00,293,1063,Thursday,16,1356
4111,DELN,2016-06-02 17:00:00,321,2170,Thursday,17,2491
4112,DELN,2016-06-02 18:00:00,233,1328,Thursday,18,1561
4113,DELN,2016-06-02 19:00:00,143,727,Thursday,19,870
4114,DELN,2016-06-02 20:00:00,88,424,Thursday,20,512
4115,DELN,2016-06-02 21:00:00,74,450,Thursday,21,524
4116,DELN,2016-06-02 22:00:00,92,325,Thursday,22,417
4117,DELN,2016-06-02 23:00:00,40,122,Thursday,23,162
4118,DELN,2016-06-03 00:00:00,8,114,Friday,0,122
4119,DELN,2016-06-03 01:00:00,5,51,Friday,1,56
4120,DELN,2016-06-03 04:00:00,43,1,Friday,4,44
4121,DELN,2016-06-03 05:00:00,304,38,Friday,5,342
4122,DELN,2016-06-03 06:00:00,824,95,Friday,6,919
4123,DELN,2016-06-03 07:00:00,1452,189,Friday,7,1641
4124,DELN,2016-06-03 08:00:00,1587,191,Friday,8,1778
4125,DELN,2016-06-03 09:00:00,904,125,Friday,9,1029
4126,DELN,2016-06-03 10:00:00,465,155,Friday,10,620
4127,DELN,2016-06-03 11:00:00,313,147,Friday,11,460
4128,DELN,2016-06-03 12:00:00,291,225,Friday,12,516
4129,DELN,2016-06-03 13:00:00,325,267,Friday,13,592
4130,DELN,2016-06-03 14:00:00,346,440,Friday,14,786
4131,DELN,2016-06-03 15:00:00,278,724,Friday,15,1002
4132,DELN,2016-06-03 16:00:00,279,1196,Friday,16,1475
4133,DELN,2016-06-03 17:00:00,286,1564,Friday,17,1850
4134,DELN,2016-06-03 18:00:00,272,1187,Friday,18,1459
4135,DELN,2016-06-03 19:00:00,218,680,Friday,19,898
4136,DELN,2016-06-03 20:00:00,106,369,Friday,20,475
4137,DELN,2016-06-03 21:00:00,92,446,Friday,21,538
4138,DELN,2016-06-03 22:00:00,82,288,Friday,22,370
4139,DELN,2016-06-03 23:00:00,64,295,Friday,23,359
4140,DELN,2016-06-04 00:00:00,25,146,Saturday,0,171
4141,DELN,2016-06-04 01:00:00,8,32,Saturday,1,40
4142,DELN,2016-06-04 06:00:00,129,37,Saturday,6,166
4143,DELN,2016-06-04 07:00:00,232,62,Saturday,7,294
4144,DELN,2016-06-04 08:00:00,271,111,Saturday,8,382
4145,DELN,2016-06-04 09:00:00,327,133,Saturday,9,460
4146,DELN,2016-06-04 10:00:00,343,87,Saturday,10,430
4147,DELN,2016-06-04 11:00:00,334,138,Saturday,11,472
4148,DELN,2016-06-04 12:00:00,314,162,Saturday,12,476
4149,DELN,2016-06-04 13:00:00,307,197,Saturday,13,504
4150,DELN,2016-06-04 14:00:00,270,241,Saturday,14,511
4151,DELN,2016-06-04 15:00:00,215,301,Saturday,15,516
4152,DELN,2016-06-04 16:00:00,182,333,Saturday,16,515
4153,DELN,2016-06-04 17:00:00,209,339,Saturday,17,548
4154,DELN,2016-06-04 18:00:00,180,374,Saturday,18,554
4155,DELN,2016-06-04 19:00:00,154,309,Saturday,19,463
4156,DELN,2016-06-04 20:00:00,120,239,Saturday,20,359
4157,DELN,2016-06-04 21:00:00,85,226,Saturday,21,311
4158,DELN,2016-06-04 22:00:00,89,245,Saturday,22,334
4159,DELN,2016-06-04 23:00:00,53,188,Saturday,23,241
4160,DELN,2016-06-05 00:00:00,19,102,Sunday,0,121
4161,DELN,2016-06-05 01:00:00,5,31,Sunday,1,36
4162,DELN,2016-06-05 07:00:00,1,1,Sunday,7,2
4163,DELN,2016-06-05 08:00:00,167,77,Sunday,8,244
4164,DELN,2016-06-05 09:00:00,225,87,Sunday,9,312
4165,DELN,2016-06-05 10:00:00,310,109,Sunday,10,419
4166,DELN,2016-06-05 11:00:00,332,87,Sunday,11,419
4167,DELN,2016-06-05 12:00:00,203,109,Sunday,12,312
4168,DELN,2016-06-05 13:00:00,247,149,Sunday,13,396
4169,DELN,2016-06-05 14:00:00,268,163,Sunday,14,431
4170,DELN,2016-06-05 15:00:00,220,208,Sunday,15,428
4171,DELN,2016-06-05 16:00:00,197,264,Sunday,16,461
4172,DELN,2016-06-05 17:00:00,127,268,Sunday,17,395
4173,DELN,2016-06-05 18:00:00,107,248,Sunday,18,355
4174,DELN,2016-06-05 19:00:00,75,226,Sunday,19,301
4175,DELN,2016-06-05 20:00:00,85,201,Sunday,20,286
4176,DELN,2016-06-05 21:00:00,68,267,Sunday,21,335
4177,DELN,2016-06-05 22:00:00,64,129,Sunday,22,193
4178,DELN,2016-06-05 23:00:00,34,122,Sunday,23,156
4179,DELN,2016-06-06 00:00:00,13,63,Monday,0,76
4180,DELN,2016-06-06 01:00:00,2,7,Monday,1,9
4181,DELN,2016-06-06 04:00:00,48,3,Monday,4,51
4182,DELN,2016-06-06 05:00:00,322,35,Monday,5,357
4183,DELN,2016-06-06 06:00:00,811,84,Monday,6,895
4184,DELN,2016-06-06 07:00:00,1567,198,Monday,7,1765
4185,DELN,2016-06-06 08:00:00,1705,168,Monday,8,1873
4186,DELN,2016-06-06 09:00:00,1065,163,Monday,9,1228
4187,DELN,2016-06-06 10:00:00,510,111,Monday,10,621
4188,DELN,2016-06-06 11:00:00,321,140,Monday,11,461
4189,DELN,2016-06-06 12:00:00,251,207,Monday,12,458
4190,DELN,2016-06-06 13:00:00,271,215,Monday,13,486
4191,DELN,2016-06-06 14:00:00,277,367,Monday,14,644
4192,DELN,2016-06-06 15:00:00,239,716,Monday,15,955
4193,DELN,2016-06-06 16:00:00,229,1286,Monday,16,1515
4194,DELN,2016-06-06 17:00:00,259,1696,Monday,17,1955
4195,DELN,2016-06-06 18:00:00,189,1503,Monday,18,1692
4196,DELN,2016-06-06 19:00:00,124,714,Monday,19,838
4197,DELN,2016-06-06 20:00:00,82,460,Monday,20,542
4198,DELN,2016-06-06 21:00:00,86,311,Monday,21,397
4199,DELN,2016-06-06 22:00:00,71,269,Monday,22,340
4200,DELN,2016-06-06 23:00:00,44,178,Monday,23,222
4201,DELN,2016-06-07 00:00:00,17,89,Tuesday,0,106
4202,DELN,2016-06-07 01:00:00,2,14,Tuesday,1,16
4203,DELN,2016-06-07 04:00:00,55,3,Tuesday,4,58
4204,DELN,2016-06-07 05:00:00,331,44,Tuesday,5,375
4205,DELN,2016-06-07 06:00:00,862,83,Tuesday,6,945
4206,DELN,2016-06-07 07:00:00,1527,195,Tuesday,7,1722
4207,DELN,2016-06-07 08:00:00,1880,172,Tuesday,8,2052
4208,DELN,2016-06-07 09:00:00,1010,135,Tuesday,9,1145
4209,DELN,2016-06-07 10:00:00,495,127,Tuesday,10,622
4210,DELN,2016-06-07 11:00:00,313,152,Tuesday,11,465
4211,DELN,2016-06-07 12:00:00,272,190,Tuesday,12,462
4212,DELN,2016-06-07 13:00:00,262,239,Tuesday,13,501
4213,DELN,2016-06-07 14:00:00,258,399,Tuesday,14,657
4214,DELN,2016-06-07 15:00:00,254,752,Tuesday,15,1006
4215,DELN,2016-06-07 16:00:00,268,1316,Tuesday,16,1584
4216,DELN,2016-06-07 17:00:00,275,1706,Tuesday,17,1981
4217,DELN,2016-06-07 18:00:00,240,1595,Tuesday,18,1835
4218,DELN,2016-06-07 19:00:00,155,721,Tuesday,19,876
4219,DELN,2016-06-07 20:00:00,82,438,Tuesday,20,520
4220,DELN,2016-06-07 21:00:00,85,347,Tuesday,21,432
4221,DELN,2016-06-07 22:00:00,77,267,Tuesday,22,344
4222,DELN,2016-06-07 23:00:00,32,157,Tuesday,23,189
4223,DELN,2016-06-08 00:00:00,14,142,Wednesday,0,156
4224,DELN,2016-06-08 01:00:00,2,42,Wednesday,1,44
4225,DELN,2016-06-08 04:00:00,58,3,Wednesday,4,61
4226,DELN,2016-06-08 05:00:00,328,47,Wednesday,5,375
4227,DELN,2016-06-08 06:00:00,882,83,Wednesday,6,965
4228,DELN,2016-06-08 07:00:00,1635,214,Wednesday,7,1849
4229,DELN,2016-06-08 08:00:00,1789,159,Wednesday,8,1948
4230,DELN,2016-06-08 09:00:00,896,100,Wednesday,9,996
4231,DELN,2016-06-08 10:00:00,527,124,Wednesday,10,651
4232,DELN,2016-06-08 11:00:00,349,146,Wednesday,11,495
4233,DELN,2016-06-08 12:00:00,286,188,Wednesday,12,474
4234,DELN,2016-06-08 13:00:00,297,286,Wednesday,13,583
4235,DELN,2016-06-08 14:00:00,292,444,Wednesday,14,736
4236,DELN,2016-06-08 15:00:00,249,768,Wednesday,15,1017
4237,DELN,2016-06-08 16:00:00,268,1203,Wednesday,16,1471
4238,DELN,2016-06-08 17:00:00,414,1929,Wednesday,17,2343
4239,DELN,2016-06-08 18:00:00,258,1380,Wednesday,18,1638
4240,DELN,2016-06-08 19:00:00,131,666,Wednesday,19,797
4241,DELN,2016-06-08 20:00:00,72,415,Wednesday,20,487
4242,DELN,2016-06-08 21:00:00,81,521,Wednesday,21,602
4243,DELN,2016-06-08 22:00:00,83,281,Wednesday,22,364
4244,DELN,2016-06-08 23:00:00,27,206,Wednesday,23,233
4245,DELN,2016-06-09 00:00:00,18,152,Thursday,0,170
4246,DELN,2016-06-09 01:00:00,1,27,Thursday,1,28
4247,DELN,2016-06-09 04:00:00,51,5,Thursday,4,56
4248,DELN,2016-06-09 05:00:00,331,41,Thursday,5,372
4249,DELN,2016-06-09 06:00:00,840,84,Thursday,6,924
4250,DELN,2016-06-09 07:00:00,1487,183,Thursday,7,1670
4251,DELN,2016-06-09 08:00:00,1805,149,Thursday,8,1954
4252,DELN,2016-06-09 09:00:00,952,141,Thursday,9,1093
4253,DELN,2016-06-09 10:00:00,542,137,Thursday,10,679
4254,DELN,2016-06-09 11:00:00,332,120,Thursday,11,452
4255,DELN,2016-06-09 12:00:00,303,179,Thursday,12,482
4256,DELN,2016-06-09 13:00:00,312,268,Thursday,13,580
4257,DELN,2016-06-09 14:00:00,288,435,Thursday,14,723
4258,DELN,2016-06-09 15:00:00,233,694,Thursday,15,927
4259,DELN,2016-06-09 16:00:00,228,1270,Thursday,16,1498
4260,DELN,2016-06-09 17:00:00,294,1639,Thursday,17,1933
4261,DELN,2016-06-09 18:00:00,212,1434,Thursday,18,1646
4262,DELN,2016-06-09 19:00:00,123,830,Thursday,19,953
4263,DELN,2016-06-09 20:00:00,87,445,Thursday,20,532
4264,DELN,2016-06-09 21:00:00,98,389,Thursday,21,487
4265,DELN,2016-06-09 22:00:00,58,208,Thursday,22,266
4266,DELN,2016-06-09 23:00:00,35,269,Thursday,23,304
4267,DELN,2016-06-10 00:00:00,13,104,Friday,0,117
4268,DELN,2016-06-10 01:00:00,6,22,Friday,1,28
4269,DELN,2016-06-10 04:00:00,49,12,Friday,4,61
4270,DELN,2016-06-10 05:00:00,319,29,Friday,5,348
4271,DELN,2016-06-10 06:00:00,781,76,Friday,6,857
4272,DELN,2016-06-10 07:00:00,1399,179,Friday,7,1578
4273,DELN,2016-06-10 08:00:00,1494,148,Friday,8,1642
4274,DELN,2016-06-10 09:00:00,874,127,Friday,9,1001
4275,DELN,2016-06-10 10:00:00,512,116,Friday,10,628
4276,DELN,2016-06-10 11:00:00,386,132,Friday,11,518
4277,DELN,2016-06-10 12:00:00,326,233,Friday,12,559
4278,DELN,2016-06-10 13:00:00,314,316,Friday,13,630
4279,DELN,2016-06-10 14:00:00,303,427,Friday,14,730
4280,DELN,2016-06-10 15:00:00,272,775,Friday,15,1047
4281,DELN,2016-06-10 16:00:00,307,1172,Friday,16,1479
4282,DELN,2016-06-10 17:00:00,381,1458,Friday,17,1839
4283,DELN,2016-06-10 18:00:00,349,1240,Friday,18,1589
4284,DELN,2016-06-10 19:00:00,148,560,Friday,19,708
4285,DELN,2016-06-10 20:00:00,100,353,Friday,20,453
4286,DELN,2016-06-10 21:00:00,68,406,Friday,21,474
4287,DELN,2016-06-10 22:00:00,98,367,Friday,22,465
4288,DELN,2016-06-10 23:00:00,44,343,Friday,23,387
4289,DELN,2016-06-11 00:00:00,19,149,Saturday,0,168
4290,DELN,2016-06-11 01:00:00,7,31,Saturday,1,38
4291,DELN,2016-06-11 06:00:00,101,31,Saturday,6,132
4292,DELN,2016-06-11 07:00:00,238,36,Saturday,7,274
4293,DELN,2016-06-11 08:00:00,277,137,Saturday,8,414
4294,DELN,2016-06-11 09:00:00,303,96,Saturday,9,399
4295,DELN,2016-06-11 10:00:00,339,105,Saturday,10,444
4296,DELN,2016-06-11 11:00:00,302,124,Saturday,11,426
4297,DELN,2016-06-11 12:00:00,322,138,Saturday,12,460
4298,DELN,2016-06-11 13:00:00,325,170,Saturday,13,495
4299,DELN,2016-06-11 14:00:00,334,175,Saturday,14,509
4300,DELN,2016-06-11 15:00:00,251,285,Saturday,15,536
4301,DELN,2016-06-11 16:00:00,224,306,Saturday,16,530
4302,DELN,2016-06-11 17:00:00,173,342,Saturday,17,515
4303,DELN,2016-06-11 18:00:00,173,397,Saturday,18,570
4304,DELN,2016-06-11 19:00:00,151,332,Saturday,19,483
4305,DELN,2016-06-11 20:00:00,74,204,Saturday,20,278
4306,DELN,2016-06-11 21:00:00,101,192,Saturday,21,293
4307,DELN,2016-06-11 22:00:00,81,412,Saturday,22,493
4308,DELN,2016-06-11 23:00:00,53,221,Saturday,23,274
4309,DELN,2016-06-12 00:00:00,18,106,Sunday,0,124
4310,DELN,2016-06-12 01:00:00,5,30,Sunday,1,35
4311,DELN,2016-06-12 08:00:00,182,92,Sunday,8,274
4312,DELN,2016-06-12 09:00:00,209,74,Sunday,9,283
4313,DELN,2016-06-12 10:00:00,217,70,Sunday,10,287
4314,DELN,2016-06-12 11:00:00,267,89,Sunday,11,356
4315,DELN,2016-06-12 12:00:00,236,77,Sunday,12,313
4316,DELN,2016-06-12 13:00:00,221,138,Sunday,13,359
4317,DELN,2016-06-12 14:00:00,234,143,Sunday,14,377
4318,DELN,2016-06-12 15:00:00,213,141,Sunday,15,354
4319,DELN,2016-06-12 16:00:00,188,142,Sunday,16,330
4320,DELN,2016-06-12 17:00:00,147,224,Sunday,17,371
4321,DELN,2016-06-12 18:00:00,165,256,Sunday,18,421
4322,DELN,2016-06-12 19:00:00,170,312,Sunday,19,482
4323,DELN,2016-06-12 20:00:00,74,215,Sunday,20,289
4324,DELN,2016-06-12 21:00:00,86,189,Sunday,21,275
4325,DELN,2016-06-12 22:00:00,49,234,Sunday,22,283
4326,DELN,2016-06-12 23:00:00,43,206,Sunday,23,249
4327,DELN,2016-06-13 00:00:00,15,119,Monday,0,134
4328,DELN,2016-06-13 01:00:00,3,14,Monday,1,17
4329,DELN,2016-06-13 04:00:00,57,3,Monday,4,60
4330,DELN,2016-06-13 05:00:00,322,41,Monday,5,363
4331,DELN,2016-06-13 06:00:00,799,83,Monday,6,882
4332,DELN,2016-06-13 07:00:00,1559,153,Monday,7,1712
4333,DELN,2016-06-13 08:00:00,1806,184,Monday,8,1990
4334,DELN,2016-06-13 09:00:00,962,114,Monday,9,1076
4335,DELN,2016-06-13 10:00:00,425,137,Monday,10,562
4336,DELN,2016-06-13 11:00:00,321,153,Monday,11,474
4337,DELN,2016-06-13 12:00:00,296,180,Monday,12,476
4338,DELN,2016-06-13 13:00:00,261,245,Monday,13,506
4339,DELN,2016-06-13 14:00:00,271,375,Monday,14,646
4340,DELN,2016-06-13 15:00:00,274,699,Monday,15,973
4341,DELN,2016-06-13 16:00:00,289,1279,Monday,16,1568
4342,DELN,2016-06-13 17:00:00,369,1765,Monday,17,2134
4343,DELN,2016-06-13 18:00:00,315,1411,Monday,18,1726
4344,DELN,2016-06-13 19:00:00,133,651,Monday,19,784
4345,DELN,2016-06-13 20:00:00,82,347,Monday,20,429
4346,DELN,2016-06-13 21:00:00,83,476,Monday,21,559
4347,DELN,2016-06-13 22:00:00,73,386,Monday,22,459
4348,DELN,2016-06-13 23:00:00,37,270,Monday,23,307
4349,DELN,2016-06-14 00:00:00,19,104,Tuesday,0,123
4350,DELN,2016-06-14 01:00:00,3,23,Tuesday,1,26
4351,DELN,2016-06-14 04:00:00,50,11,Tuesday,4,61
4352,DELN,2016-06-14 05:00:00,354,53,Tuesday,5,407
4353,DELN,2016-06-14 06:00:00,860,84,Tuesday,6,944
4354,DELN,2016-06-14 07:00:00,1597,185,Tuesday,7,1782
4355,DELN,2016-06-14 08:00:00,1844,150,Tuesday,8,1994
4356,DELN,2016-06-14 09:00:00,1024,114,Tuesday,9,1138
4357,DELN,2016-06-14 10:00:00,476,134,Tuesday,10,610
4358,DELN,2016-06-14 11:00:00,326,148,Tuesday,11,474
4359,DELN,2016-06-14 12:00:00,253,181,Tuesday,12,434
4360,DELN,2016-06-14 13:00:00,289,266,Tuesday,13,555
4361,DELN,2016-06-14 14:00:00,261,395,Tuesday,14,656
4362,DELN,2016-06-14 15:00:00,247,596,Tuesday,15,843
4363,DELN,2016-06-14 16:00:00,275,1325,Tuesday,16,1600
4364,DELN,2016-06-14 17:00:00,314,1786,Tuesday,17,2100
4365,DELN,2016-06-14 18:00:00,300,1556,Tuesday,18,1856
4366,DELN,2016-06-14 19:00:00,131,766,Tuesday,19,897
4367,DELN,2016-06-14 20:00:00,77,467,Tuesday,20,544
4368,DELN,2016-06-14 21:00:00,73,311,Tuesday,21,384
4369,DELN,2016-06-14 22:00:00,70,246,Tuesday,22,316
4370,DELN,2016-06-14 23:00:00,40,243,Tuesday,23,283
4371,DUBL,2016-06-01 01:00:00,11,12,Wednesday,1,23
4372,DUBL,2016-06-01 04:00:00,5,1,Wednesday,4,6
4373,DUBL,2016-06-01 05:00:00,256,40,Wednesday,5,296
4374,DUBL,2016-06-01 06:00:00,558,160,Wednesday,6,718
4375,DUBL,2016-06-01 07:00:00,1319,329,Wednesday,7,1648
4376,DUBL,2016-06-01 08:00:00,1930,297,Wednesday,8,2227
4377,DUBL,2016-06-01 09:00:00,1288,155,Wednesday,9,1443
4378,DUBL,2016-06-01 10:00:00,553,154,Wednesday,10,707
4379,DUBL,2016-06-01 11:00:00,272,125,Wednesday,11,397
4380,DUBL,2016-06-01 12:00:00,212,126,Wednesday,12,338
4381,DUBL,2016-06-01 13:00:00,163,167,Wednesday,13,330
4382,DUBL,2016-06-01 14:00:00,121,289,Wednesday,14,410
4383,DUBL,2016-06-01 15:00:00,149,421,Wednesday,15,570
4384,DUBL,2016-06-01 16:00:00,203,595,Wednesday,16,798
4385,DUBL,2016-06-01 17:00:00,343,1578,Wednesday,17,1921
4386,DUBL,2016-06-01 18:00:00,357,1988,Wednesday,18,2345
4387,DUBL,2016-06-01 19:00:00,173,728,Wednesday,19,901
4388,DUBL,2016-06-01 20:00:00,91,436,Wednesday,20,527
4389,DUBL,2016-06-01 21:00:00,83,203,Wednesday,21,286
4390,DUBL,2016-06-01 22:00:00,78,150,Wednesday,22,228
4391,DUBL,2016-06-01 23:00:00,56,79,Wednesday,23,135
4392,DUBL,2016-06-02 00:00:00,26,34,Thursday,0,60
4393,DUBL,2016-06-02 01:00:00,14,26,Thursday,1,40
4394,DUBL,2016-06-02 03:00:00,1,1,Thursday,3,2
4395,DUBL,2016-06-02 04:00:00,11,2,Thursday,4,13
4396,DUBL,2016-06-02 05:00:00,282,40,Thursday,5,322
4397,DUBL,2016-06-02 06:00:00,571,167,Thursday,6,738
4398,DUBL,2016-06-02 07:00:00,1256,328,Thursday,7,1584
4399,DUBL,2016-06-02 08:00:00,2002,307,Thursday,8,2309
4400,DUBL,2016-06-02 09:00:00,1269,148,Thursday,9,1417
4401,DUBL,2016-06-02 10:00:00,516,125,Thursday,10,641
4402,DUBL,2016-06-02 11:00:00,286,165,Thursday,11,451
4403,DUBL,2016-06-02 12:00:00,197,153,Thursday,12,350
4404,DUBL,2016-06-02 13:00:00,164,192,Thursday,13,356
4405,DUBL,2016-06-02 14:00:00,113,285,Thursday,14,398
4406,DUBL,2016-06-02 15:00:00,165,279,Thursday,15,444
4407,DUBL,2016-06-02 16:00:00,303,774,Thursday,16,1077
4408,DUBL,2016-06-02 17:00:00,472,1825,Thursday,17,2297
4409,DUBL,2016-06-02 18:00:00,353,1742,Thursday,18,2095
4410,DUBL,2016-06-02 19:00:00,190,696,Thursday,19,886
4411,DUBL,2016-06-02 20:00:00,90,286,Thursday,20,376
4412,DUBL,2016-06-02 21:00:00,59,459,Thursday,21,518
4413,DUBL,2016-06-02 22:00:00,57,209,Thursday,22,266
4414,DUBL,2016-06-02 23:00:00,38,110,Thursday,23,148
4415,DUBL,2016-06-03 00:00:00,17,45,Friday,0,62
4416,DUBL,2016-06-03 01:00:00,9,16,Friday,1,25
4417,DUBL,2016-06-03 03:00:00,1,1,Friday,3,2
4418,DUBL,2016-06-03 05:00:00,233,31,Friday,5,264
4419,DUBL,2016-06-03 06:00:00,507,155,Friday,6,662
4420,DUBL,2016-06-03 07:00:00,1028,257,Friday,7,1285
4421,DUBL,2016-06-03 08:00:00,1531,263,Friday,8,1794
4422,DUBL,2016-06-03 09:00:00,1152,142,Friday,9,1294
4423,DUBL,2016-06-03 10:00:00,453,129,Friday,10,582
4424,DUBL,2016-06-03 11:00:00,289,157,Friday,11,446
4425,DUBL,2016-06-03 12:00:00,187,159,Friday,12,346
4426,DUBL,2016-06-03 13:00:00,153,237,Friday,13,390
4427,DUBL,2016-06-03 14:00:00,131,307,Friday,14,438
4428,DUBL,2016-06-03 15:00:00,138,488,Friday,15,626
4429,DUBL,2016-06-03 16:00:00,239,891,Friday,16,1130
4430,DUBL,2016-06-03 17:00:00,375,1085,Friday,17,1460
4431,DUBL,2016-06-03 18:00:00,382,1474,Friday,18,1856
4432,DUBL,2016-06-03 19:00:00,242,591,Friday,19,833
4433,DUBL,2016-06-03 20:00:00,124,289,Friday,20,413
4434,DUBL,2016-06-03 21:00:00,91,212,Friday,21,303
4435,DUBL,2016-06-03 22:00:00,81,204,Friday,22,285
4436,DUBL,2016-06-03 23:00:00,58,147,Friday,23,205
4437,DUBL,2016-06-04 00:00:00,27,66,Saturday,0,93
4438,DUBL,2016-06-04 01:00:00,6,66,Saturday,1,72
4439,DUBL,2016-06-04 06:00:00,28,1,Saturday,6,29
4440,DUBL,2016-06-04 07:00:00,80,95,Saturday,7,175
4441,DUBL,2016-06-04 08:00:00,117,88,Saturday,8,205
4442,DUBL,2016-06-04 09:00:00,170,116,Saturday,9,286
4443,DUBL,2016-06-04 10:00:00,237,142,Saturday,10,379
4444,DUBL,2016-06-04 11:00:00,319,128,Saturday,11,447
4445,DUBL,2016-06-04 12:00:00,283,122,Saturday,12,405
4446,DUBL,2016-06-04 13:00:00,240,119,Saturday,13,359
4447,DUBL,2016-06-04 14:00:00,173,109,Saturday,14,282
4448,DUBL,2016-06-04 15:00:00,187,217,Saturday,15,404
4449,DUBL,2016-06-04 16:00:00,142,252,Saturday,16,394
4450,DUBL,2016-06-04 17:00:00,166,220,Saturday,17,386
4451,DUBL,2016-06-04 18:00:00,142,226,Saturday,18,368
4452,DUBL,2016-06-04 19:00:00,126,194,Saturday,19,320
4453,DUBL,2016-06-04 20:00:00,100,207,Saturday,20,307
4454,DUBL,2016-06-04 21:00:00,72,162,Saturday,21,234
4455,DUBL,2016-06-04 22:00:00,67,137,Saturday,22,204
4456,DUBL,2016-06-04 23:00:00,54,135,Saturday,23,189
4457,DUBL,2016-06-05 00:00:00,20,85,Sunday,0,105
4458,DUBL,2016-06-05 01:00:00,2,41,Sunday,1,43
4459,DUBL,2016-06-05 08:00:00,93,66,Sunday,8,159
4460,DUBL,2016-06-05 09:00:00,117,109,Sunday,9,226
4461,DUBL,2016-06-05 10:00:00,218,97,Sunday,10,315
4462,DUBL,2016-06-05 11:00:00,230,123,Sunday,11,353
4463,DUBL,2016-06-05 12:00:00,186,125,Sunday,12,311
4464,DUBL,2016-06-05 13:00:00,157,137,Sunday,13,294
4465,DUBL,2016-06-05 14:00:00,170,122,Sunday,14,292
4466,DUBL,2016-06-05 15:00:00,239,186,Sunday,15,425
4467,DUBL,2016-06-05 16:00:00,235,137,Sunday,16,372
4468,DUBL,2016-06-05 17:00:00,149,226,Sunday,17,375
4469,DUBL,2016-06-05 18:00:00,116,185,Sunday,18,301
4470,DUBL,2016-06-05 19:00:00,89,155,Sunday,19,244
4471,DUBL,2016-06-05 20:00:00,95,358,Sunday,20,453
4472,DUBL,2016-06-05 21:00:00,85,146,Sunday,21,231
4473,DUBL,2016-06-05 22:00:00,65,94,Sunday,22,159
4474,DUBL,2016-06-05 23:00:00,35,59,Sunday,23,94
4475,DUBL,2016-06-06 00:00:00,10,29,Monday,0,39
4476,DUBL,2016-06-06 01:00:00,6,18,Monday,1,24
4477,DUBL,2016-06-06 04:00:00,24,1,Monday,4,25
4478,DUBL,2016-06-06 05:00:00,225,38,Monday,5,263
4479,DUBL,2016-06-06 06:00:00,556,144,Monday,6,700
4480,DUBL,2016-06-06 07:00:00,1268,304,Monday,7,1572
4481,DUBL,2016-06-06 08:00:00,1946,303,Monday,8,2249
4482,DUBL,2016-06-06 09:00:00,1513,168,Monday,9,1681
4483,DUBL,2016-06-06 10:00:00,463,136,Monday,10,599
4484,DUBL,2016-06-06 11:00:00,271,139,Monday,11,410
4485,DUBL,2016-06-06 12:00:00,170,142,Monday,12,312
4486,DUBL,2016-06-06 13:00:00,119,158,Monday,13,277
4487,DUBL,2016-06-06 14:00:00,128,222,Monday,14,350
4488,DUBL,2016-06-06 15:00:00,129,405,Monday,15,534
4489,DUBL,2016-06-06 16:00:00,212,874,Monday,16,1086
4490,DUBL,2016-06-06 17:00:00,334,1734,Monday,17,2068
4491,DUBL,2016-06-06 18:00:00,338,1331,Monday,18,1669
4492,DUBL,2016-06-06 19:00:00,157,996,Monday,19,1153
4493,DUBL,2016-06-06 20:00:00,116,389,Monday,20,505
4494,DUBL,2016-06-06 21:00:00,72,190,Monday,21,262
4495,DUBL,2016-06-06 22:00:00,57,135,Monday,22,192
4496,DUBL,2016-06-06 23:00:00,31,72,Monday,23,103
4497,DUBL,2016-06-07 00:00:00,15,33,Tuesday,0,48
4498,DUBL,2016-06-07 01:00:00,8,10,Tuesday,1,18
4499,DUBL,2016-06-07 04:00:00,11,1,Tuesday,4,12
4500,DUBL,2016-06-07 05:00:00,251,46,Tuesday,5,297
4501,DUBL,2016-06-07 06:00:00,540,144,Tuesday,6,684
4502,DUBL,2016-06-07 07:00:00,1338,330,Tuesday,7,1668
4503,DUBL,2016-06-07 08:00:00,1964,297,Tuesday,8,2261
4504,DUBL,2016-06-07 09:00:00,1424,196,Tuesday,9,1620
4505,DUBL,2016-06-07 10:00:00,566,108,Tuesday,10,674
4506,DUBL,2016-06-07 11:00:00,248,133,Tuesday,11,381
4507,DUBL,2016-06-07 12:00:00,183,153,Tuesday,12,336
4508,DUBL,2016-06-07 13:00:00,152,184,Tuesday,13,336
4509,DUBL,2016-06-07 14:00:00,135,298,Tuesday,14,433
4510,DUBL,2016-06-07 15:00:00,167,416,Tuesday,15,583
4511,DUBL,2016-06-07 16:00:00,329,956,Tuesday,16,1285
4512,DUBL,2016-06-07 17:00:00,523,1675,Tuesday,17,2198
4513,DUBL,2016-06-07 18:00:00,552,1239,Tuesday,18,1791
4514,DUBL,2016-06-07 19:00:00,241,1070,Tuesday,19,1311
4515,DUBL,2016-06-07 20:00:00,108,329,Tuesday,20,437
4516,DUBL,2016-06-07 21:00:00,49,231,Tuesday,21,280
4517,DUBL,2016-06-07 22:00:00,66,200,Tuesday,22,266
4518,DUBL,2016-06-07 23:00:00,34,295,Tuesday,23,329
4519,DUBL,2016-06-08 00:00:00,23,272,Wednesday,0,295
4520,DUBL,2016-06-08 01:00:00,8,28,Wednesday,1,36
4521,DUBL,2016-06-08 05:00:00,252,37,Wednesday,5,289
4522,DUBL,2016-06-08 06:00:00,494,146,Wednesday,6,640
4523,DUBL,2016-06-08 07:00:00,1243,309,Wednesday,7,1552
4524,DUBL,2016-06-08 08:00:00,1884,286,Wednesday,8,2170
4525,DUBL,2016-06-08 09:00:00,1290,162,Wednesday,9,1452
4526,DUBL,2016-06-08 10:00:00,601,166,Wednesday,10,767
4527,DUBL,2016-06-08 11:00:00,269,121,Wednesday,11,390
4528,DUBL,2016-06-08 12:00:00,159,136,Wednesday,12,295
4529,DUBL,2016-06-08 13:00:00,152,169,Wednesday,13,321
4530,DUBL,2016-06-08 14:00:00,174,228,Wednesday,14,402
4531,DUBL,2016-06-08 15:00:00,202,433,Wednesday,15,635
4532,DUBL,2016-06-08 16:00:00,378,868,Wednesday,16,1246
4533,DUBL,2016-06-08 17:00:00,633,1795,Wednesday,17,2428
4534,DUBL,2016-06-08 18:00:00,652,1528,Wednesday,18,2180
4535,DUBL,2016-06-08 19:00:00,254,680,Wednesday,19,934
4536,DUBL,2016-06-08 20:00:00,99,316,Wednesday,20,415
4537,DUBL,2016-06-08 21:00:00,83,437,Wednesday,21,520
4538,DUBL,2016-06-08 22:00:00,82,232,Wednesday,22,314
4539,DUBL,2016-06-08 23:00:00,40,560,Wednesday,23,600
4540,DUBL,2016-06-09 00:00:00,10,56,Thursday,0,66
4541,DUBL,2016-06-09 01:00:00,10,23,Thursday,1,33
4542,DUBL,2016-06-09 04:00:00,15,1,Thursday,4,16
4543,DUBL,2016-06-09 05:00:00,256,38,Thursday,5,294
4544,DUBL,2016-06-09 06:00:00,510,142,Thursday,6,652
4545,DUBL,2016-06-09 07:00:00,1210,310,Thursday,7,1520
4546,DUBL,2016-06-09 08:00:00,1884,292,Thursday,8,2176
4547,DUBL,2016-06-09 09:00:00,1266,192,Thursday,9,1458
4548,DUBL,2016-06-09 10:00:00,529,132,Thursday,10,661
4549,DUBL,2016-06-09 11:00:00,281,113,Thursday,11,394
4550,DUBL,2016-06-09 12:00:00,153,183,Thursday,12,336
4551,DUBL,2016-06-09 13:00:00,137,187,Thursday,13,324
4552,DUBL,2016-06-09 14:00:00,138,247,Thursday,14,385
4553,DUBL,2016-06-09 15:00:00,161,416,Thursday,15,577
4554,DUBL,2016-06-09 16:00:00,247,905,Thursday,16,1152
4555,DUBL,2016-06-09 17:00:00,340,1579,Thursday,17,1919
4556,DUBL,2016-06-09 18:00:00,397,1504,Thursday,18,1901
4557,DUBL,2016-06-09 19:00:00,166,734,Thursday,19,900
4558,DUBL,2016-06-09 20:00:00,107,328,Thursday,20,435
4559,DUBL,2016-06-09 21:00:00,81,244,Thursday,21,325
4560,DUBL,2016-06-09 22:00:00,64,181,Thursday,22,245
4561,DUBL,2016-06-09 23:00:00,50,123,Thursday,23,173
4562,DUBL,2016-06-10 00:00:00,22,69,Friday,0,91
4563,DUBL,2016-06-10 01:00:00,9,16,Friday,1,25
4564,DUBL,2016-06-10 04:00:00,11,2,Friday,4,13
4565,DUBL,2016-06-10 05:00:00,213,36,Friday,5,249
4566,DUBL,2016-06-10 06:00:00,497,137,Friday,6,634
4567,DUBL,2016-06-10 07:00:00,942,300,Friday,7,1242
4568,DUBL,2016-06-10 08:00:00,1474,264,Friday,8,1738
4569,DUBL,2016-06-10 09:00:00,1143,163,Friday,9,1306
4570,DUBL,2016-06-10 10:00:00,439,150,Friday,10,589
4571,DUBL,2016-06-10 11:00:00,263,150,Friday,11,413
4572,DUBL,2016-06-10 12:00:00,204,181,Friday,12,385
4573,DUBL,2016-06-10 13:00:00,191,239,Friday,13,430
4574,DUBL,2016-06-10 14:00:00,180,310,Friday,14,490
4575,DUBL,2016-06-10 15:00:00,244,519,Friday,15,763
4576,DUBL,2016-06-10 16:00:00,344,979,Friday,16,1323
4577,DUBL,2016-06-10 17:00:00,691,1306,Friday,17,1997
4578,DUBL,2016-06-10 18:00:00,616,921,Friday,18,1537
4579,DUBL,2016-06-10 19:00:00,320,668,Friday,19,988
4580,DUBL,2016-06-10 20:00:00,114,256,Friday,20,370
4581,DUBL,2016-06-10 21:00:00,104,248,Friday,21,352
4582,DUBL,2016-06-10 22:00:00,91,351,Friday,22,442
4583,DUBL,2016-06-10 23:00:00,59,590,Friday,23,649
4584,DUBL,2016-06-11 00:00:00,31,125,Saturday,0,156
4585,DUBL,2016-06-11 01:00:00,7,52,Saturday,1,59
4586,DUBL,2016-06-11 06:00:00,32,19,Saturday,6,51
4587,DUBL,2016-06-11 07:00:00,84,74,Saturday,7,158
4588,DUBL,2016-06-11 08:00:00,115,78,Saturday,8,193
4589,DUBL,2016-06-11 09:00:00,236,111,Saturday,9,347
4590,DUBL,2016-06-11 10:00:00,304,135,Saturday,10,439
4591,DUBL,2016-06-11 11:00:00,389,143,Saturday,11,532
4592,DUBL,2016-06-11 12:00:00,355,161,Saturday,12,516
4593,DUBL,2016-06-11 13:00:00,415,157,Saturday,13,572
4594,DUBL,2016-06-11 14:00:00,480,114,Saturday,14,594
4595,DUBL,2016-06-11 15:00:00,363,198,Saturday,15,561
4596,DUBL,2016-06-11 16:00:00,228,243,Saturday,16,471
4597,DUBL,2016-06-11 17:00:00,199,198,Saturday,17,397
4598,DUBL,2016-06-11 18:00:00,186,242,Saturday,18,428
4599,DUBL,2016-06-11 19:00:00,134,331,Saturday,19,465
4600,DUBL,2016-06-11 20:00:00,105,268,Saturday,20,373
4601,DUBL,2016-06-11 21:00:00,88,262,Saturday,21,350
4602,DUBL,2016-06-11 22:00:00,93,688,Saturday,22,781
4603,DUBL,2016-06-11 23:00:00,64,171,Saturday,23,235
4604,DUBL,2016-06-12 00:00:00,19,116,Sunday,0,135
4605,DUBL,2016-06-12 01:00:00,4,47,Sunday,1,51
4606,DUBL,2016-06-12 08:00:00,53,61,Sunday,8,114
4607,DUBL,2016-06-12 09:00:00,138,112,Sunday,9,250
4608,DUBL,2016-06-12 10:00:00,194,117,Sunday,10,311
4609,DUBL,2016-06-12 11:00:00,297,135,Sunday,11,432
4610,DUBL,2016-06-12 12:00:00,247,113,Sunday,12,360
4611,DUBL,2016-06-12 13:00:00,281,133,Sunday,13,414
4612,DUBL,2016-06-12 14:00:00,368,87,Sunday,14,455
4613,DUBL,2016-06-12 15:00:00,354,133,Sunday,15,487
4614,DUBL,2016-06-12 16:00:00,344,142,Sunday,16,486
4615,DUBL,2016-06-12 17:00:00,207,225,Sunday,17,432
4616,DUBL,2016-06-12 18:00:00,179,239,Sunday,18,418
4617,DUBL,2016-06-12 19:00:00,192,208,Sunday,19,400
4618,DUBL,2016-06-12 20:00:00,113,204,Sunday,20,317
4619,DUBL,2016-06-12 21:00:00,94,396,Sunday,21,490
4620,DUBL,2016-06-12 22:00:00,74,536,Sunday,22,610
4621,DUBL,2016-06-12 23:00:00,26,185,Sunday,23,211
4622,DUBL,2016-06-13 00:00:00,16,78,Monday,0,94
4623,DUBL,2016-06-13 01:00:00,9,15,Monday,1,24
4624,DUBL,2016-06-13 05:00:00,251,26,Monday,5,277
4625,DUBL,2016-06-13 06:00:00,467,157,Monday,6,624
4626,DUBL,2016-06-13 07:00:00,1308,313,Monday,7,1621
4627,DUBL,2016-06-13 08:00:00,1933,300,Monday,8,2233
4628,DUBL,2016-06-13 09:00:00,1370,194,Monday,9,1564
4629,DUBL,2016-06-13 10:00:00,552,140,Monday,10,692
4630,DUBL,2016-06-13 11:00:00,303,106,Monday,11,409
4631,DUBL,2016-06-13 12:00:00,184,155,Monday,12,339
4632,DUBL,2016-06-13 13:00:00,161,157,Monday,13,318
4633,DUBL,2016-06-13 14:00:00,170,250,Monday,14,420
4634,DUBL,2016-06-13 15:00:00,232,386,Monday,15,618
4635,DUBL,2016-06-13 16:00:00,421,620,Monday,16,1041
4636,DUBL,2016-06-13 17:00:00,776,1992,Monday,17,2768
4637,DUBL,2016-06-13 18:00:00,796,1720,Monday,18,2516
4638,DUBL,2016-06-13 19:00:00,245,638,Monday,19,883
4639,DUBL,2016-06-13 20:00:00,126,265,Monday,20,391
4640,DUBL,2016-06-13 21:00:00,63,446,Monday,21,509
4641,DUBL,2016-06-13 22:00:00,84,445,Monday,22,529
4642,DUBL,2016-06-13 23:00:00,35,482,Monday,23,517
4643,DUBL,2016-06-14 00:00:00,15,289,Tuesday,0,304
4644,DUBL,2016-06-14 01:00:00,4,17,Tuesday,1,21
4645,DUBL,2016-06-14 04:00:00,16,2,Tuesday,4,18
4646,DUBL,2016-06-14 05:00:00,245,33,Tuesday,5,278
4647,DUBL,2016-06-14 06:00:00,569,145,Tuesday,6,714
4648,DUBL,2016-06-14 07:00:00,1306,319,Tuesday,7,1625
4649,DUBL,2016-06-14 08:00:00,1830,284,Tuesday,8,2114
4650,DUBL,2016-06-14 09:00:00,1461,197,Tuesday,9,1658
4651,DUBL,2016-06-14 10:00:00,489,128,Tuesday,10,617
4652,DUBL,2016-06-14 11:00:00,276,118,Tuesday,11,394
4653,DUBL,2016-06-14 12:00:00,218,126,Tuesday,12,344
4654,DUBL,2016-06-14 13:00:00,145,166,Tuesday,13,311
4655,DUBL,2016-06-14 14:00:00,192,215,Tuesday,14,407
4656,DUBL,2016-06-14 15:00:00,169,442,Tuesday,15,611
4657,DUBL,2016-06-14 16:00:00,291,862,Tuesday,16,1153
4658,DUBL,2016-06-14 17:00:00,557,1679,Tuesday,17,2236
4659,DUBL,2016-06-14 18:00:00,685,1407,Tuesday,18,2092
4660,DUBL,2016-06-14 19:00:00,269,1067,Tuesday,19,1336
4661,DUBL,2016-06-14 20:00:00,100,315,Tuesday,20,415
4662,DUBL,2016-06-14 21:00:00,75,267,Tuesday,21,342
4663,DUBL,2016-06-14 22:00:00,74,297,Tuesday,22,371
4664,DUBL,2016-06-14 23:00:00,35,383,Tuesday,23,418
4665,EMBR,2016-06-01 01:00:00,38,3,Wednesday,1,41
4666,EMBR,2016-06-01 04:00:00,10,146,Wednesday,4,156
4667,EMBR,2016-06-01 05:00:00,70,1611,Wednesday,5,1681
4668,EMBR,2016-06-01 06:00:00,191,3506,Wednesday,6,3697
4669,EMBR,2016-06-01 07:00:00,495,8358,Wednesday,7,8853
4670,EMBR,2016-06-01 08:00:00,837,13455,Wednesday,8,14292
4671,EMBR,2016-06-01 09:00:00,648,8542,Wednesday,9,9190
4672,EMBR,2016-06-01 10:00:00,424,3486,Wednesday,10,3910
4673,EMBR,2016-06-01 11:00:00,510,1482,Wednesday,11,1992
4674,EMBR,2016-06-01 12:00:00,768,1363,Wednesday,12,2131
4675,EMBR,2016-06-01 13:00:00,926,1031,Wednesday,13,1957
4676,EMBR,2016-06-01 14:00:00,1640,869,Wednesday,14,2509
4677,EMBR,2016-06-01 15:00:00,2572,973,Wednesday,15,3545
4678,EMBR,2016-06-01 16:00:00,4679,1048,Wednesday,16,5727
4679,EMBR,2016-06-01 17:00:00,9565,1522,Wednesday,17,11087
4680,EMBR,2016-06-01 18:00:00,10124,996,Wednesday,18,11120
4681,EMBR,2016-06-01 19:00:00,4467,506,Wednesday,19,4973
4682,EMBR,2016-06-01 20:00:00,2048,222,Wednesday,20,2270
4683,EMBR,2016-06-01 21:00:00,1382,236,Wednesday,21,1618
4684,EMBR,2016-06-01 22:00:00,844,192,Wednesday,22,1036
4685,EMBR,2016-06-01 23:00:00,571,76,Wednesday,23,647
4686,EMBR,2016-06-02 00:00:00,303,25,Thursday,0,328
4687,EMBR,2016-06-02 01:00:00,48,3,Thursday,1,51
4688,EMBR,2016-06-02 04:00:00,6,132,Thursday,4,138
4689,EMBR,2016-06-02 05:00:00,65,1543,Thursday,5,1608
4690,EMBR,2016-06-02 06:00:00,184,3517,Thursday,6,3701
4691,EMBR,2016-06-02 07:00:00,517,7941,Thursday,7,8458
4692,EMBR,2016-06-02 08:00:00,845,12454,Thursday,8,13299
4693,EMBR,2016-06-02 09:00:00,628,9186,Thursday,9,9814
4694,EMBR,2016-06-02 10:00:00,369,3353,Thursday,10,3722
4695,EMBR,2016-06-02 11:00:00,532,1764,Thursday,11,2296
4696,EMBR,2016-06-02 12:00:00,797,1172,Thursday,12,1969
4697,EMBR,2016-06-02 13:00:00,1037,1112,Thursday,13,2149
4698,EMBR,2016-06-02 14:00:00,1605,936,Thursday,14,2541
4699,EMBR,2016-06-02 15:00:00,2721,1000,Thursday,15,3721
4700,EMBR,2016-06-02 16:00:00,4827,1191,Thursday,16,6018
4701,EMBR,2016-06-02 17:00:00,10750,1788,Thursday,17,12538
4702,EMBR,2016-06-02 18:00:00,8372,1181,Thursday,18,9553
4703,EMBR,2016-06-02 19:00:00,4188,525,Thursday,19,4713
4704,EMBR,2016-06-02 20:00:00,2052,232,Thursday,20,2284
4705,EMBR,2016-06-02 21:00:00,1646,662,Thursday,21,2308
4706,EMBR,2016-06-02 22:00:00,1171,236,Thursday,22,1407
4707,EMBR,2016-06-02 23:00:00,734,91,Thursday,23,825
4708,EMBR,2016-06-03 00:00:00,343,25,Friday,0,368
4709,EMBR,2016-06-03 01:00:00,70,2,Friday,1,72
4710,EMBR,2016-06-03 04:00:00,9,113,Friday,4,122
4711,EMBR,2016-06-03 05:00:00,67,1404,Friday,5,1471
4712,EMBR,2016-06-03 06:00:00,187,3068,Friday,6,3255
4713,EMBR,2016-06-03 07:00:00,467,6838,Friday,7,7305
4714,EMBR,2016-06-03 08:00:00,734,11420,Friday,8,12154
4715,EMBR,2016-06-03 09:00:00,528,7478,Friday,9,8006
4716,EMBR,2016-06-03 10:00:00,410,3355,Friday,10,3765
4717,EMBR,2016-06-03 11:00:00,557,1703,Friday,11,2260
4718,EMBR,2016-06-03 12:00:00,905,1406,Friday,12,2311
4719,EMBR,2016-06-03 13:00:00,1471,1104,Friday,13,2575
4720,EMBR,2016-06-03 14:00:00,2161,1047,Friday,14,3208
4721,EMBR,2016-06-03 15:00:00,3011,1119,Friday,15,4130
4722,EMBR,2016-06-03 16:00:00,5363,1195,Friday,16,6558
4723,EMBR,2016-06-03 17:00:00,8256,1555,Friday,17,9811
4724,EMBR,2016-06-03 18:00:00,7384,959,Friday,18,8343
4725,EMBR,2016-06-03 19:00:00,3248,600,Friday,19,3848
4726,EMBR,2016-06-03 20:00:00,1678,323,Friday,20,2001
4727,EMBR,2016-06-03 21:00:00,1180,274,Friday,21,1454
4728,EMBR,2016-06-03 22:00:00,891,321,Friday,22,1212
4729,EMBR,2016-06-03 23:00:00,756,224,Friday,23,980
4730,EMBR,2016-06-04 00:00:00,475,78,Saturday,0,553
4731,EMBR,2016-06-04 01:00:00,74,16,Saturday,1,90
4732,EMBR,2016-06-04 06:00:00,26,318,Saturday,6,344
4733,EMBR,2016-06-04 07:00:00,92,612,Saturday,7,704
4734,EMBR,2016-06-04 08:00:00,144,884,Saturday,8,1028
4735,EMBR,2016-06-04 09:00:00,216,1101,Saturday,9,1317
4736,EMBR,2016-06-04 10:00:00,312,1372,Saturday,10,1684
4737,EMBR,2016-06-04 11:00:00,399,1433,Saturday,11,1832
4738,EMBR,2016-06-04 12:00:00,480,1290,Saturday,12,1770
4739,EMBR,2016-06-04 13:00:00,577,1075,Saturday,13,1652
4740,EMBR,2016-06-04 14:00:00,679,995,Saturday,14,1674
4741,EMBR,2016-06-04 15:00:00,911,860,Saturday,15,1771
4742,EMBR,2016-06-04 16:00:00,1098,816,Saturday,16,1914
4743,EMBR,2016-06-04 17:00:00,1323,651,Saturday,17,1974
4744,EMBR,2016-06-04 18:00:00,1119,542,Saturday,18,1661
4745,EMBR,2016-06-04 19:00:00,871,409,Saturday,19,1280
4746,EMBR,2016-06-04 20:00:00,822,262,Saturday,20,1084
4747,EMBR,2016-06-04 21:00:00,682,269,Saturday,21,951
4748,EMBR,2016-06-04 22:00:00,629,260,Saturday,22,889
4749,EMBR,2016-06-04 23:00:00,563,183,Saturday,23,746
4750,EMBR,2016-06-05 00:00:00,408,64,Sunday,0,472
4751,EMBR,2016-06-05 01:00:00,42,8,Sunday,1,50
4752,EMBR,2016-06-05 07:00:00,2,1,Sunday,7,3
4753,EMBR,2016-06-05 08:00:00,98,532,Sunday,8,630
4754,EMBR,2016-06-05 09:00:00,170,734,Sunday,9,904
4755,EMBR,2016-06-05 10:00:00,231,886,Sunday,10,1117
4756,EMBR,2016-06-05 11:00:00,301,992,Sunday,11,1293
4757,EMBR,2016-06-05 12:00:00,370,914,Sunday,12,1284
4758,EMBR,2016-06-05 13:00:00,411,847,Sunday,13,1258
4759,EMBR,2016-06-05 14:00:00,521,815,Sunday,14,1336
4760,EMBR,2016-06-05 15:00:00,722,686,Sunday,15,1408
4761,EMBR,2016-06-05 16:00:00,899,499,Sunday,16,1398
4762,EMBR,2016-06-05 17:00:00,930,396,Sunday,17,1326
4763,EMBR,2016-06-05 18:00:00,869,333,Sunday,18,1202
4764,EMBR,2016-06-05 19:00:00,636,264,Sunday,19,900
4765,EMBR,2016-06-05 20:00:00,585,568,Sunday,20,1153
4766,EMBR,2016-06-05 21:00:00,409,285,Sunday,21,694
4767,EMBR,2016-06-05 22:00:00,399,150,Sunday,22,549
4768,EMBR,2016-06-05 23:00:00,324,79,Sunday,23,403
4769,EMBR,2016-06-06 00:00:00,149,24,Monday,0,173
4770,EMBR,2016-06-06 01:00:00,17,2,Monday,1,19
4771,EMBR,2016-06-06 04:00:00,1,292,Monday,4,293
4772,EMBR,2016-06-06 05:00:00,56,1287,Monday,5,1343
4773,EMBR,2016-06-06 06:00:00,197,3445,Monday,6,3642
4774,EMBR,2016-06-06 07:00:00,458,7974,Monday,7,8432
4775,EMBR,2016-06-06 08:00:00,829,13563,Monday,8,14392
4776,EMBR,2016-06-06 09:00:00,566,8859,Monday,9,9425
4777,EMBR,2016-06-06 10:00:00,387,3159,Monday,10,3546
4778,EMBR,2016-06-06 11:00:00,454,1721,Monday,11,2175
4779,EMBR,2016-06-06 12:00:00,670,1222,Monday,12,1892
4780,EMBR,2016-06-06 13:00:00,879,1012,Monday,13,1891
4781,EMBR,2016-06-06 14:00:00,1481,948,Monday,14,2429
4782,EMBR,2016-06-06 15:00:00,2357,952,Monday,15,3309
4783,EMBR,2016-06-06 16:00:00,5185,1119,Monday,16,6304
4784,EMBR,2016-06-06 17:00:00,9666,1546,Monday,17,11212
4785,EMBR,2016-06-06 18:00:00,9613,1048,Monday,18,10661
4786,EMBR,2016-06-06 19:00:00,4367,442,Monday,19,4809
4787,EMBR,2016-06-06 20:00:00,2032,194,Monday,20,2226
4788,EMBR,2016-06-06 21:00:00,1351,166,Monday,21,1517
4789,EMBR,2016-06-06 22:00:00,909,155,Monday,22,1064
4790,EMBR,2016-06-06 23:00:00,573,77,Monday,23,650
4791,EMBR,2016-06-07 00:00:00,295,24,Tuesday,0,319
4792,EMBR,2016-06-07 01:00:00,37,5,Tuesday,1,42
4793,EMBR,2016-06-07 04:00:00,7,236,Tuesday,4,243
4794,EMBR,2016-06-07 05:00:00,78,1394,Tuesday,5,1472
4795,EMBR,2016-06-07 06:00:00,200,3452,Tuesday,6,3652
4796,EMBR,2016-06-07 07:00:00,507,7773,Tuesday,7,8280
4797,EMBR,2016-06-07 08:00:00,899,13707,Tuesday,8,14606
4798,EMBR,2016-06-07 09:00:00,604,9089,Tuesday,9,9693
4799,EMBR,2016-06-07 10:00:00,401,3420,Tuesday,10,3821
4800,EMBR,2016-06-07 11:00:00,471,1668,Tuesday,11,2139
4801,EMBR,2016-06-07 12:00:00,724,1333,Tuesday,12,2057
4802,EMBR,2016-06-07 13:00:00,921,1117,Tuesday,13,2038
4803,EMBR,2016-06-07 14:00:00,1623,983,Tuesday,14,2606
4804,EMBR,2016-06-07 15:00:00,2521,1182,Tuesday,15,3703
4805,EMBR,2016-06-07 16:00:00,5319,1483,Tuesday,16,6802
4806,EMBR,2016-06-07 17:00:00,9773,2399,Tuesday,17,12172
4807,EMBR,2016-06-07 18:00:00,9093,2085,Tuesday,18,11178
4808,EMBR,2016-06-07 19:00:00,4572,676,Tuesday,19,5248
4809,EMBR,2016-06-07 20:00:00,2039,283,Tuesday,20,2322
4810,EMBR,2016-06-07 21:00:00,1474,219,Tuesday,21,1693
4811,EMBR,2016-06-07 22:00:00,1582,203,Tuesday,22,1785
4812,EMBR,2016-06-07 23:00:00,2003,71,Tuesday,23,2074
4813,EMBR,2016-06-08 00:00:00,628,21,Wednesday,0,649
4814,EMBR,2016-06-08 01:00:00,80,7,Wednesday,1,87
4815,EMBR,2016-06-08 04:00:00,5,284,Wednesday,4,289
4816,EMBR,2016-06-08 05:00:00,59,1390,Wednesday,5,1449
4817,EMBR,2016-06-08 06:00:00,195,3423,Wednesday,6,3618
4818,EMBR,2016-06-08 07:00:00,523,8358,Wednesday,7,8881
4819,EMBR,2016-06-08 08:00:00,807,12525,Wednesday,8,13332
4820,EMBR,2016-06-08 09:00:00,630,9151,Wednesday,9,9781
4821,EMBR,2016-06-08 10:00:00,414,3401,Wednesday,10,3815
4822,EMBR,2016-06-08 11:00:00,499,1635,Wednesday,11,2134
4823,EMBR,2016-06-08 12:00:00,748,1272,Wednesday,12,2020
4824,EMBR,2016-06-08 13:00:00,996,1181,Wednesday,13,2177
4825,EMBR,2016-06-08 14:00:00,1598,1020,Wednesday,14,2618
4826,EMBR,2016-06-08 15:00:00,2524,1120,Wednesday,15,3644
4827,EMBR,2016-06-08 16:00:00,5129,1516,Wednesday,16,6645
4828,EMBR,2016-06-08 17:00:00,10139,2510,Wednesday,17,12649
4829,EMBR,2016-06-08 18:00:00,9492,1972,Wednesday,18,11464
4830,EMBR,2016-06-08 19:00:00,3825,688,Wednesday,19,4513
4831,EMBR,2016-06-08 20:00:00,1894,290,Wednesday,20,2184
4832,EMBR,2016-06-08 21:00:00,1565,325,Wednesday,21,1890
4833,EMBR,2016-06-08 22:00:00,1634,206,Wednesday,22,1840
4834,EMBR,2016-06-08 23:00:00,2011,125,Wednesday,23,2136
4835,EMBR,2016-06-09 00:00:00,489,37,Thursday,0,526
4836,EMBR,2016-06-09 01:00:00,69,5,Thursday,1,74
4837,EMBR,2016-06-09 04:00:00,11,132,Thursday,4,143
4838,EMBR,2016-06-09 05:00:00,57,1469,Thursday,5,1526
4839,EMBR,2016-06-09 06:00:00,187,3308,Thursday,6,3495
4840,EMBR,2016-06-09 07:00:00,484,7472,Thursday,7,7956
4841,EMBR,2016-06-09 08:00:00,812,13043,Thursday,8,13855
4842,EMBR,2016-06-09 09:00:00,618,8621,Thursday,9,9239
4843,EMBR,2016-06-09 10:00:00,400,3537,Thursday,10,3937
4844,EMBR,2016-06-09 11:00:00,563,1607,Thursday,11,2170
4845,EMBR,2016-06-09 12:00:00,794,1427,Thursday,12,2221
4846,EMBR,2016-06-09 13:00:00,1063,1119,Thursday,13,2182
4847,EMBR,2016-06-09 14:00:00,1640,1079,Thursday,14,2719
4848,EMBR,2016-06-09 15:00:00,2577,1009,Thursday,15,3586
4849,EMBR,2016-06-09 16:00:00,5093,1135,Thursday,16,6228
4850,EMBR,2016-06-09 17:00:00,9436,1676,Thursday,17,11112
4851,EMBR,2016-06-09 18:00:00,8835,1195,Thursday,18,10030
4852,EMBR,2016-06-09 19:00:00,4450,509,Thursday,19,4959
4853,EMBR,2016-06-09 20:00:00,2102,338,Thursday,20,2440
4854,EMBR,2016-06-09 21:00:00,1683,262,Thursday,21,1945
4855,EMBR,2016-06-09 22:00:00,1134,235,Thursday,22,1369
4856,EMBR,2016-06-09 23:00:00,794,138,Thursday,23,932
4857,EMBR,2016-06-10 00:00:00,388,34,Friday,0,422
4858,EMBR,2016-06-10 01:00:00,49,9,Friday,1,58
4859,EMBR,2016-06-10 04:00:00,3,120,Friday,4,123
4860,EMBR,2016-06-10 05:00:00,54,1296,Friday,5,1350
4861,EMBR,2016-06-10 06:00:00,193,3030,Friday,6,3223
4862,EMBR,2016-06-10 07:00:00,462,6580,Friday,7,7042
4863,EMBR,2016-06-10 08:00:00,694,11083,Friday,8,11777
4864,EMBR,2016-06-10 09:00:00,601,7129,Friday,9,7730
4865,EMBR,2016-06-10 10:00:00,462,3553,Friday,10,4015
4866,EMBR,2016-06-10 11:00:00,612,1919,Friday,11,2531
4867,EMBR,2016-06-10 12:00:00,865,1632,Friday,12,2497
4868,EMBR,2016-06-10 13:00:00,1309,1377,Friday,13,2686
4869,EMBR,2016-06-10 14:00:00,2093,1152,Friday,14,3245
4870,EMBR,2016-06-10 15:00:00,3110,1304,Friday,15,4414
4871,EMBR,2016-06-10 16:00:00,5409,1757,Friday,16,7166
4872,EMBR,2016-06-10 17:00:00,8942,2358,Friday,17,11300
4873,EMBR,2016-06-10 18:00:00,6930,1949,Friday,18,8879
4874,EMBR,2016-06-10 19:00:00,2648,823,Friday,19,3471
4875,EMBR,2016-06-10 20:00:00,1327,311,Friday,20,1638
4876,EMBR,2016-06-10 21:00:00,1241,303,Friday,21,1544
4877,EMBR,2016-06-10 22:00:00,1653,347,Friday,22,2000
4878,EMBR,2016-06-10 23:00:00,2052,159,Friday,23,2211
4879,EMBR,2016-06-11 00:00:00,656,82,Saturday,0,738
4880,EMBR,2016-06-11 01:00:00,81,5,Saturday,1,86
4881,EMBR,2016-06-11 06:00:00,48,245,Saturday,6,293
4882,EMBR,2016-06-11 07:00:00,79,718,Saturday,7,797
4883,EMBR,2016-06-11 08:00:00,160,1010,Saturday,8,1170
4884,EMBR,2016-06-11 09:00:00,175,1196,Saturday,9,1371
4885,EMBR,2016-06-11 10:00:00,248,1630,Saturday,10,1878
4886,EMBR,2016-06-11 11:00:00,396,1803,Saturday,11,2199
4887,EMBR,2016-06-11 12:00:00,512,1723,Saturday,12,2235
4888,EMBR,2016-06-11 13:00:00,630,1803,Saturday,13,2433
4889,EMBR,2016-06-11 14:00:00,638,2151,Saturday,14,2789
4890,EMBR,2016-06-11 15:00:00,863,1765,Saturday,15,2628
4891,EMBR,2016-06-11 16:00:00,1172,1103,Saturday,16,2275
4892,EMBR,2016-06-11 17:00:00,1244,879,Saturday,17,2123
4893,EMBR,2016-06-11 18:00:00,1314,616,Saturday,18,1930
4894,EMBR,2016-06-11 19:00:00,1444,394,Saturday,19,1838
4895,EMBR,2016-06-11 20:00:00,1250,277,Saturday,20,1527
4896,EMBR,2016-06-11 21:00:00,1717,312,Saturday,21,2029
4897,EMBR,2016-06-11 22:00:00,1793,240,Saturday,22,2033
4898,EMBR,2016-06-11 23:00:00,846,174,Saturday,23,1020
4899,EMBR,2016-06-12 00:00:00,501,64,Sunday,0,565
4900,EMBR,2016-06-12 01:00:00,56,11,Sunday,1,67
4901,EMBR,2016-06-12 07:00:00,2,2,Sunday,7,4
4902,EMBR,2016-06-12 08:00:00,111,586,Sunday,8,697
4903,EMBR,2016-06-12 09:00:00,169,689,Sunday,9,858
4904,EMBR,2016-06-12 10:00:00,189,964,Sunday,10,1153
4905,EMBR,2016-06-12 11:00:00,258,1167,Sunday,11,1425
4906,EMBR,2016-06-12 12:00:00,321,1274,Sunday,12,1595
4907,EMBR,2016-06-12 13:00:00,384,1221,Sunday,13,1605
4908,EMBR,2016-06-12 14:00:00,461,1295,Sunday,14,1756
4909,EMBR,2016-06-12 15:00:00,625,1487,Sunday,15,2112
4910,EMBR,2016-06-12 16:00:00,864,1591,Sunday,16,2455
4911,EMBR,2016-06-12 17:00:00,962,920,Sunday,17,1882
4912,EMBR,2016-06-12 18:00:00,980,561,Sunday,18,1541
4913,EMBR,2016-06-12 19:00:00,729,364,Sunday,19,1093
4914,EMBR,2016-06-12 20:00:00,899,264,Sunday,20,1163
4915,EMBR,2016-06-12 21:00:00,1684,228,Sunday,21,1912
4916,EMBR,2016-06-12 22:00:00,1596,165,Sunday,22,1761
4917,EMBR,2016-06-12 23:00:00,439,75,Sunday,23,514
4918,EMBR,2016-06-13 00:00:00,232,73,Monday,0,305
4919,EMBR,2016-06-13 01:00:00,36,2,Monday,1,38
4920,EMBR,2016-06-13 04:00:00,7,225,Monday,4,232
4921,EMBR,2016-06-13 05:00:00,52,1377,Monday,5,1429
4922,EMBR,2016-06-13 06:00:00,182,3251,Monday,6,3433
4923,EMBR,2016-06-13 07:00:00,464,8180,Monday,7,8644
4924,EMBR,2016-06-13 08:00:00,894,13288,Monday,8,14182
4925,EMBR,2016-06-13 09:00:00,607,8568,Monday,9,9175
4926,EMBR,2016-06-13 10:00:00,379,3310,Monday,10,3689
4927,EMBR,2016-06-13 11:00:00,468,1519,Monday,11,1987
4928,EMBR,2016-06-13 12:00:00,678,1275,Monday,12,1953
4929,EMBR,2016-06-13 13:00:00,830,1075,Monday,13,1905
4930,EMBR,2016-06-13 14:00:00,1449,1071,Monday,14,2520
4931,EMBR,2016-06-13 15:00:00,2564,1101,Monday,15,3665
4932,EMBR,2016-06-13 16:00:00,5573,1440,Monday,16,7013
4933,EMBR,2016-06-13 17:00:00,10881,2362,Monday,17,13243
4934,EMBR,2016-06-13 18:00:00,9711,1754,Monday,18,11465
4935,EMBR,2016-06-13 19:00:00,3807,635,Monday,19,4442
4936,EMBR,2016-06-13 20:00:00,1540,210,Monday,20,1750
4937,EMBR,2016-06-13 21:00:00,1442,742,Monday,21,2184
4938,EMBR,2016-06-13 22:00:00,1337,299,Monday,22,1636
4939,EMBR,2016-06-13 23:00:00,1664,100,Monday,23,1764
4940,EMBR,2016-06-14 00:00:00,786,15,Tuesday,0,801
4941,EMBR,2016-06-14 01:00:00,47,4,Tuesday,1,51
4942,EMBR,2016-06-14 04:00:00,5,253,Tuesday,4,258
4943,EMBR,2016-06-14 05:00:00,70,1419,Tuesday,5,1489
4944,EMBR,2016-06-14 06:00:00,187,3484,Tuesday,6,3671
4945,EMBR,2016-06-14 07:00:00,536,7879,Tuesday,7,8415
4946,EMBR,2016-06-14 08:00:00,962,13089,Tuesday,8,14051
4947,EMBR,2016-06-14 09:00:00,583,9306,Tuesday,9,9889
4948,EMBR,2016-06-14 10:00:00,409,3360,Tuesday,10,3769
4949,EMBR,2016-06-14 11:00:00,486,1698,Tuesday,11,2184
4950,EMBR,2016-06-14 12:00:00,702,1289,Tuesday,12,1991
4951,EMBR,2016-06-14 13:00:00,965,1137,Tuesday,13,2102
4952,EMBR,2016-06-14 14:00:00,1492,1046,Tuesday,14,2538
4953,EMBR,2016-06-14 15:00:00,2614,1125,Tuesday,15,3739
4954,EMBR,2016-06-14 16:00:00,4913,1524,Tuesday,16,6437
4955,EMBR,2016-06-14 17:00:00,10064,2369,Tuesday,17,12433
4956,EMBR,2016-06-14 18:00:00,9262,2099,Tuesday,18,11361
4957,EMBR,2016-06-14 19:00:00,4710,733,Tuesday,19,5443
4958,EMBR,2016-06-14 20:00:00,2106,324,Tuesday,20,2430
4959,EMBR,2016-06-14 21:00:00,1327,201,Tuesday,21,1528
4960,EMBR,2016-06-14 22:00:00,1475,217,Tuesday,22,1692
4961,EMBR,2016-06-14 23:00:00,1883,103,Tuesday,23,1986
4962,FRMT,2016-06-01 01:00:00,4,6,Wednesday,1,10
4963,FRMT,2016-06-01 03:00:00,1,1,Wednesday,3,2
4964,FRMT,2016-06-01 04:00:00,4,1,Wednesday,4,5
4965,FRMT,2016-06-01 05:00:00,125,74,Wednesday,5,199
4966,FRMT,2016-06-01 06:00:00,388,210,Wednesday,6,598
4967,FRMT,2016-06-01 07:00:00,1015,449,Wednesday,7,1464
4968,FRMT,2016-06-01 08:00:00,1974,413,Wednesday,8,2387
4969,FRMT,2016-06-01 09:00:00,2017,226,Wednesday,9,2243
4970,FRMT,2016-06-01 10:00:00,858,163,Wednesday,10,1021
4971,FRMT,2016-06-01 11:00:00,351,139,Wednesday,11,490
4972,FRMT,2016-06-01 12:00:00,241,161,Wednesday,12,402
4973,FRMT,2016-06-01 13:00:00,259,198,Wednesday,13,457
4974,FRMT,2016-06-01 14:00:00,191,230,Wednesday,14,421
4975,FRMT,2016-06-01 15:00:00,199,393,Wednesday,15,592
4976,FRMT,2016-06-01 16:00:00,288,730,Wednesday,16,1018
4977,FRMT,2016-06-01 17:00:00,467,1603,Wednesday,17,2070
4978,FRMT,2016-06-01 18:00:00,432,2081,Wednesday,18,2513
4979,FRMT,2016-06-01 19:00:00,286,1189,Wednesday,19,1475
4980,FRMT,2016-06-01 20:00:00,156,343,Wednesday,20,499
4981,FRMT,2016-06-01 21:00:00,119,182,Wednesday,21,301
4982,FRMT,2016-06-01 22:00:00,75,273,Wednesday,22,348
4983,FRMT,2016-06-01 23:00:00,59,107,Wednesday,23,166
4984,FRMT,2016-06-02 00:00:00,14,79,Thursday,0,93
4985,FRMT,2016-06-02 01:00:00,2,14,Thursday,1,16
4986,FRMT,2016-06-02 05:00:00,114,88,Thursday,5,202
4987,FRMT,2016-06-02 06:00:00,348,213,Thursday,6,561
4988,FRMT,2016-06-02 07:00:00,1108,465,Thursday,7,1573
4989,FRMT,2016-06-02 08:00:00,1784,433,Thursday,8,2217
4990,FRMT,2016-06-02 09:00:00,1938,260,Thursday,9,2198
4991,FRMT,2016-06-02 10:00:00,829,168,Thursday,10,997
4992,FRMT,2016-06-02 11:00:00,343,162,Thursday,11,505
4993,FRMT,2016-06-02 12:00:00,280,181,Thursday,12,461
4994,FRMT,2016-06-02 13:00:00,214,191,Thursday,13,405
4995,FRMT,2016-06-02 14:00:00,194,207,Thursday,14,401
4996,FRMT,2016-06-02 15:00:00,279,351,Thursday,15,630
4997,FRMT,2016-06-02 16:00:00,493,804,Thursday,16,1297
4998,FRMT,2016-06-02 17:00:00,673,1669,Thursday,17,2342
4999,FRMT,2016-06-02 18:00:00,405,952,Thursday,18,1357
5000,FRMT,2016-06-02 19:00:00,280,2022,Thursday,19,2302
5001,FRMT,2016-06-02 20:00:00,191,272,Thursday,20,463
5002,FRMT,2016-06-02 21:00:00,106,714,Thursday,21,820
5003,FRMT,2016-06-02 22:00:00,113,356,Thursday,22,469
5004,FRMT,2016-06-02 23:00:00,169,148,Thursday,23,317
5005,FRMT,2016-06-03 00:00:00,23,61,Friday,0,84
5006,FRMT,2016-06-03 01:00:00,3,51,Friday,1,54
5007,FRMT,2016-06-03 05:00:00,99,76,Friday,5,175
5008,FRMT,2016-06-03 06:00:00,313,196,Friday,6,509
5009,FRMT,2016-06-03 07:00:00,888,392,Friday,7,1280
5010,FRMT,2016-06-03 08:00:00,1674,402,Friday,8,2076
5011,FRMT,2016-06-03 09:00:00,1629,238,Friday,9,1867
5012,FRMT,2016-06-03 10:00:00,719,181,Friday,10,900
5013,FRMT,2016-06-03 11:00:00,328,199,Friday,11,527
5014,FRMT,2016-06-03 12:00:00,245,190,Friday,12,435
5015,FRMT,2016-06-03 13:00:00,209,246,Friday,13,455
5016,FRMT,2016-06-03 14:00:00,237,355,Friday,14,592
5017,FRMT,2016-06-03 15:00:00,225,537,Friday,15,762
5018,FRMT,2016-06-03 16:00:00,368,1042,Friday,16,1410
5019,FRMT,2016-06-03 17:00:00,492,1487,Friday,17,1979
5020,FRMT,2016-06-03 18:00:00,437,1638,Friday,18,2075
5021,FRMT,2016-06-03 19:00:00,346,831,Friday,19,1177
5022,FRMT,2016-06-03 20:00:00,174,319,Friday,20,493
5023,FRMT,2016-06-03 21:00:00,151,262,Friday,21,413
5024,FRMT,2016-06-03 22:00:00,224,281,Friday,22,505
5025,FRMT,2016-06-03 23:00:00,192,157,Friday,23,349
5026,FRMT,2016-06-04 00:00:00,71,148,Saturday,0,219
5027,FRMT,2016-06-04 01:00:00,11,58,Saturday,1,69
5028,FRMT,2016-06-04 06:00:00,47,2,Saturday,6,49
5029,FRMT,2016-06-04 07:00:00,70,127,Saturday,7,197
5030,FRMT,2016-06-04 08:00:00,152,88,Saturday,8,240
5031,FRMT,2016-06-04 09:00:00,240,134,Saturday,9,374
5032,FRMT,2016-06-04 10:00:00,272,142,Saturday,10,414
5033,FRMT,2016-06-04 11:00:00,289,232,Saturday,11,521
5034,FRMT,2016-06-04 12:00:00,288,145,Saturday,12,433
5035,FRMT,2016-06-04 13:00:00,235,200,Saturday,13,435
5036,FRMT,2016-06-04 14:00:00,196,211,Saturday,14,407
5037,FRMT,2016-06-04 15:00:00,217,178,Saturday,15,395
5038,FRMT,2016-06-04 16:00:00,203,236,Saturday,16,439
5039,FRMT,2016-06-04 17:00:00,194,272,Saturday,17,466
5040,FRMT,2016-06-04 18:00:00,172,240,Saturday,18,412
5041,FRMT,2016-06-04 19:00:00,137,212,Saturday,19,349
5042,FRMT,2016-06-04 20:00:00,120,177,Saturday,20,297
5043,FRMT,2016-06-04 21:00:00,113,187,Saturday,21,300
5044,FRMT,2016-06-04 22:00:00,93,193,Saturday,22,286
5045,FRMT,2016-06-04 23:00:00,80,168,Saturday,23,248
5046,FRMT,2016-06-05 00:00:00,31,92,Sunday,0,123
5047,FRMT,2016-06-05 01:00:00,6,18,Sunday,1,24
5048,FRMT,2016-06-05 08:00:00,106,47,Sunday,8,153
5049,FRMT,2016-06-05 09:00:00,159,125,Sunday,9,284
5050,FRMT,2016-06-05 10:00:00,248,90,Sunday,10,338
5051,FRMT,2016-06-05 11:00:00,268,97,Sunday,11,365
5052,FRMT,2016-06-05 12:00:00,230,125,Sunday,12,355
5053,FRMT,2016-06-05 13:00:00,207,119,Sunday,13,326
5054,FRMT,2016-06-05 14:00:00,250,160,Sunday,14,410
5055,FRMT,2016-06-05 15:00:00,315,165,Sunday,15,480
5056,FRMT,2016-06-05 16:00:00,347,158,Sunday,16,505
5057,FRMT,2016-06-05 17:00:00,140,223,Sunday,17,363
5058,FRMT,2016-06-05 18:00:00,119,223,Sunday,18,342
5059,FRMT,2016-06-05 19:00:00,101,212,Sunday,19,313
5060,FRMT,2016-06-05 20:00:00,86,587,Sunday,20,673
5061,FRMT,2016-06-05 21:00:00,139,142,Sunday,21,281
5062,FRMT,2016-06-05 22:00:00,89,167,Sunday,22,256
5063,FRMT,2016-06-05 23:00:00,45,78,Sunday,23,123
5064,FRMT,2016-06-06 00:00:00,17,51,Monday,0,68
5065,FRMT,2016-06-06 01:00:00,5,5,Monday,1,10
5066,FRMT,2016-06-06 05:00:00,100,103,Monday,5,203
5067,FRMT,2016-06-06 06:00:00,346,187,Monday,6,533
5068,FRMT,2016-06-06 07:00:00,1077,434,Monday,7,1511
5069,FRMT,2016-06-06 08:00:00,1927,401,Monday,8,2328
5070,FRMT,2016-06-06 09:00:00,2114,236,Monday,9,2350
5071,FRMT,2016-06-06 10:00:00,856,184,Monday,10,1040
5072,FRMT,2016-06-06 11:00:00,339,171,Monday,11,510
5073,FRMT,2016-06-06 12:00:00,218,164,Monday,12,382
5074,FRMT,2016-06-06 13:00:00,183,222,Monday,13,405
5075,FRMT,2016-06-06 14:00:00,156,239,Monday,14,395
5076,FRMT,2016-06-06 15:00:00,199,368,Monday,15,567
5077,FRMT,2016-06-06 16:00:00,304,906,Monday,16,1210
5078,FRMT,2016-06-06 17:00:00,486,1699,Monday,17,2185
5079,FRMT,2016-06-06 18:00:00,441,2283,Monday,18,2724
5080,FRMT,2016-06-06 19:00:00,246,1047,Monday,19,1293
5081,FRMT,2016-06-06 20:00:00,172,458,Monday,20,630
5082,FRMT,2016-06-06 21:00:00,121,275,Monday,21,396
5083,FRMT,2016-06-06 22:00:00,201,135,Monday,22,336
5084,FRMT,2016-06-06 23:00:00,233,126,Monday,23,359
5085,FRMT,2016-06-07 00:00:00,62,37,Tuesday,0,99
5086,FRMT,2016-06-07 01:00:00,4,20,Tuesday,1,24
5087,FRMT,2016-06-07 04:00:00,10,1,Tuesday,4,11
5088,FRMT,2016-06-07 05:00:00,125,104,Tuesday,5,229
5089,FRMT,2016-06-07 06:00:00,352,191,Tuesday,6,543
5090,FRMT,2016-06-07 07:00:00,966,456,Tuesday,7,1422
5091,FRMT,2016-06-07 08:00:00,2167,434,Tuesday,8,2601
5092,FRMT,2016-06-07 09:00:00,2003,242,Tuesday,9,2245
5093,FRMT,2016-06-07 10:00:00,908,153,Tuesday,10,1061
5094,FRMT,2016-06-07 11:00:00,291,185,Tuesday,11,476
5095,FRMT,2016-06-07 12:00:00,225,159,Tuesday,12,384
5096,FRMT,2016-06-07 13:00:00,202,190,Tuesday,13,392
5097,FRMT,2016-06-07 14:00:00,212,221,Tuesday,14,433
5098,FRMT,2016-06-07 15:00:00,213,347,Tuesday,15,560
5099,FRMT,2016-06-07 16:00:00,300,795,Tuesday,16,1095
5100,FRMT,2016-06-07 17:00:00,524,1780,Tuesday,17,2304
5101,FRMT,2016-06-07 18:00:00,475,2072,Tuesday,18,2547
5102,FRMT,2016-06-07 19:00:00,274,1190,Tuesday,19,1464
5103,FRMT,2016-06-07 20:00:00,182,353,Tuesday,20,535
5104,FRMT,2016-06-07 21:00:00,127,276,Tuesday,21,403
5105,FRMT,2016-06-07 22:00:00,80,240,Tuesday,22,320
5106,FRMT,2016-06-07 23:00:00,39,169,Tuesday,23,208
5107,FRMT,2016-06-08 00:00:00,33,124,Wednesday,0,157
5108,FRMT,2016-06-08 01:00:00,7,62,Wednesday,1,69
5109,FRMT,2016-06-08 05:00:00,103,101,Wednesday,5,204
5110,FRMT,2016-06-08 06:00:00,354,177,Wednesday,6,531
5111,FRMT,2016-06-08 07:00:00,1010,447,Wednesday,7,1457
5112,FRMT,2016-06-08 08:00:00,1609,406,Wednesday,8,2015
5113,FRMT,2016-06-08 09:00:00,2273,205,Wednesday,9,2478
5114,FRMT,2016-06-08 10:00:00,942,179,Wednesday,10,1121
5115,FRMT,2016-06-08 11:00:00,349,170,Wednesday,11,519
5116,FRMT,2016-06-08 12:00:00,213,184,Wednesday,12,397
5117,FRMT,2016-06-08 13:00:00,188,220,Wednesday,13,408
5118,FRMT,2016-06-08 14:00:00,198,246,Wednesday,14,444
5119,FRMT,2016-06-08 15:00:00,226,315,Wednesday,15,541
5120,FRMT,2016-06-08 16:00:00,381,687,Wednesday,16,1068
5121,FRMT,2016-06-08 17:00:00,685,1711,Wednesday,17,2396
5122,FRMT,2016-06-08 18:00:00,610,2119,Wednesday,18,2729
5123,FRMT,2016-06-08 19:00:00,313,1060,Wednesday,19,1373
5124,FRMT,2016-06-08 20:00:00,174,466,Wednesday,20,640
5125,FRMT,2016-06-08 21:00:00,117,464,Wednesday,21,581
5126,FRMT,2016-06-08 22:00:00,88,265,Wednesday,22,353
5127,FRMT,2016-06-08 23:00:00,48,116,Wednesday,23,164
5128,FRMT,2016-06-09 00:00:00,21,185,Thursday,0,206
5129,FRMT,2016-06-09 01:00:00,2,34,Thursday,1,36
5130,FRMT,2016-06-09 04:00:00,9,1,Thursday,4,10
5131,FRMT,2016-06-09 05:00:00,112,88,Thursday,5,200
5132,FRMT,2016-06-09 06:00:00,346,197,Thursday,6,543
5133,FRMT,2016-06-09 07:00:00,859,374,Thursday,7,1233
5134,FRMT,2016-06-09 08:00:00,2130,405,Thursday,8,2535
5135,FRMT,2016-06-09 09:00:00,1875,244,Thursday,9,2119
5136,FRMT,2016-06-09 10:00:00,898,156,Thursday,10,1054
5137,FRMT,2016-06-09 11:00:00,361,176,Thursday,11,537
5138,FRMT,2016-06-09 12:00:00,271,166,Thursday,12,437
5139,FRMT,2016-06-09 13:00:00,237,196,Thursday,13,433
5140,FRMT,2016-06-09 14:00:00,177,276,Thursday,14,453
5141,FRMT,2016-06-09 15:00:00,222,363,Thursday,15,585
5142,FRMT,2016-06-09 16:00:00,303,655,Thursday,16,958
5143,FRMT,2016-06-09 17:00:00,454,1805,Thursday,17,2259
5144,FRMT,2016-06-09 18:00:00,448,1907,Thursday,18,2355
5145,FRMT,2016-06-09 19:00:00,298,1096,Thursday,19,1394
5146,FRMT,2016-06-09 20:00:00,160,371,Thursday,20,531
5147,FRMT,2016-06-09 21:00:00,128,285,Thursday,21,413
5148,FRMT,2016-06-09 22:00:00,88,262,Thursday,22,350
5149,FRMT,2016-06-09 23:00:00,64,158,Thursday,23,222
5150,FRMT,2016-06-10 00:00:00,23,77,Friday,0,100
5151,FRMT,2016-06-10 01:00:00,7,18,Friday,1,25
5152,FRMT,2016-06-10 05:00:00,94,80,Friday,5,174
5153,FRMT,2016-06-10 06:00:00,285,190,Friday,6,475
5154,FRMT,2016-06-10 07:00:00,847,382,Friday,7,1229
5155,FRMT,2016-06-10 08:00:00,1602,366,Friday,8,1968
5156,FRMT,2016-06-10 09:00:00,1553,247,Friday,9,1800
5157,FRMT,2016-06-10 10:00:00,800,194,Friday,10,994
5158,FRMT,2016-06-10 11:00:00,347,148,Friday,11,495
5159,FRMT,2016-06-10 12:00:00,246,201,Friday,12,447
5160,FRMT,2016-06-10 13:00:00,206,236,Friday,13,442
5161,FRMT,2016-06-10 14:00:00,206,315,Friday,14,521
5162,FRMT,2016-06-10 15:00:00,234,474,Friday,15,708
5163,FRMT,2016-06-10 16:00:00,425,635,Friday,16,1060
5164,FRMT,2016-06-10 17:00:00,725,1520,Friday,17,2245
5165,FRMT,2016-06-10 18:00:00,675,1570,Friday,18,2245
5166,FRMT,2016-06-10 19:00:00,333,785,Friday,19,1118
5167,FRMT,2016-06-10 20:00:00,192,361,Friday,20,553
5168,FRMT,2016-06-10 21:00:00,128,395,Friday,21,523
5169,FRMT,2016-06-10 22:00:00,102,455,Friday,22,557
5170,FRMT,2016-06-10 23:00:00,69,265,Friday,23,334
5171,FRMT,2016-06-11 00:00:00,41,90,Saturday,0,131
5172,FRMT,2016-06-11 01:00:00,3,51,Saturday,1,54
5173,FRMT,2016-06-11 06:00:00,20,3,Saturday,6,23
5174,FRMT,2016-06-11 07:00:00,53,75,Saturday,7,128
5175,FRMT,2016-06-11 08:00:00,125,128,Saturday,8,253
5176,FRMT,2016-06-11 09:00:00,177,80,Saturday,9,257
5177,FRMT,2016-06-11 10:00:00,238,88,Saturday,10,326
5178,FRMT,2016-06-11 11:00:00,326,202,Saturday,11,528
5179,FRMT,2016-06-11 12:00:00,276,121,Saturday,12,397
5180,FRMT,2016-06-11 13:00:00,235,97,Saturday,13,332
5181,FRMT,2016-06-11 14:00:00,211,135,Saturday,14,346
5182,FRMT,2016-06-11 15:00:00,244,159,Saturday,15,403
5183,FRMT,2016-06-11 16:00:00,174,162,Saturday,16,336
5184,FRMT,2016-06-11 17:00:00,162,175,Saturday,17,337
5185,FRMT,2016-06-11 18:00:00,149,275,Saturday,18,424
5186,FRMT,2016-06-11 19:00:00,152,235,Saturday,19,387
5187,FRMT,2016-06-11 20:00:00,119,160,Saturday,20,279
5188,FRMT,2016-06-11 21:00:00,95,176,Saturday,21,271
5189,FRMT,2016-06-11 22:00:00,98,204,Saturday,22,302
5190,FRMT,2016-06-11 23:00:00,74,174,Saturday,23,248
5191,FRMT,2016-06-12 00:00:00,17,115,Sunday,0,132
5192,FRMT,2016-06-12 01:00:00,1,21,Sunday,1,22
5193,FRMT,2016-06-12 09:00:00,132,117,Sunday,9,249
5194,FRMT,2016-06-12 10:00:00,149,83,Sunday,10,232
5195,FRMT,2016-06-12 11:00:00,194,115,Sunday,11,309
5196,FRMT,2016-06-12 12:00:00,175,90,Sunday,12,265
5197,FRMT,2016-06-12 13:00:00,181,98,Sunday,13,279
5198,FRMT,2016-06-12 14:00:00,175,87,Sunday,14,262
5199,FRMT,2016-06-12 15:00:00,183,98,Sunday,15,281
5200,FRMT,2016-06-12 16:00:00,165,116,Sunday,16,281
5201,FRMT,2016-06-12 17:00:00,144,196,Sunday,17,340
5202,FRMT,2016-06-12 18:00:00,166,131,Sunday,18,297
5203,FRMT,2016-06-12 19:00:00,253,180,Sunday,19,433
5204,FRMT,2016-06-12 20:00:00,125,176,Sunday,20,301
5205,FRMT,2016-06-12 21:00:00,115,193,Sunday,21,308
5206,FRMT,2016-06-12 22:00:00,102,175,Sunday,22,277
5207,FRMT,2016-06-12 23:00:00,50,133,Sunday,23,183
5208,FRMT,2016-06-13 00:00:00,44,301,Monday,0,345
5209,FRMT,2016-06-13 01:00:00,7,16,Monday,1,23
5210,FRMT,2016-06-13 04:00:00,10,1,Monday,4,11
5211,FRMT,2016-06-13 05:00:00,106,91,Monday,5,197
5212,FRMT,2016-06-13 06:00:00,320,182,Monday,6,502
5213,FRMT,2016-06-13 07:00:00,1018,437,Monday,7,1455
5214,FRMT,2016-06-13 08:00:00,1996,470,Monday,8,2466
5215,FRMT,2016-06-13 09:00:00,2008,228,Monday,9,2236
5216,FRMT,2016-06-13 10:00:00,898,133,Monday,10,1031
5217,FRMT,2016-06-13 11:00:00,347,169,Monday,11,516
5218,FRMT,2016-06-13 12:00:00,206,166,Monday,12,372
5219,FRMT,2016-06-13 13:00:00,188,198,Monday,13,386
5220,FRMT,2016-06-13 14:00:00,222,220,Monday,14,442
5221,FRMT,2016-06-13 15:00:00,202,362,Monday,15,564
5222,FRMT,2016-06-13 16:00:00,577,680,Monday,16,1257
5223,FRMT,2016-06-13 17:00:00,800,1650,Monday,17,2450
5224,FRMT,2016-06-13 18:00:00,633,2395,Monday,18,3028
5225,FRMT,2016-06-13 19:00:00,312,1016,Monday,19,1328
5226,FRMT,2016-06-13 20:00:00,146,370,Monday,20,516
5227,FRMT,2016-06-13 21:00:00,95,631,Monday,21,726
5228,FRMT,2016-06-13 22:00:00,95,386,Monday,22,481
5229,FRMT,2016-06-13 23:00:00,116,284,Monday,23,400
5230,FRMT,2016-06-14 00:00:00,49,79,Tuesday,0,128
5231,FRMT,2016-06-14 01:00:00,3,21,Tuesday,1,24
5232,FRMT,2016-06-14 03:00:00,1,1,Tuesday,3,2
5233,FRMT,2016-06-14 05:00:00,117,100,Tuesday,5,217
5234,FRMT,2016-06-14 06:00:00,376,194,Tuesday,6,570
5235,FRMT,2016-06-14 07:00:00,948,433,Tuesday,7,1381
5236,FRMT,2016-06-14 08:00:00,1756,416,Tuesday,8,2172
5237,FRMT,2016-06-14 09:00:00,2452,221,Tuesday,9,2673
5238,FRMT,2016-06-14 10:00:00,877,186,Tuesday,10,1063
5239,FRMT,2016-06-14 11:00:00,350,153,Tuesday,11,503
5240,FRMT,2016-06-14 12:00:00,232,158,Tuesday,12,390
5241,FRMT,2016-06-14 13:00:00,186,207,Tuesday,13,393
5242,FRMT,2016-06-14 14:00:00,185,255,Tuesday,14,440
5243,FRMT,2016-06-14 15:00:00,204,342,Tuesday,15,546
5244,FRMT,2016-06-14 16:00:00,293,655,Tuesday,16,948
5245,FRMT,2016-06-14 17:00:00,529,1714,Tuesday,17,2243
5246,FRMT,2016-06-14 18:00:00,526,2220,Tuesday,18,2746
5247,FRMT,2016-06-14 19:00:00,307,1178,Tuesday,19,1485
5248,FRMT,2016-06-14 20:00:00,166,389,Tuesday,20,555
5249,FRMT,2016-06-14 21:00:00,106,265,Tuesday,21,371
5250,FRMT,2016-06-14 22:00:00,98,263,Tuesday,22,361
5251,FRMT,2016-06-14 23:00:00,55,213,Tuesday,23,268
5252,FTVL,2016-06-01 01:00:00,6,7,Wednesday,1,13
5253,FTVL,2016-06-01 04:00:00,2,12,Wednesday,4,14
5254,FTVL,2016-06-01 05:00:00,253,69,Wednesday,5,322
5255,FTVL,2016-06-01 06:00:00,598,142,Wednesday,6,740
5256,FTVL,2016-06-01 07:00:00,1251,288,Wednesday,7,1539
5257,FTVL,2016-06-01 08:00:00,1467,292,Wednesday,8,1759
5258,FTVL,2016-06-01 09:00:00,1044,218,Wednesday,9,1262
5259,FTVL,2016-06-01 10:00:00,515,179,Wednesday,10,694
5260,FTVL,2016-06-01 11:00:00,394,206,Wednesday,11,600
5261,FTVL,2016-06-01 12:00:00,344,326,Wednesday,12,670
5262,FTVL,2016-06-01 13:00:00,367,362,Wednesday,13,729
5263,FTVL,2016-06-01 14:00:00,356,455,Wednesday,14,811
5264,FTVL,2016-06-01 15:00:00,316,721,Wednesday,15,1037
5265,FTVL,2016-06-01 16:00:00,343,1046,Wednesday,16,1389
5266,FTVL,2016-06-01 17:00:00,408,1389,Wednesday,17,1797
5267,FTVL,2016-06-01 18:00:00,320,1204,Wednesday,18,1524
5268,FTVL,2016-06-01 19:00:00,222,642,Wednesday,19,864
5269,FTVL,2016-06-01 20:00:00,141,363,Wednesday,20,504
5270,FTVL,2016-06-01 21:00:00,139,346,Wednesday,21,485
5271,FTVL,2016-06-01 22:00:00,108,239,Wednesday,22,347
5272,FTVL,2016-06-01 23:00:00,52,190,Wednesday,23,242
5273,FTVL,2016-06-02 00:00:00,21,117,Thursday,0,138
5274,FTVL,2016-06-02 01:00:00,4,8,Thursday,1,12
5275,FTVL,2016-06-02 04:00:00,4,13,Thursday,4,17
5276,FTVL,2016-06-02 05:00:00,254,57,Thursday,5,311
5277,FTVL,2016-06-02 06:00:00,597,131,Thursday,6,728
5278,FTVL,2016-06-02 07:00:00,1234,242,Thursday,7,1476
5279,FTVL,2016-06-02 08:00:00,1422,287,Thursday,8,1709
5280,FTVL,2016-06-02 09:00:00,1305,232,Thursday,9,1537
5281,FTVL,2016-06-02 10:00:00,655,196,Thursday,10,851
5282,FTVL,2016-06-02 11:00:00,323,261,Thursday,11,584
5283,FTVL,2016-06-02 12:00:00,387,276,Thursday,12,663
5284,FTVL,2016-06-02 13:00:00,353,455,Thursday,13,808
5285,FTVL,2016-06-02 14:00:00,334,513,Thursday,14,847
5286,FTVL,2016-06-02 15:00:00,338,838,Thursday,15,1176
5287,FTVL,2016-06-02 16:00:00,393,965,Thursday,16,1358
5288,FTVL,2016-06-02 17:00:00,432,1456,Thursday,17,1888
5289,FTVL,2016-06-02 18:00:00,329,1134,Thursday,18,1463
5290,FTVL,2016-06-02 19:00:00,257,578,Thursday,19,835
5291,FTVL,2016-06-02 20:00:00,126,415,Thursday,20,541
5292,FTVL,2016-06-02 21:00:00,134,464,Thursday,21,598
5293,FTVL,2016-06-02 22:00:00,114,281,Thursday,22,395
5294,FTVL,2016-06-02 23:00:00,63,212,Thursday,23,275
5295,FTVL,2016-06-03 00:00:00,33,121,Friday,0,154
5296,FTVL,2016-06-03 01:00:00,6,9,Friday,1,15
5297,FTVL,2016-06-03 04:00:00,4,15,Friday,4,19
5298,FTVL,2016-06-03 05:00:00,238,37,Friday,5,275
5299,FTVL,2016-06-03 06:00:00,584,126,Friday,6,710
5300,FTVL,2016-06-03 07:00:00,1142,285,Friday,7,1427
5301,FTVL,2016-06-03 08:00:00,1326,317,Friday,8,1643
5302,FTVL,2016-06-03 09:00:00,1050,214,Friday,9,1264
5303,FTVL,2016-06-03 10:00:00,567,185,Friday,10,752
5304,FTVL,2016-06-03 11:00:00,399,270,Friday,11,669
5305,FTVL,2016-06-03 12:00:00,332,329,Friday,12,661
5306,FTVL,2016-06-03 13:00:00,341,422,Friday,13,763
5307,FTVL,2016-06-03 14:00:00,347,585,Friday,14,932
5308,FTVL,2016-06-03 15:00:00,353,738,Friday,15,1091
5309,FTVL,2016-06-03 16:00:00,396,974,Friday,16,1370
5310,FTVL,2016-06-03 17:00:00,416,1309,Friday,17,1725
5311,FTVL,2016-06-03 18:00:00,367,967,Friday,18,1334
5312,FTVL,2016-06-03 19:00:00,315,525,Friday,19,840
5313,FTVL,2016-06-03 20:00:00,180,415,Friday,20,595
5314,FTVL,2016-06-03 21:00:00,182,354,Friday,21,536
5315,FTVL,2016-06-03 22:00:00,111,315,Friday,22,426
5316,FTVL,2016-06-03 23:00:00,84,282,Friday,23,366
5317,FTVL,2016-06-04 00:00:00,57,196,Saturday,0,253
5318,FTVL,2016-06-04 01:00:00,7,6,Saturday,1,13
5319,FTVL,2016-06-04 06:00:00,138,66,Saturday,6,204
5320,FTVL,2016-06-04 07:00:00,349,106,Saturday,7,455
5321,FTVL,2016-06-04 08:00:00,354,127,Saturday,8,481
5322,FTVL,2016-06-04 09:00:00,392,150,Saturday,9,542
5323,FTVL,2016-06-04 10:00:00,400,167,Saturday,10,567
5324,FTVL,2016-06-04 11:00:00,314,183,Saturday,11,497
5325,FTVL,2016-06-04 12:00:00,315,243,Saturday,12,558
5326,FTVL,2016-06-04 13:00:00,335,271,Saturday,13,606
5327,FTVL,2016-06-04 14:00:00,298,309,Saturday,14,607
5328,FTVL,2016-06-04 15:00:00,338,388,Saturday,15,726
5329,FTVL,2016-06-04 16:00:00,283,428,Saturday,16,711
5330,FTVL,2016-06-04 17:00:00,282,454,Saturday,17,736
5331,FTVL,2016-06-04 18:00:00,207,431,Saturday,18,638
5332,FTVL,2016-06-04 19:00:00,193,296,Saturday,19,489
5333,FTVL,2016-06-04 20:00:00,160,291,Saturday,20,451
5334,FTVL,2016-06-04 21:00:00,131,222,Saturday,21,353
5335,FTVL,2016-06-04 22:00:00,109,245,Saturday,22,354
5336,FTVL,2016-06-04 23:00:00,54,186,Saturday,23,240
5337,FTVL,2016-06-05 00:00:00,36,144,Sunday,0,180
5338,FTVL,2016-06-05 01:00:00,3,10,Sunday,1,13
5339,FTVL,2016-06-05 08:00:00,243,89,Sunday,8,332
5340,FTVL,2016-06-05 09:00:00,252,110,Sunday,9,362
5341,FTVL,2016-06-05 10:00:00,277,156,Sunday,10,433
5342,FTVL,2016-06-05 11:00:00,294,152,Sunday,11,446
5343,FTVL,2016-06-05 12:00:00,285,159,Sunday,12,444
5344,FTVL,2016-06-05 13:00:00,302,223,Sunday,13,525
5345,FTVL,2016-06-05 14:00:00,292,242,Sunday,14,534
5346,FTVL,2016-06-05 15:00:00,241,268,Sunday,15,509
5347,FTVL,2016-06-05 16:00:00,253,361,Sunday,16,614
5348,FTVL,2016-06-05 17:00:00,209,341,Sunday,17,550
5349,FTVL,2016-06-05 18:00:00,177,311,Sunday,18,488
5350,FTVL,2016-06-05 19:00:00,128,248,Sunday,19,376
5351,FTVL,2016-06-05 20:00:00,116,269,Sunday,20,385
5352,FTVL,2016-06-05 21:00:00,143,206,Sunday,21,349
5353,FTVL,2016-06-05 22:00:00,92,147,Sunday,22,239
5354,FTVL,2016-06-05 23:00:00,59,146,Sunday,23,205
5355,FTVL,2016-06-06 00:00:00,26,83,Monday,0,109
5356,FTVL,2016-06-06 01:00:00,3,3,Monday,1,6
5357,FTVL,2016-06-06 04:00:00,11,9,Monday,4,20
5358,FTVL,2016-06-06 05:00:00,231,46,Monday,5,277
5359,FTVL,2016-06-06 06:00:00,579,107,Monday,6,686
5360,FTVL,2016-06-06 07:00:00,1189,255,Monday,7,1444
5361,FTVL,2016-06-06 08:00:00,1389,282,Monday,8,1671
5362,FTVL,2016-06-06 09:00:00,1014,187,Monday,9,1201
5363,FTVL,2016-06-06 10:00:00,481,195,Monday,10,676
5364,FTVL,2016-06-06 11:00:00,346,221,Monday,11,567
5365,FTVL,2016-06-06 12:00:00,311,279,Monday,12,590
5366,FTVL,2016-06-06 13:00:00,327,305,Monday,13,632
5367,FTVL,2016-06-06 14:00:00,337,499,Monday,14,836
5368,FTVL,2016-06-06 15:00:00,321,570,Monday,15,891
5369,FTVL,2016-06-06 16:00:00,386,1023,Monday,16,1409
5370,FTVL,2016-06-06 17:00:00,334,1503,Monday,17,1837
5371,FTVL,2016-06-06 18:00:00,308,1105,Monday,18,1413
5372,FTVL,2016-06-06 19:00:00,195,609,Monday,19,804
5373,FTVL,2016-06-06 20:00:00,115,268,Monday,20,383
5374,FTVL,2016-06-06 21:00:00,100,379,Monday,21,479
5375,FTVL,2016-06-06 22:00:00,109,234,Monday,22,343
5376,FTVL,2016-06-06 23:00:00,56,175,Monday,23,231
5377,FTVL,2016-06-07 00:00:00,23,105,Tuesday,0,128
5378,FTVL,2016-06-07 01:00:00,3,7,Tuesday,1,10
5379,FTVL,2016-06-07 04:00:00,6,14,Tuesday,4,20
5380,FTVL,2016-06-07 05:00:00,260,49,Tuesday,5,309
5381,FTVL,2016-06-07 06:00:00,585,141,Tuesday,6,726
5382,FTVL,2016-06-07 07:00:00,1288,274,Tuesday,7,1562
5383,FTVL,2016-06-07 08:00:00,1444,289,Tuesday,8,1733
5384,FTVL,2016-06-07 09:00:00,1013,212,Tuesday,9,1225
5385,FTVL,2016-06-07 10:00:00,632,214,Tuesday,10,846
5386,FTVL,2016-06-07 11:00:00,345,222,Tuesday,11,567
5387,FTVL,2016-06-07 12:00:00,320,237,Tuesday,12,557
5388,FTVL,2016-06-07 13:00:00,334,351,Tuesday,13,685
5389,FTVL,2016-06-07 14:00:00,363,488,Tuesday,14,851
5390,FTVL,2016-06-07 15:00:00,338,683,Tuesday,15,1021
5391,FTVL,2016-06-07 16:00:00,375,1045,Tuesday,16,1420
5392,FTVL,2016-06-07 17:00:00,378,1507,Tuesday,17,1885
5393,FTVL,2016-06-07 18:00:00,325,1147,Tuesday,18,1472
5394,FTVL,2016-06-07 19:00:00,233,575,Tuesday,19,808
5395,FTVL,2016-06-07 20:00:00,145,435,Tuesday,20,580
5396,FTVL,2016-06-07 21:00:00,118,316,Tuesday,21,434
5397,FTVL,2016-06-07 22:00:00,98,249,Tuesday,22,347
5398,FTVL,2016-06-07 23:00:00,65,235,Tuesday,23,300
5399,FTVL,2016-06-08 00:00:00,31,132,Wednesday,0,163
5400,FTVL,2016-06-08 01:00:00,6,5,Wednesday,1,11
5401,FTVL,2016-06-08 04:00:00,5,18,Wednesday,4,23
5402,FTVL,2016-06-08 05:00:00,240,40,Wednesday,5,280
5403,FTVL,2016-06-08 06:00:00,582,119,Wednesday,6,701
5404,FTVL,2016-06-08 07:00:00,1238,272,Wednesday,7,1510
5405,FTVL,2016-06-08 08:00:00,1281,305,Wednesday,8,1586
5406,FTVL,2016-06-08 09:00:00,1048,197,Wednesday,9,1245
5407,FTVL,2016-06-08 10:00:00,538,180,Wednesday,10,718
5408,FTVL,2016-06-08 11:00:00,346,221,Wednesday,11,567
5409,FTVL,2016-06-08 12:00:00,330,288,Wednesday,12,618
5410,FTVL,2016-06-08 13:00:00,381,365,Wednesday,13,746
5411,FTVL,2016-06-08 14:00:00,337,441,Wednesday,14,778
5412,FTVL,2016-06-08 15:00:00,359,649,Wednesday,15,1008
5413,FTVL,2016-06-08 16:00:00,320,973,Wednesday,16,1293
5414,FTVL,2016-06-08 17:00:00,476,1299,Wednesday,17,1775
5415,FTVL,2016-06-08 18:00:00,353,1299,Wednesday,18,1652
5416,FTVL,2016-06-08 19:00:00,207,501,Wednesday,19,708
5417,FTVL,2016-06-08 20:00:00,110,426,Wednesday,20,536
5418,FTVL,2016-06-08 21:00:00,135,480,Wednesday,21,615
5419,FTVL,2016-06-08 22:00:00,119,308,Wednesday,22,427
5420,FTVL,2016-06-08 23:00:00,58,231,Wednesday,23,289
5421,FTVL,2016-06-09 00:00:00,29,117,Thursday,0,146
5422,FTVL,2016-06-09 01:00:00,5,5,Thursday,1,10
5423,FTVL,2016-06-09 04:00:00,11,16,Thursday,4,27
5424,FTVL,2016-06-09 05:00:00,251,42,Thursday,5,293
5425,FTVL,2016-06-09 06:00:00,588,125,Thursday,6,713
5426,FTVL,2016-06-09 07:00:00,1145,271,Thursday,7,1416
5427,FTVL,2016-06-09 08:00:00,1416,301,Thursday,8,1717
5428,FTVL,2016-06-09 09:00:00,966,203,Thursday,9,1169
5429,FTVL,2016-06-09 10:00:00,561,205,Thursday,10,766
5430,FTVL,2016-06-09 11:00:00,327,224,Thursday,11,551
5431,FTVL,2016-06-09 12:00:00,339,247,Thursday,12,586
5432,FTVL,2016-06-09 13:00:00,295,332,Thursday,13,627
5433,FTVL,2016-06-09 14:00:00,335,428,Thursday,14,763
5434,FTVL,2016-06-09 15:00:00,347,638,Thursday,15,985
5435,FTVL,2016-06-09 16:00:00,364,944,Thursday,16,1308
5436,FTVL,2016-06-09 17:00:00,380,1371,Thursday,17,1751
5437,FTVL,2016-06-09 18:00:00,303,1074,Thursday,18,1377
5438,FTVL,2016-06-09 19:00:00,226,593,Thursday,19,819
5439,FTVL,2016-06-09 20:00:00,156,414,Thursday,20,570
5440,FTVL,2016-06-09 21:00:00,135,345,Thursday,21,480
5441,FTVL,2016-06-09 22:00:00,117,299,Thursday,22,416
5442,FTVL,2016-06-09 23:00:00,70,201,Thursday,23,271
5443,FTVL,2016-06-10 00:00:00,23,117,Friday,0,140
5444,FTVL,2016-06-10 01:00:00,5,10,Friday,1,15
5445,FTVL,2016-06-10 04:00:00,6,17,Friday,4,23
5446,FTVL,2016-06-10 05:00:00,204,36,Friday,5,240
5447,FTVL,2016-06-10 06:00:00,603,123,Friday,6,726
5448,FTVL,2016-06-10 07:00:00,1086,254,Friday,7,1340
5449,FTVL,2016-06-10 08:00:00,1305,296,Friday,8,1601
5450,FTVL,2016-06-10 09:00:00,838,183,Friday,9,1021
5451,FTVL,2016-06-10 10:00:00,532,176,Friday,10,708
5452,FTVL,2016-06-10 11:00:00,375,197,Friday,11,572
5453,FTVL,2016-06-10 12:00:00,342,289,Friday,12,631
5454,FTVL,2016-06-10 13:00:00,365,346,Friday,13,711
5455,FTVL,2016-06-10 14:00:00,371,467,Friday,14,838
5456,FTVL,2016-06-10 15:00:00,365,680,Friday,15,1045
5457,FTVL,2016-06-10 16:00:00,401,1020,Friday,16,1421
5458,FTVL,2016-06-10 17:00:00,460,1163,Friday,17,1623
5459,FTVL,2016-06-10 18:00:00,426,1003,Friday,18,1429
5460,FTVL,2016-06-10 19:00:00,240,548,Friday,19,788
5461,FTVL,2016-06-10 20:00:00,140,367,Friday,20,507
5462,FTVL,2016-06-10 21:00:00,145,423,Friday,21,568
5463,FTVL,2016-06-10 22:00:00,142,358,Friday,22,500
5464,FTVL,2016-06-10 23:00:00,125,285,Friday,23,410
5465,FTVL,2016-06-11 00:00:00,60,169,Saturday,0,229
5466,FTVL,2016-06-11 01:00:00,3,11,Saturday,1,14
5467,FTVL,2016-06-11 06:00:00,131,56,Saturday,6,187
5468,FTVL,2016-06-11 07:00:00,277,85,Saturday,7,362
5469,FTVL,2016-06-11 08:00:00,349,141,Saturday,8,490
5470,FTVL,2016-06-11 09:00:00,346,125,Saturday,9,471
5471,FTVL,2016-06-11 10:00:00,375,152,Saturday,10,527
5472,FTVL,2016-06-11 11:00:00,317,202,Saturday,11,519
5473,FTVL,2016-06-11 12:00:00,329,207,Saturday,12,536
5474,FTVL,2016-06-11 13:00:00,304,244,Saturday,13,548
5475,FTVL,2016-06-11 14:00:00,360,261,Saturday,14,621
5476,FTVL,2016-06-11 15:00:00,294,314,Saturday,15,608
5477,FTVL,2016-06-11 16:00:00,275,358,Saturday,16,633
5478,FTVL,2016-06-11 17:00:00,251,423,Saturday,17,674
5479,FTVL,2016-06-11 18:00:00,252,397,Saturday,18,649
5480,FTVL,2016-06-11 19:00:00,240,343,Saturday,19,583
5481,FTVL,2016-06-11 20:00:00,146,289,Saturday,20,435
5482,FTVL,2016-06-11 21:00:00,123,235,Saturday,21,358
5483,FTVL,2016-06-11 22:00:00,106,288,Saturday,22,394
5484,FTVL,2016-06-11 23:00:00,73,253,Saturday,23,326
5485,FTVL,2016-06-12 00:00:00,44,170,Sunday,0,214
5486,FTVL,2016-06-12 01:00:00,6,6,Sunday,1,12
5487,FTVL,2016-06-12 08:00:00,252,115,Sunday,8,367
5488,FTVL,2016-06-12 09:00:00,230,117,Sunday,9,347
5489,FTVL,2016-06-12 10:00:00,292,144,Sunday,10,436
5490,FTVL,2016-06-12 11:00:00,289,152,Sunday,11,441
5491,FTVL,2016-06-12 12:00:00,297,150,Sunday,12,447
5492,FTVL,2016-06-12 13:00:00,349,189,Sunday,13,538
5493,FTVL,2016-06-12 14:00:00,301,227,Sunday,14,528
5494,FTVL,2016-06-12 15:00:00,217,252,Sunday,15,469
5495,FTVL,2016-06-12 16:00:00,216,280,Sunday,16,496
5496,FTVL,2016-06-12 17:00:00,207,298,Sunday,17,505
5497,FTVL,2016-06-12 18:00:00,142,334,Sunday,18,476
5498,FTVL,2016-06-12 19:00:00,151,260,Sunday,19,411
5499,FTVL,2016-06-12 20:00:00,144,229,Sunday,20,373
5500,FTVL,2016-06-12 21:00:00,115,235,Sunday,21,350
5501,FTVL,2016-06-12 22:00:00,83,226,Sunday,22,309
5502,FTVL,2016-06-12 23:00:00,55,178,Sunday,23,233
5503,FTVL,2016-06-13 00:00:00,33,84,Monday,0,117
5504,FTVL,2016-06-13 01:00:00,2,1,Monday,1,3
5505,FTVL,2016-06-13 04:00:00,3,9,Monday,4,12
5506,FTVL,2016-06-13 05:00:00,257,34,Monday,5,291
5507,FTVL,2016-06-13 06:00:00,532,109,Monday,6,641
5508,FTVL,2016-06-13 07:00:00,1212,227,Monday,7,1439
5509,FTVL,2016-06-13 08:00:00,1370,306,Monday,8,1676
5510,FTVL,2016-06-13 09:00:00,873,173,Monday,9,1046
5511,FTVL,2016-06-13 10:00:00,509,165,Monday,10,674
5512,FTVL,2016-06-13 11:00:00,314,248,Monday,11,562
5513,FTVL,2016-06-13 12:00:00,347,273,Monday,12,620
5514,FTVL,2016-06-13 13:00:00,318,322,Monday,13,640
5515,FTVL,2016-06-13 14:00:00,332,391,Monday,14,723
5516,FTVL,2016-06-13 15:00:00,337,565,Monday,15,902
5517,FTVL,2016-06-13 16:00:00,367,1006,Monday,16,1373
5518,FTVL,2016-06-13 17:00:00,436,1382,Monday,17,1818
5519,FTVL,2016-06-13 18:00:00,371,1261,Monday,18,1632
5520,FTVL,2016-06-13 19:00:00,239,534,Monday,19,773
5521,FTVL,2016-06-13 20:00:00,108,314,Monday,20,422
5522,FTVL,2016-06-13 21:00:00,105,480,Monday,21,585
5523,FTVL,2016-06-13 22:00:00,116,326,Monday,22,442
5524,FTVL,2016-06-13 23:00:00,74,188,Monday,23,262
5525,FTVL,2016-06-14 00:00:00,35,119,Tuesday,0,154
5526,FTVL,2016-06-14 01:00:00,10,12,Tuesday,1,22
5527,FTVL,2016-06-14 04:00:00,12,12,Tuesday,4,24
5528,FTVL,2016-06-14 05:00:00,254,55,Tuesday,5,309
5529,FTVL,2016-06-14 06:00:00,587,134,Tuesday,6,721
5530,FTVL,2016-06-14 07:00:00,1219,271,Tuesday,7,1490
5531,FTVL,2016-06-14 08:00:00,1289,305,Tuesday,8,1594
5532,FTVL,2016-06-14 09:00:00,1163,216,Tuesday,9,1379
5533,FTVL,2016-06-14 10:00:00,537,162,Tuesday,10,699
5534,FTVL,2016-06-14 11:00:00,375,213,Tuesday,11,588
5535,FTVL,2016-06-14 12:00:00,306,292,Tuesday,12,598
5536,FTVL,2016-06-14 13:00:00,350,316,Tuesday,13,666
5537,FTVL,2016-06-14 14:00:00,340,416,Tuesday,14,756
5538,FTVL,2016-06-14 15:00:00,295,619,Tuesday,15,914
5539,FTVL,2016-06-14 16:00:00,298,960,Tuesday,16,1258
5540,FTVL,2016-06-14 17:00:00,407,1371,Tuesday,17,1778
5541,FTVL,2016-06-14 18:00:00,351,1282,Tuesday,18,1633
5542,FTVL,2016-06-14 19:00:00,220,642,Tuesday,19,862
5543,FTVL,2016-06-14 20:00:00,155,444,Tuesday,20,599
5544,FTVL,2016-06-14 21:00:00,136,411,Tuesday,21,547
5545,FTVL,2016-06-14 22:00:00,84,286,Tuesday,22,370
5546,FTVL,2016-06-14 23:00:00,51,234,Tuesday,23,285
5547,GLEN,2016-06-01 01:00:00,2,17,Wednesday,1,19
5548,GLEN,2016-06-01 05:00:00,119,26,Wednesday,5,145
5549,GLEN,2016-06-01 06:00:00,349,106,Wednesday,6,455
5550,GLEN,2016-06-01 07:00:00,996,240,Wednesday,7,1236
5551,GLEN,2016-06-01 08:00:00,1831,248,Wednesday,8,2079
5552,GLEN,2016-06-01 09:00:00,1154,154,Wednesday,9,1308
5553,GLEN,2016-06-01 10:00:00,487,112,Wednesday,10,599
5554,GLEN,2016-06-01 11:00:00,335,143,Wednesday,11,478
5555,GLEN,2016-06-01 12:00:00,260,168,Wednesday,12,428
5556,GLEN,2016-06-01 13:00:00,246,220,Wednesday,13,466
5557,GLEN,2016-06-01 14:00:00,247,276,Wednesday,14,523
5558,GLEN,2016-06-01 15:00:00,267,454,Wednesday,15,721
5559,GLEN,2016-06-01 16:00:00,305,691,Wednesday,16,996
5560,GLEN,2016-06-01 17:00:00,357,1476,Wednesday,17,1833
5561,GLEN,2016-06-01 18:00:00,348,1212,Wednesday,18,1560
5562,GLEN,2016-06-01 19:00:00,171,655,Wednesday,19,826
5563,GLEN,2016-06-01 20:00:00,104,368,Wednesday,20,472
5564,GLEN,2016-06-01 21:00:00,78,336,Wednesday,21,414
5565,GLEN,2016-06-01 22:00:00,56,242,Wednesday,22,298
5566,GLEN,2016-06-01 23:00:00,33,143,Wednesday,23,176
5567,GLEN,2016-06-02 00:00:00,18,67,Thursday,0,85
5568,GLEN,2016-06-02 01:00:00,1,9,Thursday,1,10
5569,GLEN,2016-06-02 05:00:00,103,21,Thursday,5,124
5570,GLEN,2016-06-02 06:00:00,335,105,Thursday,6,440
5571,GLEN,2016-06-02 07:00:00,941,222,Thursday,7,1163
5572,GLEN,2016-06-02 08:00:00,1582,246,Thursday,8,1828
5573,GLEN,2016-06-02 09:00:00,1397,146,Thursday,9,1543
5574,GLEN,2016-06-02 10:00:00,518,168,Thursday,10,686
5575,GLEN,2016-06-02 11:00:00,280,151,Thursday,11,431
5576,GLEN,2016-06-02 12:00:00,286,146,Thursday,12,432
5577,GLEN,2016-06-02 13:00:00,250,215,Thursday,13,465
5578,GLEN,2016-06-02 14:00:00,294,274,Thursday,14,568
5579,GLEN,2016-06-02 15:00:00,294,418,Thursday,15,712
5580,GLEN,2016-06-02 16:00:00,326,688,Thursday,16,1014
5581,GLEN,2016-06-02 17:00:00,483,1538,Thursday,17,2021
5582,GLEN,2016-06-02 18:00:00,391,1107,Thursday,18,1498
5583,GLEN,2016-06-02 19:00:00,174,586,Thursday,19,760
5584,GLEN,2016-06-02 20:00:00,126,314,Thursday,20,440
5585,GLEN,2016-06-02 21:00:00,92,458,Thursday,21,550
5586,GLEN,2016-06-02 22:00:00,82,317,Thursday,22,399
5587,GLEN,2016-06-02 23:00:00,36,210,Thursday,23,246
5588,GLEN,2016-06-03 00:00:00,19,70,Friday,0,89
5589,GLEN,2016-06-03 01:00:00,5,10,Friday,1,15
5590,GLEN,2016-06-03 04:00:00,26,1,Friday,4,27
5591,GLEN,2016-06-03 05:00:00,103,19,Friday,5,122
5592,GLEN,2016-06-03 06:00:00,322,105,Friday,6,427
5593,GLEN,2016-06-03 07:00:00,882,204,Friday,7,1086
5594,GLEN,2016-06-03 08:00:00,1597,204,Friday,8,1801
5595,GLEN,2016-06-03 09:00:00,1019,143,Friday,9,1162
5596,GLEN,2016-06-03 10:00:00,522,113,Friday,10,635
5597,GLEN,2016-06-03 11:00:00,332,134,Friday,11,466
5598,GLEN,2016-06-03 12:00:00,318,212,Friday,12,530
5599,GLEN,2016-06-03 13:00:00,245,254,Friday,13,499
5600,GLEN,2016-06-03 14:00:00,265,336,Friday,14,601
5601,GLEN,2016-06-03 15:00:00,298,479,Friday,15,777
5602,GLEN,2016-06-03 16:00:00,335,759,Friday,16,1094
5603,GLEN,2016-06-03 17:00:00,409,1295,Friday,17,1704
5604,GLEN,2016-06-03 18:00:00,450,958,Friday,18,1408
5605,GLEN,2016-06-03 19:00:00,285,522,Friday,19,807
5606,GLEN,2016-06-03 20:00:00,144,296,Friday,20,440
5607,GLEN,2016-06-03 21:00:00,135,300,Friday,21,435
5608,GLEN,2016-06-03 22:00:00,90,325,Friday,22,415
5609,GLEN,2016-06-03 23:00:00,68,248,Friday,23,316
5610,GLEN,2016-06-04 00:00:00,37,143,Saturday,0,180
5611,GLEN,2016-06-04 01:00:00,3,21,Saturday,1,24
5612,GLEN,2016-06-04 06:00:00,62,25,Saturday,6,87
5613,GLEN,2016-06-04 07:00:00,140,31,Saturday,7,171
5614,GLEN,2016-06-04 08:00:00,245,77,Saturday,8,322
5615,GLEN,2016-06-04 09:00:00,277,110,Saturday,9,387
5616,GLEN,2016-06-04 10:00:00,413,95,Saturday,10,508
5617,GLEN,2016-06-04 11:00:00,319,171,Saturday,11,490
5618,GLEN,2016-06-04 12:00:00,280,175,Saturday,12,455
5619,GLEN,2016-06-04 13:00:00,295,214,Saturday,13,509
5620,GLEN,2016-06-04 14:00:00,248,271,Saturday,14,519
5621,GLEN,2016-06-04 15:00:00,230,284,Saturday,15,514
5622,GLEN,2016-06-04 16:00:00,236,287,Saturday,16,523
5623,GLEN,2016-06-04 17:00:00,264,366,Saturday,17,630
5624,GLEN,2016-06-04 18:00:00,228,323,Saturday,18,551
5625,GLEN,2016-06-04 19:00:00,165,215,Saturday,19,380
5626,GLEN,2016-06-04 20:00:00,149,229,Saturday,20,378
5627,GLEN,2016-06-04 21:00:00,77,200,Saturday,21,277
5628,GLEN,2016-06-04 22:00:00,85,188,Saturday,22,273
5629,GLEN,2016-06-04 23:00:00,56,216,Saturday,23,272
5630,GLEN,2016-06-05 00:00:00,27,102,Sunday,0,129
5631,GLEN,2016-06-05 07:00:00,1,1,Sunday,7,2
5632,GLEN,2016-06-05 08:00:00,110,19,Sunday,8,129
5633,GLEN,2016-06-05 09:00:00,195,84,Sunday,9,279
5634,GLEN,2016-06-05 10:00:00,253,95,Sunday,10,348
5635,GLEN,2016-06-05 11:00:00,269,115,Sunday,11,384
5636,GLEN,2016-06-05 12:00:00,237,156,Sunday,12,393
5637,GLEN,2016-06-05 13:00:00,270,161,Sunday,13,431
5638,GLEN,2016-06-05 14:00:00,221,217,Sunday,14,438
5639,GLEN,2016-06-05 15:00:00,246,253,Sunday,15,499
5640,GLEN,2016-06-05 16:00:00,245,255,Sunday,16,500
5641,GLEN,2016-06-05 17:00:00,169,309,Sunday,17,478
5642,GLEN,2016-06-05 18:00:00,114,248,Sunday,18,362
5643,GLEN,2016-06-05 19:00:00,85,192,Sunday,19,277
5644,GLEN,2016-06-05 20:00:00,76,270,Sunday,20,346
5645,GLEN,2016-06-05 21:00:00,86,161,Sunday,21,247
5646,GLEN,2016-06-05 22:00:00,65,154,Sunday,22,219
5647,GLEN,2016-06-05 23:00:00,37,119,Sunday,23,156
5648,GLEN,2016-06-06 00:00:00,13,21,Monday,0,34
5649,GLEN,2016-06-06 01:00:00,1,2,Monday,1,3
5650,GLEN,2016-06-06 05:00:00,105,13,Monday,5,118
5651,GLEN,2016-06-06 06:00:00,312,106,Monday,6,418
5652,GLEN,2016-06-06 07:00:00,959,255,Monday,7,1214
5653,GLEN,2016-06-06 08:00:00,1754,248,Monday,8,2002
5654,GLEN,2016-06-06 09:00:00,1218,144,Monday,9,1362
5655,GLEN,2016-06-06 10:00:00,491,125,Monday,10,616
5656,GLEN,2016-06-06 11:00:00,304,126,Monday,11,430
5657,GLEN,2016-06-06 12:00:00,268,212,Monday,12,480
5658,GLEN,2016-06-06 13:00:00,250,197,Monday,13,447
5659,GLEN,2016-06-06 14:00:00,243,327,Monday,14,570
5660,GLEN,2016-06-06 15:00:00,260,385,Monday,15,645
5661,GLEN,2016-06-06 16:00:00,289,745,Monday,16,1034
5662,GLEN,2016-06-06 17:00:00,337,1438,Monday,17,1775
5663,GLEN,2016-06-06 18:00:00,308,1237,Monday,18,1545
5664,GLEN,2016-06-06 19:00:00,177,651,Monday,19,828
5665,GLEN,2016-06-06 20:00:00,103,347,Monday,20,450
5666,GLEN,2016-06-06 21:00:00,79,381,Monday,21,460
5667,GLEN,2016-06-06 22:00:00,69,225,Monday,22,294
5668,GLEN,2016-06-06 23:00:00,27,162,Monday,23,189
5669,GLEN,2016-06-07 00:00:00,16,50,Tuesday,0,66
5670,GLEN,2016-06-07 04:00:00,33,1,Tuesday,4,34
5671,GLEN,2016-06-07 05:00:00,118,22,Tuesday,5,140
5672,GLEN,2016-06-07 06:00:00,379,130,Tuesday,6,509
5673,GLEN,2016-06-07 07:00:00,975,238,Tuesday,7,1213
5674,GLEN,2016-06-07 08:00:00,1802,250,Tuesday,8,2052
5675,GLEN,2016-06-07 09:00:00,1278,177,Tuesday,9,1455
5676,GLEN,2016-06-07 10:00:00,519,150,Tuesday,10,669
5677,GLEN,2016-06-07 11:00:00,303,150,Tuesday,11,453
5678,GLEN,2016-06-07 12:00:00,276,232,Tuesday,12,508
5679,GLEN,2016-06-07 13:00:00,220,207,Tuesday,13,427
5680,GLEN,2016-06-07 14:00:00,224,320,Tuesday,14,544
5681,GLEN,2016-06-07 15:00:00,282,398,Tuesday,15,680
5682,GLEN,2016-06-07 16:00:00,301,750,Tuesday,16,1051
5683,GLEN,2016-06-07 17:00:00,450,1451,Tuesday,17,1901
5684,GLEN,2016-06-07 18:00:00,394,1208,Tuesday,18,1602
5685,GLEN,2016-06-07 19:00:00,194,698,Tuesday,19,892
5686,GLEN,2016-06-07 20:00:00,128,329,Tuesday,20,457
5687,GLEN,2016-06-07 21:00:00,61,337,Tuesday,21,398
5688,GLEN,2016-06-07 22:00:00,70,278,Tuesday,22,348
5689,GLEN,2016-06-07 23:00:00,42,216,Tuesday,23,258
5690,GLEN,2016-06-08 00:00:00,13,59,Wednesday,0,72
5691,GLEN,2016-06-08 01:00:00,2,14,Wednesday,1,16
5692,GLEN,2016-06-08 05:00:00,111,23,Wednesday,5,134
5693,GLEN,2016-06-08 06:00:00,366,133,Wednesday,6,499
5694,GLEN,2016-06-08 07:00:00,995,219,Wednesday,7,1214
5695,GLEN,2016-06-08 08:00:00,1787,258,Wednesday,8,2045
5696,GLEN,2016-06-08 09:00:00,1191,149,Wednesday,9,1340
5697,GLEN,2016-06-08 10:00:00,500,126,Wednesday,10,626
5698,GLEN,2016-06-08 11:00:00,356,161,Wednesday,11,517
5699,GLEN,2016-06-08 12:00:00,276,210,Wednesday,12,486
5700,GLEN,2016-06-08 13:00:00,256,222,Wednesday,13,478
5701,GLEN,2016-06-08 14:00:00,249,325,Wednesday,14,574
5702,GLEN,2016-06-08 15:00:00,259,445,Wednesday,15,704
5703,GLEN,2016-06-08 16:00:00,328,726,Wednesday,16,1054
5704,GLEN,2016-06-08 17:00:00,429,1586,Wednesday,17,2015
5705,GLEN,2016-06-08 18:00:00,429,1101,Wednesday,18,1530
5706,GLEN,2016-06-08 19:00:00,164,584,Wednesday,19,748
5707,GLEN,2016-06-08 20:00:00,98,353,Wednesday,20,451
5708,GLEN,2016-06-08 21:00:00,84,439,Wednesday,21,523
5709,GLEN,2016-06-08 22:00:00,71,345,Wednesday,22,416
5710,GLEN,2016-06-08 23:00:00,37,193,Wednesday,23,230
5711,GLEN,2016-06-09 00:00:00,25,88,Thursday,0,113
5712,GLEN,2016-06-09 05:00:00,104,27,Thursday,5,131
5713,GLEN,2016-06-09 06:00:00,338,116,Thursday,6,454
5714,GLEN,2016-06-09 07:00:00,925,210,Thursday,7,1135
5715,GLEN,2016-06-09 08:00:00,1763,253,Thursday,8,2016
5716,GLEN,2016-06-09 09:00:00,1189,129,Thursday,9,1318
5717,GLEN,2016-06-09 10:00:00,521,113,Thursday,10,634
5718,GLEN,2016-06-09 11:00:00,301,164,Thursday,11,465
5719,GLEN,2016-06-09 12:00:00,276,165,Thursday,12,441
5720,GLEN,2016-06-09 13:00:00,240,203,Thursday,13,443
5721,GLEN,2016-06-09 14:00:00,253,299,Thursday,14,552
5722,GLEN,2016-06-09 15:00:00,262,394,Thursday,15,656
5723,GLEN,2016-06-09 16:00:00,339,777,Thursday,16,1116
5724,GLEN,2016-06-09 17:00:00,426,1367,Thursday,17,1793
5725,GLEN,2016-06-09 18:00:00,409,1363,Thursday,18,1772
5726,GLEN,2016-06-09 19:00:00,218,621,Thursday,19,839
5727,GLEN,2016-06-09 20:00:00,94,451,Thursday,20,545
5728,GLEN,2016-06-09 21:00:00,95,421,Thursday,21,516
5729,GLEN,2016-06-09 22:00:00,74,252,Thursday,22,326
5730,GLEN,2016-06-09 23:00:00,34,271,Thursday,23,305
5731,GLEN,2016-06-10 00:00:00,27,77,Friday,0,104
5732,GLEN,2016-06-10 01:00:00,3,11,Friday,1,14
5733,GLEN,2016-06-10 04:00:00,36,1,Friday,4,37
5734,GLEN,2016-06-10 05:00:00,82,18,Friday,5,100
5735,GLEN,2016-06-10 06:00:00,320,107,Friday,6,427
5736,GLEN,2016-06-10 07:00:00,852,220,Friday,7,1072
5737,GLEN,2016-06-10 08:00:00,1587,233,Friday,8,1820
5738,GLEN,2016-06-10 09:00:00,1126,164,Friday,9,1290
5739,GLEN,2016-06-10 10:00:00,492,137,Friday,10,629
5740,GLEN,2016-06-10 11:00:00,318,140,Friday,11,458
5741,GLEN,2016-06-10 12:00:00,300,202,Friday,12,502
5742,GLEN,2016-06-10 13:00:00,270,255,Friday,13,525
5743,GLEN,2016-06-10 14:00:00,258,320,Friday,14,578
5744,GLEN,2016-06-10 15:00:00,307,505,Friday,15,812
5745,GLEN,2016-06-10 16:00:00,360,803,Friday,16,1163
5746,GLEN,2016-06-10 17:00:00,488,1329,Friday,17,1817
5747,GLEN,2016-06-10 18:00:00,436,997,Friday,18,1433
5748,GLEN,2016-06-10 19:00:00,245,449,Friday,19,694
5749,GLEN,2016-06-10 20:00:00,118,300,Friday,20,418
5750,GLEN,2016-06-10 21:00:00,106,326,Friday,21,432
5751,GLEN,2016-06-10 22:00:00,83,363,Friday,22,446
5752,GLEN,2016-06-10 23:00:00,69,228,Friday,23,297
5753,GLEN,2016-06-11 00:00:00,26,153,Saturday,0,179
5754,GLEN,2016-06-11 01:00:00,2,19,Saturday,1,21
5755,GLEN,2016-06-11 06:00:00,59,18,Saturday,6,77
5756,GLEN,2016-06-11 07:00:00,163,44,Saturday,7,207
5757,GLEN,2016-06-11 08:00:00,230,61,Saturday,8,291
5758,GLEN,2016-06-11 09:00:00,310,116,Saturday,9,426
5759,GLEN,2016-06-11 10:00:00,358,98,Saturday,10,456
5760,GLEN,2016-06-11 11:00:00,347,150,Saturday,11,497
5761,GLEN,2016-06-11 12:00:00,313,175,Saturday,12,488
5762,GLEN,2016-06-11 13:00:00,327,214,Saturday,13,541
5763,GLEN,2016-06-11 14:00:00,305,244,Saturday,14,549
5764,GLEN,2016-06-11 15:00:00,289,317,Saturday,15,606
5765,GLEN,2016-06-11 16:00:00,217,344,Saturday,16,561
5766,GLEN,2016-06-11 17:00:00,189,383,Saturday,17,572
5767,GLEN,2016-06-11 18:00:00,243,321,Saturday,18,564
5768,GLEN,2016-06-11 19:00:00,191,256,Saturday,19,447
5769,GLEN,2016-06-11 20:00:00,123,235,Saturday,20,358
5770,GLEN,2016-06-11 21:00:00,76,223,Saturday,21,299
5771,GLEN,2016-06-11 22:00:00,82,195,Saturday,22,277
5772,GLEN,2016-06-11 23:00:00,74,192,Saturday,23,266
5773,GLEN,2016-06-12 00:00:00,28,116,Sunday,0,144
5774,GLEN,2016-06-12 01:00:00,7,9,Sunday,1,16
5775,GLEN,2016-06-12 08:00:00,144,33,Sunday,8,177
5776,GLEN,2016-06-12 09:00:00,191,68,Sunday,9,259
5777,GLEN,2016-06-12 10:00:00,229,87,Sunday,10,316
5778,GLEN,2016-06-12 11:00:00,293,109,Sunday,11,402
5779,GLEN,2016-06-12 12:00:00,314,125,Sunday,12,439
5780,GLEN,2016-06-12 13:00:00,247,163,Sunday,13,410
5781,GLEN,2016-06-12 14:00:00,255,236,Sunday,14,491
5782,GLEN,2016-06-12 15:00:00,243,226,Sunday,15,469
5783,GLEN,2016-06-12 16:00:00,223,301,Sunday,16,524
5784,GLEN,2016-06-12 17:00:00,190,279,Sunday,17,469
5785,GLEN,2016-06-12 18:00:00,162,294,Sunday,18,456
5786,GLEN,2016-06-12 19:00:00,116,275,Sunday,19,391
5787,GLEN,2016-06-12 20:00:00,81,208,Sunday,20,289
5788,GLEN,2016-06-12 21:00:00,75,228,Sunday,21,303
5789,GLEN,2016-06-12 22:00:00,64,164,Sunday,22,228
5790,GLEN,2016-06-12 23:00:00,30,106,Sunday,23,136
5791,GLEN,2016-06-13 00:00:00,11,82,Monday,0,93
5792,GLEN,2016-06-13 05:00:00,106,12,Monday,5,118
5793,GLEN,2016-06-13 06:00:00,290,106,Monday,6,396
5794,GLEN,2016-06-13 07:00:00,933,232,Monday,7,1165
5795,GLEN,2016-06-13 08:00:00,1706,251,Monday,8,1957
5796,GLEN,2016-06-13 09:00:00,1204,181,Monday,9,1385
5797,GLEN,2016-06-13 10:00:00,496,95,Monday,10,591
5798,GLEN,2016-06-13 11:00:00,318,143,Monday,11,461
5799,GLEN,2016-06-13 12:00:00,251,187,Monday,12,438
5800,GLEN,2016-06-13 13:00:00,229,216,Monday,13,445
5801,GLEN,2016-06-13 14:00:00,262,309,Monday,14,571
5802,GLEN,2016-06-13 15:00:00,299,375,Monday,15,674
5803,GLEN,2016-06-13 16:00:00,315,751,Monday,16,1066
5804,GLEN,2016-06-13 17:00:00,434,1646,Monday,17,2080
5805,GLEN,2016-06-13 18:00:00,405,1110,Monday,18,1515
5806,GLEN,2016-06-13 19:00:00,154,630,Monday,19,784
5807,GLEN,2016-06-13 20:00:00,77,338,Monday,20,415
5808,GLEN,2016-06-13 21:00:00,79,435,Monday,21,514
5809,GLEN,2016-06-13 22:00:00,62,300,Monday,22,362
5810,GLEN,2016-06-13 23:00:00,40,196,Monday,23,236
5811,GLEN,2016-06-14 00:00:00,14,63,Tuesday,0,77
5812,GLEN,2016-06-14 01:00:00,2,20,Tuesday,1,22
5813,GLEN,2016-06-14 05:00:00,116,18,Tuesday,5,134
5814,GLEN,2016-06-14 06:00:00,347,127,Tuesday,6,474
5815,GLEN,2016-06-14 07:00:00,993,221,Tuesday,7,1214
5816,GLEN,2016-06-14 08:00:00,1877,236,Tuesday,8,2113
5817,GLEN,2016-06-14 09:00:00,1173,147,Tuesday,9,1320
5818,GLEN,2016-06-14 10:00:00,525,111,Tuesday,10,636
5819,GLEN,2016-06-14 11:00:00,319,154,Tuesday,11,473
5820,GLEN,2016-06-14 12:00:00,250,165,Tuesday,12,415
5821,GLEN,2016-06-14 13:00:00,234,262,Tuesday,13,496
5822,GLEN,2016-06-14 14:00:00,284,324,Tuesday,14,608
5823,GLEN,2016-06-14 15:00:00,269,390,Tuesday,15,659
5824,GLEN,2016-06-14 16:00:00,318,690,Tuesday,16,1008
5825,GLEN,2016-06-14 17:00:00,416,1455,Tuesday,17,1871
5826,GLEN,2016-06-14 18:00:00,435,1330,Tuesday,18,1765
5827,GLEN,2016-06-14 19:00:00,228,649,Tuesday,19,877
5828,GLEN,2016-06-14 20:00:00,100,451,Tuesday,20,551
5829,GLEN,2016-06-14 21:00:00,74,378,Tuesday,21,452
5830,GLEN,2016-06-14 22:00:00,82,290,Tuesday,22,372
5831,GLEN,2016-06-14 23:00:00,31,233,Tuesday,23,264
5832,HAYW,2016-06-01 04:00:00,3,4,Wednesday,4,7
5833,HAYW,2016-06-01 05:00:00,140,43,Wednesday,5,183
5834,HAYW,2016-06-01 06:00:00,423,139,Wednesday,6,562
5835,HAYW,2016-06-01 07:00:00,831,283,Wednesday,7,1114
5836,HAYW,2016-06-01 08:00:00,930,312,Wednesday,8,1242
5837,HAYW,2016-06-01 09:00:00,484,203,Wednesday,9,687
5838,HAYW,2016-06-01 10:00:00,282,176,Wednesday,10,458
5839,HAYW,2016-06-01 11:00:00,209,160,Wednesday,11,369
5840,HAYW,2016-06-01 12:00:00,217,172,Wednesday,12,389
5841,HAYW,2016-06-01 13:00:00,155,218,Wednesday,13,373
5842,HAYW,2016-06-01 14:00:00,176,283,Wednesday,14,459
5843,HAYW,2016-06-01 15:00:00,193,370,Wednesday,15,563
5844,HAYW,2016-06-01 16:00:00,277,542,Wednesday,16,819
5845,HAYW,2016-06-01 17:00:00,283,668,Wednesday,17,951
5846,HAYW,2016-06-01 18:00:00,302,966,Wednesday,18,1268
5847,HAYW,2016-06-01 19:00:00,173,474,Wednesday,19,647
5848,HAYW,2016-06-01 20:00:00,143,173,Wednesday,20,316
5849,HAYW,2016-06-01 21:00:00,97,143,Wednesday,21,240
5850,HAYW,2016-06-01 22:00:00,79,109,Wednesday,22,188
5851,HAYW,2016-06-01 23:00:00,46,76,Wednesday,23,122
5852,HAYW,2016-06-02 00:00:00,14,28,Thursday,0,42
5853,HAYW,2016-06-02 04:00:00,6,3,Thursday,4,9
5854,HAYW,2016-06-02 05:00:00,135,44,Thursday,5,179
5855,HAYW,2016-06-02 06:00:00,427,114,Thursday,6,541
5856,HAYW,2016-06-02 07:00:00,804,272,Thursday,7,1076
5857,HAYW,2016-06-02 08:00:00,885,284,Thursday,8,1169
5858,HAYW,2016-06-02 09:00:00,612,223,Thursday,9,835
5859,HAYW,2016-06-02 10:00:00,283,127,Thursday,10,410
5860,HAYW,2016-06-02 11:00:00,225,218,Thursday,11,443
5861,HAYW,2016-06-02 12:00:00,193,170,Thursday,12,363
5862,HAYW,2016-06-02 13:00:00,165,196,Thursday,13,361
5863,HAYW,2016-06-02 14:00:00,232,203,Thursday,14,435
5864,HAYW,2016-06-02 15:00:00,218,249,Thursday,15,467
5865,HAYW,2016-06-02 16:00:00,304,246,Thursday,16,550
5866,HAYW,2016-06-02 17:00:00,306,940,Thursday,17,1246
5867,HAYW,2016-06-02 18:00:00,235,772,Thursday,18,1007
5868,HAYW,2016-06-02 19:00:00,218,421,Thursday,19,639
5869,HAYW,2016-06-02 20:00:00,96,183,Thursday,20,279
5870,HAYW,2016-06-02 21:00:00,95,260,Thursday,21,355
5871,HAYW,2016-06-02 22:00:00,94,139,Thursday,22,233
5872,HAYW,2016-06-02 23:00:00,43,88,Thursday,23,131
5873,HAYW,2016-06-03 00:00:00,23,63,Friday,0,86
5874,HAYW,2016-06-03 01:00:00,3,12,Friday,1,15
5875,HAYW,2016-06-03 04:00:00,7,3,Friday,4,10
5876,HAYW,2016-06-03 05:00:00,120,47,Friday,5,167
5877,HAYW,2016-06-03 06:00:00,359,102,Friday,6,461
5878,HAYW,2016-06-03 07:00:00,765,241,Friday,7,1006
5879,HAYW,2016-06-03 08:00:00,806,223,Friday,8,1029
5880,HAYW,2016-06-03 09:00:00,448,171,Friday,9,619
5881,HAYW,2016-06-03 10:00:00,281,112,Friday,10,393
5882,HAYW,2016-06-03 11:00:00,200,156,Friday,11,356
5883,HAYW,2016-06-03 12:00:00,181,173,Friday,12,354
5884,HAYW,2016-06-03 13:00:00,190,175,Friday,13,365
5885,HAYW,2016-06-03 14:00:00,218,187,Friday,14,405
5886,HAYW,2016-06-03 15:00:00,214,331,Friday,15,545
5887,HAYW,2016-06-03 16:00:00,204,489,Friday,16,693
5888,HAYW,2016-06-03 17:00:00,253,787,Friday,17,1040
5889,HAYW,2016-06-03 18:00:00,244,648,Friday,18,892
5890,HAYW,2016-06-03 19:00:00,169,390,Friday,19,559
5891,HAYW,2016-06-03 20:00:00,127,162,Friday,20,289
5892,HAYW,2016-06-03 21:00:00,103,150,Friday,21,253
5893,HAYW,2016-06-03 22:00:00,71,183,Friday,22,254
5894,HAYW,2016-06-03 23:00:00,67,106,Friday,23,173
5895,HAYW,2016-06-04 00:00:00,27,82,Saturday,0,109
5896,HAYW,2016-06-04 01:00:00,8,28,Saturday,1,36
5897,HAYW,2016-06-04 06:00:00,30,25,Saturday,6,55
5898,HAYW,2016-06-04 07:00:00,88,54,Saturday,7,142
5899,HAYW,2016-06-04 08:00:00,119,79,Saturday,8,198
5900,HAYW,2016-06-04 09:00:00,156,74,Saturday,9,230
5901,HAYW,2016-06-04 10:00:00,141,84,Saturday,10,225
5902,HAYW,2016-06-04 11:00:00,175,86,Saturday,11,261
5903,HAYW,2016-06-04 12:00:00,175,116,Saturday,12,291
5904,HAYW,2016-06-04 13:00:00,195,114,Saturday,13,309
5905,HAYW,2016-06-04 14:00:00,158,153,Saturday,14,311
5906,HAYW,2016-06-04 15:00:00,127,117,Saturday,15,244
5907,HAYW,2016-06-04 16:00:00,111,150,Saturday,16,261
5908,HAYW,2016-06-04 17:00:00,121,168,Saturday,17,289
5909,HAYW,2016-06-04 18:00:00,133,189,Saturday,18,322
5910,HAYW,2016-06-04 19:00:00,94,183,Saturday,19,277
5911,HAYW,2016-06-04 20:00:00,66,118,Saturday,20,184
5912,HAYW,2016-06-04 21:00:00,59,101,Saturday,21,160
5913,HAYW,2016-06-04 22:00:00,79,90,Saturday,22,169
5914,HAYW,2016-06-04 23:00:00,34,83,Saturday,23,117
5915,HAYW,2016-06-05 00:00:00,22,54,Sunday,0,76
5916,HAYW,2016-06-05 01:00:00,3,23,Sunday,1,26
5917,HAYW,2016-06-05 08:00:00,79,44,Sunday,8,123
5918,HAYW,2016-06-05 09:00:00,99,65,Sunday,9,164
5919,HAYW,2016-06-05 10:00:00,105,55,Sunday,10,160
5920,HAYW,2016-06-05 11:00:00,127,59,Sunday,11,186
5921,HAYW,2016-06-05 12:00:00,109,68,Sunday,12,177
5922,HAYW,2016-06-05 13:00:00,113,89,Sunday,13,202
5923,HAYW,2016-06-05 14:00:00,130,71,Sunday,14,201
5924,HAYW,2016-06-05 15:00:00,130,88,Sunday,15,218
5925,HAYW,2016-06-05 16:00:00,144,131,Sunday,16,275
5926,HAYW,2016-06-05 17:00:00,88,132,Sunday,17,220
5927,HAYW,2016-06-05 18:00:00,57,98,Sunday,18,155
5928,HAYW,2016-06-05 19:00:00,59,118,Sunday,19,177
5929,HAYW,2016-06-05 20:00:00,50,147,Sunday,20,197
5930,HAYW,2016-06-05 21:00:00,70,87,Sunday,21,157
5931,HAYW,2016-06-05 22:00:00,45,80,Sunday,22,125
5932,HAYW,2016-06-05 23:00:00,33,48,Sunday,23,81
5933,HAYW,2016-06-06 00:00:00,13,41,Monday,0,54
5934,HAYW,2016-06-06 01:00:00,1,13,Monday,1,14
5935,HAYW,2016-06-06 04:00:00,11,5,Monday,4,16
5936,HAYW,2016-06-06 05:00:00,130,50,Monday,5,180
5937,HAYW,2016-06-06 06:00:00,362,132,Monday,6,494
5938,HAYW,2016-06-06 07:00:00,812,259,Monday,7,1071
5939,HAYW,2016-06-06 08:00:00,862,261,Monday,8,1123
5940,HAYW,2016-06-06 09:00:00,517,195,Monday,9,712
5941,HAYW,2016-06-06 10:00:00,275,137,Monday,10,412
5942,HAYW,2016-06-06 11:00:00,185,145,Monday,11,330
5943,HAYW,2016-06-06 12:00:00,155,159,Monday,12,314
5944,HAYW,2016-06-06 13:00:00,191,231,Monday,13,422
5945,HAYW,2016-06-06 14:00:00,174,198,Monday,14,372
5946,HAYW,2016-06-06 15:00:00,172,317,Monday,15,489
5947,HAYW,2016-06-06 16:00:00,231,536,Monday,16,767
5948,HAYW,2016-06-06 17:00:00,312,847,Monday,17,1159
5949,HAYW,2016-06-06 18:00:00,232,761,Monday,18,993
5950,HAYW,2016-06-06 19:00:00,172,406,Monday,19,578
5951,HAYW,2016-06-06 20:00:00,93,191,Monday,20,284
5952,HAYW,2016-06-06 21:00:00,104,130,Monday,21,234
5953,HAYW,2016-06-06 22:00:00,52,117,Monday,22,169
5954,HAYW,2016-06-06 23:00:00,39,86,Monday,23,125
5955,HAYW,2016-06-07 00:00:00,9,54,Tuesday,0,63
5956,HAYW,2016-06-07 01:00:00,5,6,Tuesday,1,11
5957,HAYW,2016-06-07 04:00:00,6,3,Tuesday,4,9
5958,HAYW,2016-06-07 05:00:00,136,69,Tuesday,5,205
5959,HAYW,2016-06-07 06:00:00,412,116,Tuesday,6,528
5960,HAYW,2016-06-07 07:00:00,801,224,Tuesday,7,1025
5961,HAYW,2016-06-07 08:00:00,949,237,Tuesday,8,1186
5962,HAYW,2016-06-07 09:00:00,551,189,Tuesday,9,740
5963,HAYW,2016-06-07 10:00:00,291,164,Tuesday,10,455
5964,HAYW,2016-06-07 11:00:00,207,143,Tuesday,11,350
5965,HAYW,2016-06-07 12:00:00,168,151,Tuesday,12,319
5966,HAYW,2016-06-07 13:00:00,174,183,Tuesday,13,357
5967,HAYW,2016-06-07 14:00:00,187,249,Tuesday,14,436
5968,HAYW,2016-06-07 15:00:00,187,387,Tuesday,15,574
5969,HAYW,2016-06-07 16:00:00,241,518,Tuesday,16,759
5970,HAYW,2016-06-07 17:00:00,295,877,Tuesday,17,1172
5971,HAYW,2016-06-07 18:00:00,246,786,Tuesday,18,1032
5972,HAYW,2016-06-07 19:00:00,186,440,Tuesday,19,626
5973,HAYW,2016-06-07 20:00:00,70,155,Tuesday,20,225
5974,HAYW,2016-06-07 21:00:00,75,147,Tuesday,21,222
5975,HAYW,2016-06-07 22:00:00,58,126,Tuesday,22,184
5976,HAYW,2016-06-07 23:00:00,31,83,Tuesday,23,114
5977,HAYW,2016-06-08 00:00:00,17,66,Wednesday,0,83
5978,HAYW,2016-06-08 01:00:00,5,8,Wednesday,1,13
5979,HAYW,2016-06-08 04:00:00,6,5,Wednesday,4,11
5980,HAYW,2016-06-08 05:00:00,146,59,Wednesday,5,205
5981,HAYW,2016-06-08 06:00:00,424,119,Wednesday,6,543
5982,HAYW,2016-06-08 07:00:00,804,209,Wednesday,7,1013
5983,HAYW,2016-06-08 08:00:00,853,266,Wednesday,8,1119
5984,HAYW,2016-06-08 09:00:00,629,179,Wednesday,9,808
5985,HAYW,2016-06-08 10:00:00,282,143,Wednesday,10,425
5986,HAYW,2016-06-08 11:00:00,212,144,Wednesday,11,356
5987,HAYW,2016-06-08 12:00:00,196,144,Wednesday,12,340
5988,HAYW,2016-06-08 13:00:00,192,205,Wednesday,13,397
5989,HAYW,2016-06-08 14:00:00,202,234,Wednesday,14,436
5990,HAYW,2016-06-08 15:00:00,166,335,Wednesday,15,501
5991,HAYW,2016-06-08 16:00:00,231,568,Wednesday,16,799
5992,HAYW,2016-06-08 17:00:00,348,865,Wednesday,17,1213
5993,HAYW,2016-06-08 18:00:00,259,795,Wednesday,18,1054
5994,HAYW,2016-06-08 19:00:00,125,378,Wednesday,19,503
5995,HAYW,2016-06-08 20:00:00,84,193,Wednesday,20,277
5996,HAYW,2016-06-08 21:00:00,67,242,Wednesday,21,309
5997,HAYW,2016-06-08 22:00:00,69,108,Wednesday,22,177
5998,HAYW,2016-06-08 23:00:00,29,104,Wednesday,23,133
5999,HAYW,2016-06-09 00:00:00,18,56,Thursday,0,74
6000,HAYW,2016-06-09 01:00:00,4,7,Thursday,1,11
6001,HAYW,2016-06-09 04:00:00,6,5,Thursday,4,11
6002,HAYW,2016-06-09 05:00:00,158,55,Thursday,5,213
6003,HAYW,2016-06-09 06:00:00,396,104,Thursday,6,500
6004,HAYW,2016-06-09 07:00:00,691,205,Thursday,7,896
6005,HAYW,2016-06-09 08:00:00,974,230,Thursday,8,1204
6006,HAYW,2016-06-09 09:00:00,474,172,Thursday,9,646
6007,HAYW,2016-06-09 10:00:00,249,125,Thursday,10,374
6008,HAYW,2016-06-09 11:00:00,185,140,Thursday,11,325
6009,HAYW,2016-06-09 12:00:00,188,169,Thursday,12,357
6010,HAYW,2016-06-09 13:00:00,177,207,Thursday,13,384
6011,HAYW,2016-06-09 14:00:00,176,196,Thursday,14,372
6012,HAYW,2016-06-09 15:00:00,175,283,Thursday,15,458
6013,HAYW,2016-06-09 16:00:00,247,551,Thursday,16,798
6014,HAYW,2016-06-09 17:00:00,268,849,Thursday,17,1117
6015,HAYW,2016-06-09 18:00:00,234,726,Thursday,18,960
6016,HAYW,2016-06-09 19:00:00,145,440,Thursday,19,585
6017,HAYW,2016-06-09 20:00:00,85,195,Thursday,20,280
6018,HAYW,2016-06-09 21:00:00,83,159,Thursday,21,242
6019,HAYW,2016-06-09 22:00:00,57,125,Thursday,22,182
6020,HAYW,2016-06-09 23:00:00,40,90,Thursday,23,130
6021,HAYW,2016-06-10 00:00:00,23,55,Friday,0,78
6022,HAYW,2016-06-10 01:00:00,6,10,Friday,1,16
6023,HAYW,2016-06-10 04:00:00,9,2,Friday,4,11
6024,HAYW,2016-06-10 05:00:00,138,46,Friday,5,184
6025,HAYW,2016-06-10 06:00:00,357,100,Friday,6,457
6026,HAYW,2016-06-10 07:00:00,691,195,Friday,7,886
6027,HAYW,2016-06-10 08:00:00,785,168,Friday,8,953
6028,HAYW,2016-06-10 09:00:00,486,121,Friday,9,607
6029,HAYW,2016-06-10 10:00:00,468,117,Friday,10,585
6030,HAYW,2016-06-10 11:00:00,177,109,Friday,11,286
6031,HAYW,2016-06-10 12:00:00,170,165,Friday,12,335
6032,HAYW,2016-06-10 13:00:00,194,193,Friday,13,387
6033,HAYW,2016-06-10 14:00:00,187,207,Friday,14,394
6034,HAYW,2016-06-10 15:00:00,246,497,Friday,15,743
6035,HAYW,2016-06-10 16:00:00,202,345,Friday,16,547
6036,HAYW,2016-06-10 17:00:00,337,929,Friday,17,1266
6037,HAYW,2016-06-10 18:00:00,267,615,Friday,18,882
6038,HAYW,2016-06-10 19:00:00,134,306,Friday,19,440
6039,HAYW,2016-06-10 20:00:00,88,155,Friday,20,243
6040,HAYW,2016-06-10 21:00:00,84,257,Friday,21,341
6041,HAYW,2016-06-10 22:00:00,79,152,Friday,22,231
6042,HAYW,2016-06-10 23:00:00,44,148,Friday,23,192
6043,HAYW,2016-06-11 00:00:00,23,72,Saturday,0,95
6044,HAYW,2016-06-11 01:00:00,1,14,Saturday,1,15
6045,HAYW,2016-06-11 06:00:00,27,21,Saturday,6,48
6046,HAYW,2016-06-11 07:00:00,61,53,Saturday,7,114
6047,HAYW,2016-06-11 08:00:00,102,100,Saturday,8,202
6048,HAYW,2016-06-11 09:00:00,138,111,Saturday,9,249
6049,HAYW,2016-06-11 10:00:00,156,86,Saturday,10,242
6050,HAYW,2016-06-11 11:00:00,151,82,Saturday,11,233
6051,HAYW,2016-06-11 12:00:00,157,79,Saturday,12,236
6052,HAYW,2016-06-11 13:00:00,137,131,Saturday,13,268
6053,HAYW,2016-06-11 14:00:00,177,108,Saturday,14,285
6054,HAYW,2016-06-11 15:00:00,136,135,Saturday,15,271
6055,HAYW,2016-06-11 16:00:00,119,138,Saturday,16,257
6056,HAYW,2016-06-11 17:00:00,135,169,Saturday,17,304
6057,HAYW,2016-06-11 18:00:00,103,147,Saturday,18,250
6058,HAYW,2016-06-11 19:00:00,75,151,Saturday,19,226
6059,HAYW,2016-06-11 20:00:00,57,106,Saturday,20,163
6060,HAYW,2016-06-11 21:00:00,65,87,Saturday,21,152
6061,HAYW,2016-06-11 22:00:00,73,131,Saturday,22,204
6062,HAYW,2016-06-11 23:00:00,40,82,Saturday,23,122
6063,HAYW,2016-06-12 00:00:00,18,86,Sunday,0,104
6064,HAYW,2016-06-12 01:00:00,6,22,Sunday,1,28
6065,HAYW,2016-06-12 08:00:00,51,32,Sunday,8,83
6066,HAYW,2016-06-12 09:00:00,90,67,Sunday,9,157
6067,HAYW,2016-06-12 10:00:00,123,60,Sunday,10,183
6068,HAYW,2016-06-12 11:00:00,144,61,Sunday,11,205
6069,HAYW,2016-06-12 12:00:00,83,69,Sunday,12,152
6070,HAYW,2016-06-12 13:00:00,138,66,Sunday,13,204
6071,HAYW,2016-06-12 14:00:00,84,78,Sunday,14,162
6072,HAYW,2016-06-12 15:00:00,119,79,Sunday,15,198
6073,HAYW,2016-06-12 16:00:00,78,120,Sunday,16,198
6074,HAYW,2016-06-12 17:00:00,99,105,Sunday,17,204
6075,HAYW,2016-06-12 18:00:00,66,99,Sunday,18,165
6076,HAYW,2016-06-12 19:00:00,102,108,Sunday,19,210
6077,HAYW,2016-06-12 20:00:00,58,100,Sunday,20,158
6078,HAYW,2016-06-12 21:00:00,73,109,Sunday,21,182
6079,HAYW,2016-06-12 22:00:00,37,90,Sunday,22,127
6080,HAYW,2016-06-12 23:00:00,27,100,Sunday,23,127
6081,HAYW,2016-06-13 00:00:00,15,40,Monday,0,55
6082,HAYW,2016-06-13 01:00:00,3,7,Monday,1,10
6083,HAYW,2016-06-13 04:00:00,6,3,Monday,4,9
6084,HAYW,2016-06-13 05:00:00,142,43,Monday,5,185
6085,HAYW,2016-06-13 06:00:00,371,111,Monday,6,482
6086,HAYW,2016-06-13 07:00:00,771,198,Monday,7,969
6087,HAYW,2016-06-13 08:00:00,932,192,Monday,8,1124
6088,HAYW,2016-06-13 09:00:00,473,155,Monday,9,628
6089,HAYW,2016-06-13 10:00:00,242,109,Monday,10,351
6090,HAYW,2016-06-13 11:00:00,208,113,Monday,11,321
6091,HAYW,2016-06-13 12:00:00,141,149,Monday,12,290
6092,HAYW,2016-06-13 13:00:00,185,188,Monday,13,373
6093,HAYW,2016-06-13 14:00:00,136,189,Monday,14,325
6094,HAYW,2016-06-13 15:00:00,177,310,Monday,15,487
6095,HAYW,2016-06-13 16:00:00,250,538,Monday,16,788
6096,HAYW,2016-06-13 17:00:00,306,869,Monday,17,1175
6097,HAYW,2016-06-13 18:00:00,281,716,Monday,18,997
6098,HAYW,2016-06-13 19:00:00,143,374,Monday,19,517
6099,HAYW,2016-06-13 20:00:00,63,158,Monday,20,221
6100,HAYW,2016-06-13 21:00:00,52,238,Monday,21,290
6101,HAYW,2016-06-13 22:00:00,52,199,Monday,22,251
6102,HAYW,2016-06-13 23:00:00,39,125,Monday,23,164
6103,HAYW,2016-06-14 00:00:00,15,81,Tuesday,0,96
6104,HAYW,2016-06-14 01:00:00,5,6,Tuesday,1,11
6105,HAYW,2016-06-14 04:00:00,8,1,Tuesday,4,9
6106,HAYW,2016-06-14 05:00:00,138,54,Tuesday,5,192
6107,HAYW,2016-06-14 06:00:00,399,113,Tuesday,6,512
6108,HAYW,2016-06-14 07:00:00,717,196,Tuesday,7,913
6109,HAYW,2016-06-14 08:00:00,794,228,Tuesday,8,1022
6110,HAYW,2016-06-14 09:00:00,632,146,Tuesday,9,778
6111,HAYW,2016-06-14 10:00:00,263,124,Tuesday,10,387
6112,HAYW,2016-06-14 11:00:00,200,109,Tuesday,11,309
6113,HAYW,2016-06-14 12:00:00,168,138,Tuesday,12,306
6114,HAYW,2016-06-14 13:00:00,177,156,Tuesday,13,333
6115,HAYW,2016-06-14 14:00:00,153,175,Tuesday,14,328
6116,HAYW,2016-06-14 15:00:00,156,309,Tuesday,15,465
6117,HAYW,2016-06-14 16:00:00,193,521,Tuesday,16,714
6118,HAYW,2016-06-14 17:00:00,294,841,Tuesday,17,1135
6119,HAYW,2016-06-14 18:00:00,248,735,Tuesday,18,983
6120,HAYW,2016-06-14 19:00:00,146,503,Tuesday,19,649
6121,HAYW,2016-06-14 20:00:00,68,172,Tuesday,20,240
6122,HAYW,2016-06-14 21:00:00,66,135,Tuesday,21,201
6123,HAYW,2016-06-14 22:00:00,58,131,Tuesday,22,189
6124,HAYW,2016-06-14 23:00:00,39,100,Tuesday,23,139
6125,LAFY,2016-06-01 04:00:00,4,3,Wednesday,4,7
6126,LAFY,2016-06-01 05:00:00,148,10,Wednesday,5,158
6127,LAFY,2016-06-01 06:00:00,277,43,Wednesday,6,320
6128,LAFY,2016-06-01 07:00:00,732,89,Wednesday,7,821
6129,LAFY,2016-06-01 08:00:00,866,92,Wednesday,8,958
6130,LAFY,2016-06-01 09:00:00,421,79,Wednesday,9,500
6131,LAFY,2016-06-01 10:00:00,266,42,Wednesday,10,308
6132,LAFY,2016-06-01 11:00:00,114,40,Wednesday,11,154
6133,LAFY,2016-06-01 12:00:00,85,46,Wednesday,12,131
6134,LAFY,2016-06-01 13:00:00,59,114,Wednesday,13,173
6135,LAFY,2016-06-01 14:00:00,69,95,Wednesday,14,164
6136,LAFY,2016-06-01 15:00:00,113,311,Wednesday,15,424
6137,LAFY,2016-06-01 16:00:00,108,473,Wednesday,16,581
6138,LAFY,2016-06-01 17:00:00,130,775,Wednesday,17,905
6139,LAFY,2016-06-01 18:00:00,101,848,Wednesday,18,949
6140,LAFY,2016-06-01 19:00:00,72,300,Wednesday,19,372
6141,LAFY,2016-06-01 20:00:00,37,213,Wednesday,20,250
6142,LAFY,2016-06-01 21:00:00,46,131,Wednesday,21,177
6143,LAFY,2016-06-01 22:00:00,43,72,Wednesday,22,115
6144,LAFY,2016-06-01 23:00:00,15,67,Wednesday,23,82
6145,LAFY,2016-06-02 00:00:00,9,23,Thursday,0,32
6146,LAFY,2016-06-02 04:00:00,3,5,Thursday,4,8
6147,LAFY,2016-06-02 05:00:00,120,10,Thursday,5,130
6148,LAFY,2016-06-02 06:00:00,294,39,Thursday,6,333
6149,LAFY,2016-06-02 07:00:00,677,84,Thursday,7,761
6150,LAFY,2016-06-02 08:00:00,928,101,Thursday,8,1029
6151,LAFY,2016-06-02 09:00:00,416,67,Thursday,9,483
6152,LAFY,2016-06-02 10:00:00,226,60,Thursday,10,286
6153,LAFY,2016-06-02 11:00:00,128,56,Thursday,11,184
6154,LAFY,2016-06-02 12:00:00,75,74,Thursday,12,149
6155,LAFY,2016-06-02 13:00:00,71,101,Thursday,13,172
6156,LAFY,2016-06-02 14:00:00,74,154,Thursday,14,228
6157,LAFY,2016-06-02 15:00:00,118,245,Thursday,15,363
6158,LAFY,2016-06-02 16:00:00,141,425,Thursday,16,566
6159,LAFY,2016-06-02 17:00:00,179,960,Thursday,17,1139
6160,LAFY,2016-06-02 18:00:00,120,792,Thursday,18,912
6161,LAFY,2016-06-02 19:00:00,62,207,Thursday,19,269
6162,LAFY,2016-06-02 20:00:00,41,231,Thursday,20,272
6163,LAFY,2016-06-02 21:00:00,43,185,Thursday,21,228
6164,LAFY,2016-06-02 22:00:00,29,107,Thursday,22,136
6165,LAFY,2016-06-02 23:00:00,22,60,Thursday,23,82
6166,LAFY,2016-06-03 00:00:00,6,16,Friday,0,22
6167,LAFY,2016-06-03 04:00:00,1,5,Friday,4,6
6168,LAFY,2016-06-03 05:00:00,100,12,Friday,5,112
6169,LAFY,2016-06-03 06:00:00,241,40,Friday,6,281
6170,LAFY,2016-06-03 07:00:00,588,92,Friday,7,680
6171,LAFY,2016-06-03 08:00:00,689,99,Friday,8,788
6172,LAFY,2016-06-03 09:00:00,684,58,Friday,9,742
6173,LAFY,2016-06-03 10:00:00,211,54,Friday,10,265
6174,LAFY,2016-06-03 11:00:00,126,50,Friday,11,176
6175,LAFY,2016-06-03 12:00:00,107,92,Friday,12,199
6176,LAFY,2016-06-03 13:00:00,84,331,Friday,13,415
6177,LAFY,2016-06-03 14:00:00,61,205,Friday,14,266
6178,LAFY,2016-06-03 15:00:00,130,272,Friday,15,402
6179,LAFY,2016-06-03 16:00:00,99,470,Friday,16,569
6180,LAFY,2016-06-03 17:00:00,160,735,Friday,17,895
6181,LAFY,2016-06-03 18:00:00,123,550,Friday,18,673
6182,LAFY,2016-06-03 19:00:00,106,234,Friday,19,340
6183,LAFY,2016-06-03 20:00:00,24,126,Friday,20,150
6184,LAFY,2016-06-03 21:00:00,65,122,Friday,21,187
6185,LAFY,2016-06-03 22:00:00,36,112,Friday,22,148
6186,LAFY,2016-06-03 23:00:00,24,62,Friday,23,86
6187,LAFY,2016-06-04 00:00:00,22,51,Saturday,0,73
6188,LAFY,2016-06-04 06:00:00,29,11,Saturday,6,40
6189,LAFY,2016-06-04 07:00:00,44,40,Saturday,7,84
6190,LAFY,2016-06-04 08:00:00,64,39,Saturday,8,103
6191,LAFY,2016-06-04 09:00:00,82,47,Saturday,9,129
6192,LAFY,2016-06-04 10:00:00,74,46,Saturday,10,120
6193,LAFY,2016-06-04 11:00:00,127,48,Saturday,11,175
6194,LAFY,2016-06-04 12:00:00,111,79,Saturday,12,190
6195,LAFY,2016-06-04 13:00:00,137,65,Saturday,13,202
6196,LAFY,2016-06-04 14:00:00,73,88,Saturday,14,161
6197,LAFY,2016-06-04 15:00:00,77,100,Saturday,15,177
6198,LAFY,2016-06-04 16:00:00,83,148,Saturday,16,231
6199,LAFY,2016-06-04 17:00:00,115,97,Saturday,17,212
6200,LAFY,2016-06-04 18:00:00,99,114,Saturday,18,213
6201,LAFY,2016-06-04 19:00:00,100,93,Saturday,19,193
6202,LAFY,2016-06-04 20:00:00,66,88,Saturday,20,154
6203,LAFY,2016-06-04 21:00:00,58,73,Saturday,21,131
6204,LAFY,2016-06-04 22:00:00,43,140,Saturday,22,183
6205,LAFY,2016-06-04 23:00:00,36,59,Saturday,23,95
6206,LAFY,2016-06-05 00:00:00,10,42,Sunday,0,52
6207,LAFY,2016-06-05 01:00:00,2,11,Sunday,1,13
6208,LAFY,2016-06-05 08:00:00,48,37,Sunday,8,85
6209,LAFY,2016-06-05 09:00:00,78,44,Sunday,9,122
6210,LAFY,2016-06-05 10:00:00,68,45,Sunday,10,113
6211,LAFY,2016-06-05 11:00:00,116,63,Sunday,11,179
6212,LAFY,2016-06-05 12:00:00,95,62,Sunday,12,157
6213,LAFY,2016-06-05 13:00:00,85,66,Sunday,13,151
6214,LAFY,2016-06-05 14:00:00,86,99,Sunday,14,185
6215,LAFY,2016-06-05 15:00:00,82,93,Sunday,15,175
6216,LAFY,2016-06-05 16:00:00,70,131,Sunday,16,201
6217,LAFY,2016-06-05 17:00:00,79,104,Sunday,17,183
6218,LAFY,2016-06-05 18:00:00,59,70,Sunday,18,129
6219,LAFY,2016-06-05 19:00:00,46,64,Sunday,19,110
6220,LAFY,2016-06-05 20:00:00,49,99,Sunday,20,148
6221,LAFY,2016-06-05 21:00:00,45,47,Sunday,21,92
6222,LAFY,2016-06-05 22:00:00,28,27,Sunday,22,55
6223,LAFY,2016-06-05 23:00:00,17,20,Sunday,23,37
6224,LAFY,2016-06-06 00:00:00,4,18,Monday,0,22
6225,LAFY,2016-06-06 01:00:00,1,2,Monday,1,3
6226,LAFY,2016-06-06 04:00:00,22,2,Monday,4,24
6227,LAFY,2016-06-06 05:00:00,94,13,Monday,5,107
6228,LAFY,2016-06-06 06:00:00,312,41,Monday,6,353
6229,LAFY,2016-06-06 07:00:00,676,88,Monday,7,764
6230,LAFY,2016-06-06 08:00:00,975,109,Monday,8,1084
6231,LAFY,2016-06-06 09:00:00,461,66,Monday,9,527
6232,LAFY,2016-06-06 10:00:00,233,47,Monday,10,280
6233,LAFY,2016-06-06 11:00:00,111,53,Monday,11,164
6234,LAFY,2016-06-06 12:00:00,71,53,Monday,12,124
6235,LAFY,2016-06-06 13:00:00,60,77,Monday,13,137
6236,LAFY,2016-06-06 14:00:00,68,144,Monday,14,212
6237,LAFY,2016-06-06 15:00:00,107,232,Monday,15,339
6238,LAFY,2016-06-06 16:00:00,104,469,Monday,16,573
6239,LAFY,2016-06-06 17:00:00,118,729,Monday,17,847
6240,LAFY,2016-06-06 18:00:00,106,976,Monday,18,1082
6241,LAFY,2016-06-06 19:00:00,58,305,Monday,19,363
6242,LAFY,2016-06-06 20:00:00,42,137,Monday,20,179
6243,LAFY,2016-06-06 21:00:00,30,105,Monday,21,135
6244,LAFY,2016-06-06 22:00:00,31,82,Monday,22,113
6245,LAFY,2016-06-06 23:00:00,11,28,Monday,23,39
6246,LAFY,2016-06-07 00:00:00,9,19,Tuesday,0,28
6247,LAFY,2016-06-07 04:00:00,13,3,Tuesday,4,16
6248,LAFY,2016-06-07 05:00:00,106,15,Tuesday,5,121
6249,LAFY,2016-06-07 06:00:00,306,36,Tuesday,6,342
6250,LAFY,2016-06-07 07:00:00,622,88,Tuesday,7,710
6251,LAFY,2016-06-07 08:00:00,995,113,Tuesday,8,1108
6252,LAFY,2016-06-07 09:00:00,456,50,Tuesday,9,506
6253,LAFY,2016-06-07 10:00:00,239,39,Tuesday,10,278
6254,LAFY,2016-06-07 11:00:00,95,40,Tuesday,11,135
6255,LAFY,2016-06-07 12:00:00,74,80,Tuesday,12,154
6256,LAFY,2016-06-07 13:00:00,85,93,Tuesday,13,178
6257,LAFY,2016-06-07 14:00:00,96,140,Tuesday,14,236
6258,LAFY,2016-06-07 15:00:00,115,267,Tuesday,15,382
6259,LAFY,2016-06-07 16:00:00,95,454,Tuesday,16,549
6260,LAFY,2016-06-07 17:00:00,204,877,Tuesday,17,1081
6261,LAFY,2016-06-07 18:00:00,180,779,Tuesday,18,959
6262,LAFY,2016-06-07 19:00:00,82,315,Tuesday,19,397
6263,LAFY,2016-06-07 20:00:00,31,167,Tuesday,20,198
6264,LAFY,2016-06-07 21:00:00,38,128,Tuesday,21,166
6265,LAFY,2016-06-07 22:00:00,23,138,Tuesday,22,161
6266,LAFY,2016-06-07 23:00:00,20,161,Tuesday,23,181
6267,LAFY,2016-06-08 00:00:00,7,35,Wednesday,0,42
6268,LAFY,2016-06-08 04:00:00,16,5,Wednesday,4,21
6269,LAFY,2016-06-08 05:00:00,112,12,Wednesday,5,124
6270,LAFY,2016-06-08 06:00:00,304,41,Wednesday,6,345
6271,LAFY,2016-06-08 07:00:00,608,100,Wednesday,7,708
6272,LAFY,2016-06-08 08:00:00,949,101,Wednesday,8,1050
6273,LAFY,2016-06-08 09:00:00,431,69,Wednesday,9,500
6274,LAFY,2016-06-08 10:00:00,243,46,Wednesday,10,289
6275,LAFY,2016-06-08 11:00:00,100,44,Wednesday,11,144
6276,LAFY,2016-06-08 12:00:00,86,46,Wednesday,12,132
6277,LAFY,2016-06-08 13:00:00,69,134,Wednesday,13,203
6278,LAFY,2016-06-08 14:00:00,77,165,Wednesday,14,242
6279,LAFY,2016-06-08 15:00:00,125,248,Wednesday,15,373
6280,LAFY,2016-06-08 16:00:00,140,446,Wednesday,16,586
6281,LAFY,2016-06-08 17:00:00,239,897,Wednesday,17,1136
6282,LAFY,2016-06-08 18:00:00,163,717,Wednesday,18,880
6283,LAFY,2016-06-08 19:00:00,61,273,Wednesday,19,334
6284,LAFY,2016-06-08 20:00:00,38,145,Wednesday,20,183
6285,LAFY,2016-06-08 21:00:00,31,225,Wednesday,21,256
6286,LAFY,2016-06-08 22:00:00,24,124,Wednesday,22,148
6287,LAFY,2016-06-08 23:00:00,19,157,Wednesday,23,176
6288,LAFY,2016-06-09 00:00:00,6,26,Thursday,0,32
6289,LAFY,2016-06-09 01:00:00,3,11,Thursday,1,14
6290,LAFY,2016-06-09 04:00:00,1,4,Thursday,4,5
6291,LAFY,2016-06-09 05:00:00,115,10,Thursday,5,125
6292,LAFY,2016-06-09 06:00:00,266,42,Thursday,6,308
6293,LAFY,2016-06-09 07:00:00,615,88,Thursday,7,703
6294,LAFY,2016-06-09 08:00:00,863,111,Thursday,8,974
6295,LAFY,2016-06-09 09:00:00,425,68,Thursday,9,493
6296,LAFY,2016-06-09 10:00:00,251,63,Thursday,10,314
6297,LAFY,2016-06-09 11:00:00,141,55,Thursday,11,196
6298,LAFY,2016-06-09 12:00:00,91,74,Thursday,12,165
6299,LAFY,2016-06-09 13:00:00,90,87,Thursday,13,177
6300,LAFY,2016-06-09 14:00:00,99,143,Thursday,14,242
6301,LAFY,2016-06-09 15:00:00,100,263,Thursday,15,363
6302,LAFY,2016-06-09 16:00:00,108,446,Thursday,16,554
6303,LAFY,2016-06-09 17:00:00,146,705,Thursday,17,851
6304,LAFY,2016-06-09 18:00:00,121,786,Thursday,18,907
6305,LAFY,2016-06-09 19:00:00,69,340,Thursday,19,409
6306,LAFY,2016-06-09 20:00:00,56,167,Thursday,20,223
6307,LAFY,2016-06-09 21:00:00,34,135,Thursday,21,169
6308,LAFY,2016-06-09 22:00:00,26,105,Thursday,22,131
6309,LAFY,2016-06-09 23:00:00,16,79,Thursday,23,95
6310,LAFY,2016-06-10 00:00:00,12,24,Friday,0,36
6311,LAFY,2016-06-10 04:00:00,1,2,Friday,4,3
6312,LAFY,2016-06-10 05:00:00,98,7,Friday,5,105
6313,LAFY,2016-06-10 06:00:00,227,44,Friday,6,271
6314,LAFY,2016-06-10 07:00:00,532,75,Friday,7,607
6315,LAFY,2016-06-10 08:00:00,734,94,Friday,8,828
6316,LAFY,2016-06-10 09:00:00,341,71,Friday,9,412
6317,LAFY,2016-06-10 10:00:00,249,64,Friday,10,313
6318,LAFY,2016-06-10 11:00:00,149,56,Friday,11,205
6319,LAFY,2016-06-10 12:00:00,118,106,Friday,12,224
6320,LAFY,2016-06-10 13:00:00,106,130,Friday,13,236
6321,LAFY,2016-06-10 14:00:00,82,197,Friday,14,279
6322,LAFY,2016-06-10 15:00:00,144,310,Friday,15,454
6323,LAFY,2016-06-10 16:00:00,135,491,Friday,16,626
6324,LAFY,2016-06-10 17:00:00,242,715,Friday,17,957
6325,LAFY,2016-06-10 18:00:00,208,510,Friday,18,718
6326,LAFY,2016-06-10 19:00:00,73,200,Friday,19,273
6327,LAFY,2016-06-10 20:00:00,43,98,Friday,20,141
6328,LAFY,2016-06-10 21:00:00,40,106,Friday,21,146
6329,LAFY,2016-06-10 22:00:00,59,178,Friday,22,237
6330,LAFY,2016-06-10 23:00:00,31,166,Friday,23,197
6331,LAFY,2016-06-11 00:00:00,14,54,Saturday,0,68
6332,LAFY,2016-06-11 01:00:00,4,2,Saturday,1,6
6333,LAFY,2016-06-11 06:00:00,31,8,Saturday,6,39
6334,LAFY,2016-06-11 07:00:00,49,39,Saturday,7,88
6335,LAFY,2016-06-11 08:00:00,60,42,Saturday,8,102
6336,LAFY,2016-06-11 09:00:00,82,51,Saturday,9,133
6337,LAFY,2016-06-11 10:00:00,97,47,Saturday,10,144
6338,LAFY,2016-06-11 11:00:00,146,43,Saturday,11,189
6339,LAFY,2016-06-11 12:00:00,119,60,Saturday,12,179
6340,LAFY,2016-06-11 13:00:00,139,69,Saturday,13,208
6341,LAFY,2016-06-11 14:00:00,175,76,Saturday,14,251
6342,LAFY,2016-06-11 15:00:00,152,98,Saturday,15,250
6343,LAFY,2016-06-11 16:00:00,113,97,Saturday,16,210
6344,LAFY,2016-06-11 17:00:00,127,117,Saturday,17,244
6345,LAFY,2016-06-11 18:00:00,86,121,Saturday,18,207
6346,LAFY,2016-06-11 19:00:00,87,114,Saturday,19,201
6347,LAFY,2016-06-11 20:00:00,45,107,Saturday,20,152
6348,LAFY,2016-06-11 21:00:00,50,214,Saturday,21,264
6349,LAFY,2016-06-11 22:00:00,56,107,Saturday,22,163
6350,LAFY,2016-06-11 23:00:00,17,74,Saturday,23,91
6351,LAFY,2016-06-12 00:00:00,14,37,Sunday,0,51
6352,LAFY,2016-06-12 01:00:00,3,8,Sunday,1,11
6353,LAFY,2016-06-12 08:00:00,47,40,Sunday,8,87
6354,LAFY,2016-06-12 09:00:00,92,40,Sunday,9,132
6355,LAFY,2016-06-12 10:00:00,121,50,Sunday,10,171
6356,LAFY,2016-06-12 11:00:00,133,40,Sunday,11,173
6357,LAFY,2016-06-12 12:00:00,134,42,Sunday,12,176
6358,LAFY,2016-06-12 13:00:00,94,70,Sunday,13,164
6359,LAFY,2016-06-12 14:00:00,85,79,Sunday,14,164
6360,LAFY,2016-06-12 15:00:00,136,120,Sunday,15,256
6361,LAFY,2016-06-12 16:00:00,133,111,Sunday,16,244
6362,LAFY,2016-06-12 17:00:00,102,119,Sunday,17,221
6363,LAFY,2016-06-12 18:00:00,72,114,Sunday,18,186
6364,LAFY,2016-06-12 19:00:00,59,90,Sunday,19,149
6365,LAFY,2016-06-12 20:00:00,33,102,Sunday,20,135
6366,LAFY,2016-06-12 21:00:00,38,171,Sunday,21,209
6367,LAFY,2016-06-12 22:00:00,32,87,Sunday,22,119
6368,LAFY,2016-06-12 23:00:00,24,39,Sunday,23,63
6369,LAFY,2016-06-13 00:00:00,10,30,Monday,0,40
6370,LAFY,2016-06-13 01:00:00,1,3,Monday,1,4
6371,LAFY,2016-06-13 04:00:00,19,2,Monday,4,21
6372,LAFY,2016-06-13 05:00:00,103,13,Monday,5,116
6373,LAFY,2016-06-13 06:00:00,281,43,Monday,6,324
6374,LAFY,2016-06-13 07:00:00,657,78,Monday,7,735
6375,LAFY,2016-06-13 08:00:00,882,98,Monday,8,980
6376,LAFY,2016-06-13 09:00:00,464,62,Monday,9,526
6377,LAFY,2016-06-13 10:00:00,229,54,Monday,10,283
6378,LAFY,2016-06-13 11:00:00,109,51,Monday,11,160
6379,LAFY,2016-06-13 12:00:00,80,65,Monday,12,145
6380,LAFY,2016-06-13 13:00:00,71,79,Monday,13,150
6381,LAFY,2016-06-13 14:00:00,88,129,Monday,14,217
6382,LAFY,2016-06-13 15:00:00,110,231,Monday,15,341
6383,LAFY,2016-06-13 16:00:00,152,478,Monday,16,630
6384,LAFY,2016-06-13 17:00:00,250,944,Monday,17,1194
6385,LAFY,2016-06-13 18:00:00,192,719,Monday,18,911
6386,LAFY,2016-06-13 19:00:00,67,242,Monday,19,309
6387,LAFY,2016-06-13 20:00:00,35,102,Monday,20,137
6388,LAFY,2016-06-13 21:00:00,41,185,Monday,21,226
6389,LAFY,2016-06-13 22:00:00,30,172,Monday,22,202
6390,LAFY,2016-06-13 23:00:00,22,165,Monday,23,187
6391,LAFY,2016-06-14 00:00:00,6,30,Tuesday,0,36
6392,LAFY,2016-06-14 01:00:00,1,7,Tuesday,1,8
6393,LAFY,2016-06-14 04:00:00,16,2,Tuesday,4,18
6394,LAFY,2016-06-14 05:00:00,113,15,Tuesday,5,128
6395,LAFY,2016-06-14 06:00:00,296,35,Tuesday,6,331
6396,LAFY,2016-06-14 07:00:00,628,83,Tuesday,7,711
6397,LAFY,2016-06-14 08:00:00,965,95,Tuesday,8,1060
6398,LAFY,2016-06-14 09:00:00,421,63,Tuesday,9,484
6399,LAFY,2016-06-14 10:00:00,237,50,Tuesday,10,287
6400,LAFY,2016-06-14 11:00:00,145,51,Tuesday,11,196
6401,LAFY,2016-06-14 12:00:00,123,70,Tuesday,12,193
6402,LAFY,2016-06-14 13:00:00,60,92,Tuesday,13,152
6403,LAFY,2016-06-14 14:00:00,76,126,Tuesday,14,202
6404,LAFY,2016-06-14 15:00:00,114,215,Tuesday,15,329
6405,LAFY,2016-06-14 16:00:00,103,420,Tuesday,16,523
6406,LAFY,2016-06-14 17:00:00,192,941,Tuesday,17,1133
6407,LAFY,2016-06-14 18:00:00,202,714,Tuesday,18,916
6408,LAFY,2016-06-14 19:00:00,83,350,Tuesday,19,433
6409,LAFY,2016-06-14 20:00:00,28,130,Tuesday,20,158
6410,LAFY,2016-06-14 21:00:00,44,85,Tuesday,21,129
6411,LAFY,2016-06-14 22:00:00,37,171,Tuesday,22,208
6412,LAFY,2016-06-14 23:00:00,15,193,Tuesday,23,208
6413,LAKE,2016-06-01 01:00:00,1,1,Wednesday,1,2
6414,LAKE,2016-06-01 04:00:00,1,14,Wednesday,4,15
6415,LAKE,2016-06-01 05:00:00,103,57,Wednesday,5,160
6416,LAKE,2016-06-01 06:00:00,280,165,Wednesday,6,445
6417,LAKE,2016-06-01 07:00:00,711,487,Wednesday,7,1198
6418,LAKE,2016-06-01 08:00:00,1155,678,Wednesday,8,1833
6419,LAKE,2016-06-01 09:00:00,811,374,Wednesday,9,1185
6420,LAKE,2016-06-01 10:00:00,394,208,Wednesday,10,602
6421,LAKE,2016-06-01 11:00:00,301,173,Wednesday,11,474
6422,LAKE,2016-06-01 12:00:00,331,191,Wednesday,12,522
6423,LAKE,2016-06-01 13:00:00,281,215,Wednesday,13,496
6424,LAKE,2016-06-01 14:00:00,288,246,Wednesday,14,534
6425,LAKE,2016-06-01 15:00:00,301,422,Wednesday,15,723
6426,LAKE,2016-06-01 16:00:00,484,574,Wednesday,16,1058
6427,LAKE,2016-06-01 17:00:00,617,916,Wednesday,17,1533
6428,LAKE,2016-06-01 18:00:00,407,898,Wednesday,18,1305
6429,LAKE,2016-06-01 19:00:00,166,566,Wednesday,19,732
6430,LAKE,2016-06-01 20:00:00,142,274,Wednesday,20,416
6431,LAKE,2016-06-01 21:00:00,94,242,Wednesday,21,336
6432,LAKE,2016-06-01 22:00:00,75,216,Wednesday,22,291
6433,LAKE,2016-06-01 23:00:00,55,117,Wednesday,23,172
6434,LAKE,2016-06-02 00:00:00,17,60,Thursday,0,77
6435,LAKE,2016-06-02 04:00:00,1,14,Thursday,4,15
6436,LAKE,2016-06-02 05:00:00,108,47,Thursday,5,155
6437,LAKE,2016-06-02 06:00:00,272,171,Thursday,6,443
6438,LAKE,2016-06-02 07:00:00,711,455,Thursday,7,1166
6439,LAKE,2016-06-02 08:00:00,1135,659,Thursday,8,1794
6440,LAKE,2016-06-02 09:00:00,858,469,Thursday,9,1327
6441,LAKE,2016-06-02 10:00:00,450,238,Thursday,10,688
6442,LAKE,2016-06-02 11:00:00,259,239,Thursday,11,498
6443,LAKE,2016-06-02 12:00:00,258,190,Thursday,12,448
6444,LAKE,2016-06-02 13:00:00,366,268,Thursday,13,634
6445,LAKE,2016-06-02 14:00:00,432,262,Thursday,14,694
6446,LAKE,2016-06-02 15:00:00,328,384,Thursday,15,712
6447,LAKE,2016-06-02 16:00:00,449,572,Thursday,16,1021
6448,LAKE,2016-06-02 17:00:00,740,995,Thursday,17,1735
6449,LAKE,2016-06-02 18:00:00,394,884,Thursday,18,1278
6450,LAKE,2016-06-02 19:00:00,184,388,Thursday,19,572
6451,LAKE,2016-06-02 20:00:00,128,289,Thursday,20,417
6452,LAKE,2016-06-02 21:00:00,99,373,Thursday,21,472
6453,LAKE,2016-06-02 22:00:00,77,217,Thursday,22,294
6454,LAKE,2016-06-02 23:00:00,49,135,Thursday,23,184
6455,LAKE,2016-06-03 00:00:00,25,85,Friday,0,110
6456,LAKE,2016-06-03 01:00:00,3,4,Friday,1,7
6457,LAKE,2016-06-03 04:00:00,1,9,Friday,4,10
6458,LAKE,2016-06-03 05:00:00,82,41,Friday,5,123
6459,LAKE,2016-06-03 06:00:00,253,176,Friday,6,429
6460,LAKE,2016-06-03 07:00:00,651,433,Friday,7,1084
6461,LAKE,2016-06-03 08:00:00,1030,592,Friday,8,1622
6462,LAKE,2016-06-03 09:00:00,723,253,Friday,9,976
6463,LAKE,2016-06-03 10:00:00,397,300,Friday,10,697
6464,LAKE,2016-06-03 11:00:00,359,209,Friday,11,568
6465,LAKE,2016-06-03 12:00:00,289,191,Friday,12,480
6466,LAKE,2016-06-03 13:00:00,291,282,Friday,13,573
6467,LAKE,2016-06-03 14:00:00,361,283,Friday,14,644
6468,LAKE,2016-06-03 15:00:00,312,397,Friday,15,709
6469,LAKE,2016-06-03 16:00:00,426,608,Friday,16,1034
6470,LAKE,2016-06-03 17:00:00,644,903,Friday,17,1547
6471,LAKE,2016-06-03 18:00:00,387,896,Friday,18,1283
6472,LAKE,2016-06-03 19:00:00,220,502,Friday,19,722
6473,LAKE,2016-06-03 20:00:00,182,341,Friday,20,523
6474,LAKE,2016-06-03 21:00:00,217,267,Friday,21,484
6475,LAKE,2016-06-03 22:00:00,169,234,Friday,22,403
6476,LAKE,2016-06-03 23:00:00,105,205,Friday,23,310
6477,LAKE,2016-06-04 00:00:00,60,146,Saturday,0,206
6478,LAKE,2016-06-04 01:00:00,4,5,Saturday,1,9
6479,LAKE,2016-06-04 06:00:00,47,30,Saturday,6,77
6480,LAKE,2016-06-04 07:00:00,127,82,Saturday,7,209
6481,LAKE,2016-06-04 08:00:00,178,148,Saturday,8,326
6482,LAKE,2016-06-04 09:00:00,207,158,Saturday,9,365
6483,LAKE,2016-06-04 10:00:00,214,159,Saturday,10,373
6484,LAKE,2016-06-04 11:00:00,239,175,Saturday,11,414
6485,LAKE,2016-06-04 12:00:00,229,188,Saturday,12,417
6486,LAKE,2016-06-04 13:00:00,214,170,Saturday,13,384
6487,LAKE,2016-06-04 14:00:00,231,186,Saturday,14,417
6488,LAKE,2016-06-04 15:00:00,203,230,Saturday,15,433
6489,LAKE,2016-06-04 16:00:00,231,225,Saturday,16,456
6490,LAKE,2016-06-04 17:00:00,204,275,Saturday,17,479
6491,LAKE,2016-06-04 18:00:00,208,274,Saturday,18,482
6492,LAKE,2016-06-04 19:00:00,169,219,Saturday,19,388
6493,LAKE,2016-06-04 20:00:00,136,181,Saturday,20,317
6494,LAKE,2016-06-04 21:00:00,96,180,Saturday,21,276
6495,LAKE,2016-06-04 22:00:00,68,142,Saturday,22,210
6496,LAKE,2016-06-04 23:00:00,77,156,Saturday,23,233
6497,LAKE,2016-06-05 00:00:00,34,124,Sunday,0,158
6498,LAKE,2016-06-05 01:00:00,3,2,Sunday,1,5
6499,LAKE,2016-06-05 08:00:00,125,140,Sunday,8,265
6500,LAKE,2016-06-05 09:00:00,143,143,Sunday,9,286
6501,LAKE,2016-06-05 10:00:00,202,200,Sunday,10,402
6502,LAKE,2016-06-05 11:00:00,218,202,Sunday,11,420
6503,LAKE,2016-06-05 12:00:00,203,220,Sunday,12,423
6504,LAKE,2016-06-05 13:00:00,288,208,Sunday,13,496
6505,LAKE,2016-06-05 14:00:00,295,237,Sunday,14,532
6506,LAKE,2016-06-05 15:00:00,263,180,Sunday,15,443
6507,LAKE,2016-06-05 16:00:00,274,220,Sunday,16,494
6508,LAKE,2016-06-05 17:00:00,214,251,Sunday,17,465
6509,LAKE,2016-06-05 18:00:00,135,183,Sunday,18,318
6510,LAKE,2016-06-05 19:00:00,111,193,Sunday,19,304
6511,LAKE,2016-06-05 20:00:00,142,199,Sunday,20,341
6512,LAKE,2016-06-05 21:00:00,90,128,Sunday,21,218
6513,LAKE,2016-06-05 22:00:00,55,112,Sunday,22,167
6514,LAKE,2016-06-05 23:00:00,31,75,Sunday,23,106
6515,LAKE,2016-06-06 00:00:00,12,53,Monday,0,65
6516,LAKE,2016-06-06 01:00:00,2,2,Monday,1,4
6517,LAKE,2016-06-06 04:00:00,13,11,Monday,4,24
6518,LAKE,2016-06-06 05:00:00,104,42,Monday,5,146
6519,LAKE,2016-06-06 06:00:00,268,157,Monday,6,425
6520,LAKE,2016-06-06 07:00:00,638,504,Monday,7,1142
6521,LAKE,2016-06-06 08:00:00,1085,650,Monday,8,1735
6522,LAKE,2016-06-06 09:00:00,922,319,Monday,9,1241
6523,LAKE,2016-06-06 10:00:00,370,215,Monday,10,585
6524,LAKE,2016-06-06 11:00:00,278,177,Monday,11,455
6525,LAKE,2016-06-06 12:00:00,290,207,Monday,12,497
6526,LAKE,2016-06-06 13:00:00,275,247,Monday,13,522
6527,LAKE,2016-06-06 14:00:00,259,240,Monday,14,499
6528,LAKE,2016-06-06 15:00:00,261,311,Monday,15,572
6529,LAKE,2016-06-06 16:00:00,416,576,Monday,16,992
6530,LAKE,2016-06-06 17:00:00,683,882,Monday,17,1565
6531,LAKE,2016-06-06 18:00:00,338,972,Monday,18,1310
6532,LAKE,2016-06-06 19:00:00,180,406,Monday,19,586
6533,LAKE,2016-06-06 20:00:00,113,342,Monday,20,455
6534,LAKE,2016-06-06 21:00:00,77,171,Monday,21,248
6535,LAKE,2016-06-06 22:00:00,62,209,Monday,22,271
6536,LAKE,2016-06-06 23:00:00,42,130,Monday,23,172
6537,LAKE,2016-06-07 00:00:00,15,60,Tuesday,0,75
6538,LAKE,2016-06-07 04:00:00,1,15,Tuesday,4,16
6539,LAKE,2016-06-07 05:00:00,94,42,Tuesday,5,136
6540,LAKE,2016-06-07 06:00:00,285,184,Tuesday,6,469
6541,LAKE,2016-06-07 07:00:00,715,493,Tuesday,7,1208
6542,LAKE,2016-06-07 08:00:00,1145,682,Tuesday,8,1827
6543,LAKE,2016-06-07 09:00:00,877,314,Tuesday,9,1191
6544,LAKE,2016-06-07 10:00:00,463,215,Tuesday,10,678
6545,LAKE,2016-06-07 11:00:00,329,147,Tuesday,11,476
6546,LAKE,2016-06-07 12:00:00,310,221,Tuesday,12,531
6547,LAKE,2016-06-07 13:00:00,267,252,Tuesday,13,519
6548,LAKE,2016-06-07 14:00:00,256,277,Tuesday,14,533
6549,LAKE,2016-06-07 15:00:00,339,335,Tuesday,15,674
6550,LAKE,2016-06-07 16:00:00,407,584,Tuesday,16,991
6551,LAKE,2016-06-07 17:00:00,640,1060,Tuesday,17,1700
6552,LAKE,2016-06-07 18:00:00,360,982,Tuesday,18,1342
6553,LAKE,2016-06-07 19:00:00,174,461,Tuesday,19,635
6554,LAKE,2016-06-07 20:00:00,98,321,Tuesday,20,419
6555,LAKE,2016-06-07 21:00:00,64,273,Tuesday,21,337
6556,LAKE,2016-06-07 22:00:00,68,212,Tuesday,22,280
6557,LAKE,2016-06-07 23:00:00,66,177,Tuesday,23,243
6558,LAKE,2016-06-08 00:00:00,23,71,Wednesday,0,94
6559,LAKE,2016-06-08 01:00:00,6,1,Wednesday,1,7
6560,LAKE,2016-06-08 04:00:00,9,11,Wednesday,4,20
6561,LAKE,2016-06-08 05:00:00,99,43,Wednesday,5,142
6562,LAKE,2016-06-08 06:00:00,281,159,Wednesday,6,440
6563,LAKE,2016-06-08 07:00:00,698,446,Wednesday,7,1144
6564,LAKE,2016-06-08 08:00:00,988,661,Wednesday,8,1649
6565,LAKE,2016-06-08 09:00:00,939,318,Wednesday,9,1257
6566,LAKE,2016-06-08 10:00:00,455,286,Wednesday,10,741
6567,LAKE,2016-06-08 11:00:00,308,162,Wednesday,11,470
6568,LAKE,2016-06-08 12:00:00,274,234,Wednesday,12,508
6569,LAKE,2016-06-08 13:00:00,287,198,Wednesday,13,485
6570,LAKE,2016-06-08 14:00:00,272,268,Wednesday,14,540
6571,LAKE,2016-06-08 15:00:00,320,348,Wednesday,15,668
6572,LAKE,2016-06-08 16:00:00,396,629,Wednesday,16,1025
6573,LAKE,2016-06-08 17:00:00,740,826,Wednesday,17,1566
6574,LAKE,2016-06-08 18:00:00,392,1020,Wednesday,18,1412
6575,LAKE,2016-06-08 19:00:00,181,481,Wednesday,19,662
6576,LAKE,2016-06-08 20:00:00,117,265,Wednesday,20,382
6577,LAKE,2016-06-08 21:00:00,136,333,Wednesday,21,469
6578,LAKE,2016-06-08 22:00:00,88,246,Wednesday,22,334
6579,LAKE,2016-06-08 23:00:00,56,169,Wednesday,23,225
6580,LAKE,2016-06-09 00:00:00,22,68,Thursday,0,90
6581,LAKE,2016-06-09 04:00:00,1,12,Thursday,4,13
6582,LAKE,2016-06-09 05:00:00,97,52,Thursday,5,149
6583,LAKE,2016-06-09 06:00:00,276,155,Thursday,6,431
6584,LAKE,2016-06-09 07:00:00,586,442,Thursday,7,1028
6585,LAKE,2016-06-09 08:00:00,1198,599,Thursday,8,1797
6586,LAKE,2016-06-09 09:00:00,823,393,Thursday,9,1216
6587,LAKE,2016-06-09 10:00:00,451,205,Thursday,10,656
6588,LAKE,2016-06-09 11:00:00,286,167,Thursday,11,453
6589,LAKE,2016-06-09 12:00:00,265,208,Thursday,12,473
6590,LAKE,2016-06-09 13:00:00,247,216,Thursday,13,463
6591,LAKE,2016-06-09 14:00:00,305,245,Thursday,14,550
6592,LAKE,2016-06-09 15:00:00,296,367,Thursday,15,663
6593,LAKE,2016-06-09 16:00:00,398,573,Thursday,16,971
6594,LAKE,2016-06-09 17:00:00,636,799,Thursday,17,1435
6595,LAKE,2016-06-09 18:00:00,410,945,Thursday,18,1355
6596,LAKE,2016-06-09 19:00:00,186,509,Thursday,19,695
6597,LAKE,2016-06-09 20:00:00,140,320,Thursday,20,460
6598,LAKE,2016-06-09 21:00:00,83,287,Thursday,21,370
6599,LAKE,2016-06-09 22:00:00,80,238,Thursday,22,318
6600,LAKE,2016-06-09 23:00:00,55,152,Thursday,23,207
6601,LAKE,2016-06-10 00:00:00,22,81,Friday,0,103
6602,LAKE,2016-06-10 01:00:00,2,2,Friday,1,4
6603,LAKE,2016-06-10 04:00:00,1,10,Friday,4,11
6604,LAKE,2016-06-10 05:00:00,79,43,Friday,5,122
6605,LAKE,2016-06-10 06:00:00,266,144,Friday,6,410
6606,LAKE,2016-06-10 07:00:00,580,404,Friday,7,984
6607,LAKE,2016-06-10 08:00:00,987,545,Friday,8,1532
6608,LAKE,2016-06-10 09:00:00,706,291,Friday,9,997
6609,LAKE,2016-06-10 10:00:00,441,181,Friday,10,622
6610,LAKE,2016-06-10 11:00:00,278,162,Friday,11,440
6611,LAKE,2016-06-10 12:00:00,260,204,Friday,12,464
6612,LAKE,2016-06-10 13:00:00,222,234,Friday,13,456
6613,LAKE,2016-06-10 14:00:00,258,269,Friday,14,527
6614,LAKE,2016-06-10 15:00:00,294,387,Friday,15,681
6615,LAKE,2016-06-10 16:00:00,393,674,Friday,16,1067
6616,LAKE,2016-06-10 17:00:00,743,901,Friday,17,1644
6617,LAKE,2016-06-10 18:00:00,437,802,Friday,18,1239
6618,LAKE,2016-06-10 19:00:00,217,329,Friday,19,546
6619,LAKE,2016-06-10 20:00:00,141,247,Friday,20,388
6620,LAKE,2016-06-10 21:00:00,152,419,Friday,21,571
6621,LAKE,2016-06-10 22:00:00,121,276,Friday,22,397
6622,LAKE,2016-06-10 23:00:00,104,169,Friday,23,273
6623,LAKE,2016-06-11 00:00:00,79,121,Saturday,0,200
6624,LAKE,2016-06-11 06:00:00,47,32,Saturday,6,79
6625,LAKE,2016-06-11 07:00:00,110,80,Saturday,7,190
6626,LAKE,2016-06-11 08:00:00,173,138,Saturday,8,311
6627,LAKE,2016-06-11 09:00:00,211,131,Saturday,9,342
6628,LAKE,2016-06-11 10:00:00,186,213,Saturday,10,399
6629,LAKE,2016-06-11 11:00:00,257,158,Saturday,11,415
6630,LAKE,2016-06-11 12:00:00,247,178,Saturday,12,425
6631,LAKE,2016-06-11 13:00:00,318,224,Saturday,13,542
6632,LAKE,2016-06-11 14:00:00,218,178,Saturday,14,396
6633,LAKE,2016-06-11 15:00:00,236,218,Saturday,15,454
6634,LAKE,2016-06-11 16:00:00,236,224,Saturday,16,460
6635,LAKE,2016-06-11 17:00:00,191,284,Saturday,17,475
6636,LAKE,2016-06-11 18:00:00,213,270,Saturday,18,483
6637,LAKE,2016-06-11 19:00:00,169,241,Saturday,19,410
6638,LAKE,2016-06-11 20:00:00,115,187,Saturday,20,302
6639,LAKE,2016-06-11 21:00:00,94,210,Saturday,21,304
6640,LAKE,2016-06-11 22:00:00,112,171,Saturday,22,283
6641,LAKE,2016-06-11 23:00:00,61,147,Saturday,23,208
6642,LAKE,2016-06-12 00:00:00,44,102,Sunday,0,146
6643,LAKE,2016-06-12 01:00:00,3,4,Sunday,1,7
6644,LAKE,2016-06-12 08:00:00,110,147,Sunday,8,257
6645,LAKE,2016-06-12 09:00:00,143,167,Sunday,9,310
6646,LAKE,2016-06-12 10:00:00,186,178,Sunday,10,364
6647,LAKE,2016-06-12 11:00:00,249,163,Sunday,11,412
6648,LAKE,2016-06-12 12:00:00,224,166,Sunday,12,390
6649,LAKE,2016-06-12 13:00:00,281,181,Sunday,13,462
6650,LAKE,2016-06-12 14:00:00,246,161,Sunday,14,407
6651,LAKE,2016-06-12 15:00:00,199,135,Sunday,15,334
6652,LAKE,2016-06-12 16:00:00,233,242,Sunday,16,475
6653,LAKE,2016-06-12 17:00:00,179,199,Sunday,17,378
6654,LAKE,2016-06-12 18:00:00,101,218,Sunday,18,319
6655,LAKE,2016-06-12 19:00:00,123,191,Sunday,19,314
6656,LAKE,2016-06-12 20:00:00,86,127,Sunday,20,213
6657,LAKE,2016-06-12 21:00:00,82,161,Sunday,21,243
6658,LAKE,2016-06-12 22:00:00,67,146,Sunday,22,213
6659,LAKE,2016-06-12 23:00:00,31,115,Sunday,23,146
6660,LAKE,2016-06-13 00:00:00,23,62,Monday,0,85
6661,LAKE,2016-06-13 05:00:00,100,41,Monday,5,141
6662,LAKE,2016-06-13 06:00:00,237,156,Monday,6,393
6663,LAKE,2016-06-13 07:00:00,690,440,Monday,7,1130
6664,LAKE,2016-06-13 08:00:00,1117,632,Monday,8,1749
6665,LAKE,2016-06-13 09:00:00,766,316,Monday,9,1082
6666,LAKE,2016-06-13 10:00:00,390,191,Monday,10,581
6667,LAKE,2016-06-13 11:00:00,266,167,Monday,11,433
6668,LAKE,2016-06-13 12:00:00,243,185,Monday,12,428
6669,LAKE,2016-06-13 13:00:00,247,216,Monday,13,463
6670,LAKE,2016-06-13 14:00:00,239,243,Monday,14,482
6671,LAKE,2016-06-13 15:00:00,277,327,Monday,15,604
6672,LAKE,2016-06-13 16:00:00,434,639,Monday,16,1073
6673,LAKE,2016-06-13 17:00:00,727,1010,Monday,17,1737
6674,LAKE,2016-06-13 18:00:00,385,878,Monday,18,1263
6675,LAKE,2016-06-13 19:00:00,139,418,Monday,19,557
6676,LAKE,2016-06-13 20:00:00,84,222,Monday,20,306
6677,LAKE,2016-06-13 21:00:00,141,406,Monday,21,547
6678,LAKE,2016-06-13 22:00:00,84,269,Monday,22,353
6679,LAKE,2016-06-13 23:00:00,65,104,Monday,23,169
6680,LAKE,2016-06-14 00:00:00,23,57,Tuesday,0,80
6681,LAKE,2016-06-14 04:00:00,4,11,Tuesday,4,15
6682,LAKE,2016-06-14 05:00:00,105,44,Tuesday,5,149
6683,LAKE,2016-06-14 06:00:00,297,182,Tuesday,6,479
6684,LAKE,2016-06-14 07:00:00,680,415,Tuesday,7,1095
6685,LAKE,2016-06-14 08:00:00,1101,626,Tuesday,8,1727
6686,LAKE,2016-06-14 09:00:00,892,303,Tuesday,9,1195
6687,LAKE,2016-06-14 10:00:00,393,201,Tuesday,10,594
6688,LAKE,2016-06-14 11:00:00,274,161,Tuesday,11,435
6689,LAKE,2016-06-14 12:00:00,239,187,Tuesday,12,426
6690,LAKE,2016-06-14 13:00:00,246,200,Tuesday,13,446
6691,LAKE,2016-06-14 14:00:00,222,254,Tuesday,14,476
6692,LAKE,2016-06-14 15:00:00,328,348,Tuesday,15,676
6693,LAKE,2016-06-14 16:00:00,397,542,Tuesday,16,939
6694,LAKE,2016-06-14 17:00:00,668,992,Tuesday,17,1660
6695,LAKE,2016-06-14 18:00:00,452,993,Tuesday,18,1445
6696,LAKE,2016-06-14 19:00:00,221,408,Tuesday,19,629
6697,LAKE,2016-06-14 20:00:00,116,343,Tuesday,20,459
6698,LAKE,2016-06-14 21:00:00,99,318,Tuesday,21,417
6699,LAKE,2016-06-14 22:00:00,84,257,Tuesday,22,341
6700,LAKE,2016-06-14 23:00:00,52,127,Tuesday,23,179
6701,MCAR,2016-06-01 04:00:00,17,7,Wednesday,4,24
6702,MCAR,2016-06-01 05:00:00,100,79,Wednesday,5,179
6703,MCAR,2016-06-01 06:00:00,321,350,Wednesday,6,671
6704,MCAR,2016-06-01 07:00:00,883,681,Wednesday,7,1564
6705,MCAR,2016-06-01 08:00:00,1567,798,Wednesday,8,2365
6706,MCAR,2016-06-01 09:00:00,1162,380,Wednesday,9,1542
6707,MCAR,2016-06-01 10:00:00,593,232,Wednesday,10,825
6708,MCAR,2016-06-01 11:00:00,344,216,Wednesday,11,560
6709,MCAR,2016-06-01 12:00:00,379,259,Wednesday,12,638
6710,MCAR,2016-06-01 13:00:00,305,364,Wednesday,13,669
6711,MCAR,2016-06-01 14:00:00,256,319,Wednesday,14,575
6712,MCAR,2016-06-01 15:00:00,396,476,Wednesday,15,872
6713,MCAR,2016-06-01 16:00:00,610,823,Wednesday,16,1433
6714,MCAR,2016-06-01 17:00:00,811,1219,Wednesday,17,2030
6715,MCAR,2016-06-01 18:00:00,822,1355,Wednesday,18,2177
6716,MCAR,2016-06-01 19:00:00,375,719,Wednesday,19,1094
6717,MCAR,2016-06-01 20:00:00,193,524,Wednesday,20,717
6718,MCAR,2016-06-01 21:00:00,189,437,Wednesday,21,626
6719,MCAR,2016-06-01 22:00:00,134,231,Wednesday,22,365
6720,MCAR,2016-06-01 23:00:00,72,212,Wednesday,23,284
6721,MCAR,2016-06-02 00:00:00,41,82,Thursday,0,123
6722,MCAR,2016-06-02 04:00:00,14,11,Thursday,4,25
6723,MCAR,2016-06-02 05:00:00,107,92,Thursday,5,199
6724,MCAR,2016-06-02 06:00:00,286,347,Thursday,6,633
6725,MCAR,2016-06-02 07:00:00,838,693,Thursday,7,1531
6726,MCAR,2016-06-02 08:00:00,1471,782,Thursday,8,2253
6727,MCAR,2016-06-02 09:00:00,1192,422,Thursday,9,1614
6728,MCAR,2016-06-02 10:00:00,598,226,Thursday,10,824
6729,MCAR,2016-06-02 11:00:00,361,199,Thursday,11,560
6730,MCAR,2016-06-02 12:00:00,332,240,Thursday,12,572
6731,MCAR,2016-06-02 13:00:00,307,295,Thursday,13,602
6732,MCAR,2016-06-02 14:00:00,267,354,Thursday,14,621
6733,MCAR,2016-06-02 15:00:00,361,507,Thursday,15,868
6734,MCAR,2016-06-02 16:00:00,600,714,Thursday,16,1314
6735,MCAR,2016-06-02 17:00:00,956,1448,Thursday,17,2404
6736,MCAR,2016-06-02 18:00:00,760,1188,Thursday,18,1948
6737,MCAR,2016-06-02 19:00:00,416,684,Thursday,19,1100
6738,MCAR,2016-06-02 20:00:00,219,390,Thursday,20,609
6739,MCAR,2016-06-02 21:00:00,185,557,Thursday,21,742
6740,MCAR,2016-06-02 22:00:00,154,307,Thursday,22,461
6741,MCAR,2016-06-02 23:00:00,76,197,Thursday,23,273
6742,MCAR,2016-06-03 00:00:00,51,132,Friday,0,183
6743,MCAR,2016-06-03 04:00:00,13,11,Friday,4,24
6744,MCAR,2016-06-03 05:00:00,89,74,Friday,5,163
6745,MCAR,2016-06-03 06:00:00,271,324,Friday,6,595
6746,MCAR,2016-06-03 07:00:00,737,632,Friday,7,1369
6747,MCAR,2016-06-03 08:00:00,1397,756,Friday,8,2153
6748,MCAR,2016-06-03 09:00:00,1068,378,Friday,9,1446
6749,MCAR,2016-06-03 10:00:00,576,216,Friday,10,792
6750,MCAR,2016-06-03 11:00:00,381,259,Friday,11,640
6751,MCAR,2016-06-03 12:00:00,311,273,Friday,12,584
6752,MCAR,2016-06-03 13:00:00,340,367,Friday,13,707
6753,MCAR,2016-06-03 14:00:00,331,465,Friday,14,796
6754,MCAR,2016-06-03 15:00:00,427,486,Friday,15,913
6755,MCAR,2016-06-03 16:00:00,694,803,Friday,16,1497
6756,MCAR,2016-06-03 17:00:00,809,1286,Friday,17,2095
6757,MCAR,2016-06-03 18:00:00,738,1009,Friday,18,1747
6758,MCAR,2016-06-03 19:00:00,419,613,Friday,19,1032
6759,MCAR,2016-06-03 20:00:00,263,417,Friday,20,680
6760,MCAR,2016-06-03 21:00:00,188,424,Friday,21,612
6761,MCAR,2016-06-03 22:00:00,143,346,Friday,22,489
6762,MCAR,2016-06-03 23:00:00,128,242,Friday,23,370
6763,MCAR,2016-06-04 00:00:00,89,169,Saturday,0,258
6764,MCAR,2016-06-04 06:00:00,60,40,Saturday,6,100
6765,MCAR,2016-06-04 07:00:00,125,82,Saturday,7,207
6766,MCAR,2016-06-04 08:00:00,198,100,Saturday,8,298
6767,MCAR,2016-06-04 09:00:00,305,133,Saturday,9,438
6768,MCAR,2016-06-04 10:00:00,266,203,Saturday,10,469
6769,MCAR,2016-06-04 11:00:00,321,174,Saturday,11,495
6770,MCAR,2016-06-04 12:00:00,300,202,Saturday,12,502
6771,MCAR,2016-06-04 13:00:00,327,282,Saturday,13,609
6772,MCAR,2016-06-04 14:00:00,295,296,Saturday,14,591
6773,MCAR,2016-06-04 15:00:00,253,295,Saturday,15,548
6774,MCAR,2016-06-04 16:00:00,279,310,Saturday,16,589
6775,MCAR,2016-06-04 17:00:00,294,344,Saturday,17,638
6776,MCAR,2016-06-04 18:00:00,287,360,Saturday,18,647
6777,MCAR,2016-06-04 19:00:00,232,285,Saturday,19,517
6778,MCAR,2016-06-04 20:00:00,203,244,Saturday,20,447
6779,MCAR,2016-06-04 21:00:00,161,181,Saturday,21,342
6780,MCAR,2016-06-04 22:00:00,157,301,Saturday,22,458
6781,MCAR,2016-06-04 23:00:00,120,191,Saturday,23,311
6782,MCAR,2016-06-05 00:00:00,73,163,Sunday,0,236
6783,MCAR,2016-06-05 08:00:00,102,97,Sunday,8,199
6784,MCAR,2016-06-05 09:00:00,185,104,Sunday,9,289
6785,MCAR,2016-06-05 10:00:00,237,151,Sunday,10,388
6786,MCAR,2016-06-05 11:00:00,257,157,Sunday,11,414
6787,MCAR,2016-06-05 12:00:00,252,189,Sunday,12,441
6788,MCAR,2016-06-05 13:00:00,280,238,Sunday,13,518
6789,MCAR,2016-06-05 14:00:00,247,249,Sunday,14,496
6790,MCAR,2016-06-05 15:00:00,241,166,Sunday,15,407
6791,MCAR,2016-06-05 16:00:00,264,303,Sunday,16,567
6792,MCAR,2016-06-05 17:00:00,211,256,Sunday,17,467
6793,MCAR,2016-06-05 18:00:00,165,245,Sunday,18,410
6794,MCAR,2016-06-05 19:00:00,127,214,Sunday,19,341
6795,MCAR,2016-06-05 20:00:00,161,284,Sunday,20,445
6796,MCAR,2016-06-05 21:00:00,157,182,Sunday,21,339
6797,MCAR,2016-06-05 22:00:00,110,125,Sunday,22,235
6798,MCAR,2016-06-05 23:00:00,70,104,Sunday,23,174
6799,MCAR,2016-06-06 00:00:00,33,74,Monday,0,107
6800,MCAR,2016-06-06 04:00:00,15,7,Monday,4,22
6801,MCAR,2016-06-06 05:00:00,94,77,Monday,5,171
6802,MCAR,2016-06-06 06:00:00,295,333,Monday,6,628
6803,MCAR,2016-06-06 07:00:00,802,650,Monday,7,1452
6804,MCAR,2016-06-06 08:00:00,1512,774,Monday,8,2286
6805,MCAR,2016-06-06 09:00:00,1138,415,Monday,9,1553
6806,MCAR,2016-06-06 10:00:00,539,196,Monday,10,735
6807,MCAR,2016-06-06 11:00:00,355,197,Monday,11,552
6808,MCAR,2016-06-06 12:00:00,310,221,Monday,12,531
6809,MCAR,2016-06-06 13:00:00,276,242,Monday,13,518
6810,MCAR,2016-06-06 14:00:00,287,343,Monday,14,630
6811,MCAR,2016-06-06 15:00:00,337,373,Monday,15,710
6812,MCAR,2016-06-06 16:00:00,599,775,Monday,16,1374
6813,MCAR,2016-06-06 17:00:00,779,1216,Monday,17,1995
6814,MCAR,2016-06-06 18:00:00,713,1371,Monday,18,2084
6815,MCAR,2016-06-06 19:00:00,347,814,Monday,19,1161
6816,MCAR,2016-06-06 20:00:00,211,394,Monday,20,605
6817,MCAR,2016-06-06 21:00:00,179,360,Monday,21,539
6818,MCAR,2016-06-06 22:00:00,133,241,Monday,22,374
6819,MCAR,2016-06-06 23:00:00,81,149,Monday,23,230
6820,MCAR,2016-06-07 00:00:00,29,73,Tuesday,0,102
6821,MCAR,2016-06-07 04:00:00,15,8,Tuesday,4,23
6822,MCAR,2016-06-07 05:00:00,98,93,Tuesday,5,191
6823,MCAR,2016-06-07 06:00:00,288,335,Tuesday,6,623
6824,MCAR,2016-06-07 07:00:00,843,710,Tuesday,7,1553
6825,MCAR,2016-06-07 08:00:00,1545,771,Tuesday,8,2316
6826,MCAR,2016-06-07 09:00:00,1218,394,Tuesday,9,1612
6827,MCAR,2016-06-07 10:00:00,646,214,Tuesday,10,860
6828,MCAR,2016-06-07 11:00:00,346,180,Tuesday,11,526
6829,MCAR,2016-06-07 12:00:00,357,259,Tuesday,12,616
6830,MCAR,2016-06-07 13:00:00,308,268,Tuesday,13,576
6831,MCAR,2016-06-07 14:00:00,334,310,Tuesday,14,644
6832,MCAR,2016-06-07 15:00:00,411,605,Tuesday,15,1016
6833,MCAR,2016-06-07 16:00:00,626,794,Tuesday,16,1420
6834,MCAR,2016-06-07 17:00:00,922,1287,Tuesday,17,2209
6835,MCAR,2016-06-07 18:00:00,778,1429,Tuesday,18,2207
6836,MCAR,2016-06-07 19:00:00,395,738,Tuesday,19,1133
6837,MCAR,2016-06-07 20:00:00,198,447,Tuesday,20,645
6838,MCAR,2016-06-07 21:00:00,169,344,Tuesday,21,513
6839,MCAR,2016-06-07 22:00:00,151,358,Tuesday,22,509
6840,MCAR,2016-06-07 23:00:00,94,228,Tuesday,23,322
6841,MCAR,2016-06-08 00:00:00,61,95,Wednesday,0,156
6842,MCAR,2016-06-08 04:00:00,18,10,Wednesday,4,28
6843,MCAR,2016-06-08 05:00:00,120,92,Wednesday,5,212
6844,MCAR,2016-06-08 06:00:00,309,290,Wednesday,6,599
6845,MCAR,2016-06-08 07:00:00,857,727,Wednesday,7,1584
6846,MCAR,2016-06-08 08:00:00,1518,745,Wednesday,8,2263
6847,MCAR,2016-06-08 09:00:00,1178,417,Wednesday,9,1595
6848,MCAR,2016-06-08 10:00:00,592,247,Wednesday,10,839
6849,MCAR,2016-06-08 11:00:00,358,201,Wednesday,11,559
6850,MCAR,2016-06-08 12:00:00,323,238,Wednesday,12,561
6851,MCAR,2016-06-08 13:00:00,323,318,Wednesday,13,641
6852,MCAR,2016-06-08 14:00:00,363,334,Wednesday,14,697
6853,MCAR,2016-06-08 15:00:00,413,346,Wednesday,15,759
6854,MCAR,2016-06-08 16:00:00,629,810,Wednesday,16,1439
6855,MCAR,2016-06-08 17:00:00,918,1230,Wednesday,17,2148
6856,MCAR,2016-06-08 18:00:00,779,1470,Wednesday,18,2249
6857,MCAR,2016-06-08 19:00:00,360,619,Wednesday,19,979
6858,MCAR,2016-06-08 20:00:00,178,419,Wednesday,20,597
6859,MCAR,2016-06-08 21:00:00,231,541,Wednesday,21,772
6860,MCAR,2016-06-08 22:00:00,143,315,Wednesday,22,458
6861,MCAR,2016-06-08 23:00:00,72,250,Wednesday,23,322
6862,MCAR,2016-06-09 00:00:00,46,82,Thursday,0,128
6863,MCAR,2016-06-09 04:00:00,16,12,Thursday,4,28
6864,MCAR,2016-06-09 05:00:00,97,82,Thursday,5,179
6865,MCAR,2016-06-09 06:00:00,309,298,Thursday,6,607
6866,MCAR,2016-06-09 07:00:00,763,737,Thursday,7,1500
6867,MCAR,2016-06-09 08:00:00,1443,766,Thursday,8,2209
6868,MCAR,2016-06-09 09:00:00,1209,384,Thursday,9,1593
6869,MCAR,2016-06-09 10:00:00,597,243,Thursday,10,840
6870,MCAR,2016-06-09 11:00:00,406,202,Thursday,11,608
6871,MCAR,2016-06-09 12:00:00,361,226,Thursday,12,587
6872,MCAR,2016-06-09 13:00:00,272,291,Thursday,13,563
6873,MCAR,2016-06-09 14:00:00,302,384,Thursday,14,686
6874,MCAR,2016-06-09 15:00:00,405,401,Thursday,15,806
6875,MCAR,2016-06-09 16:00:00,648,719,Thursday,16,1367
6876,MCAR,2016-06-09 17:00:00,817,1271,Thursday,17,2088
6877,MCAR,2016-06-09 18:00:00,776,1188,Thursday,18,1964
6878,MCAR,2016-06-09 19:00:00,381,840,Thursday,19,1221
6879,MCAR,2016-06-09 20:00:00,198,433,Thursday,20,631
6880,MCAR,2016-06-09 21:00:00,196,488,Thursday,21,684
6881,MCAR,2016-06-09 22:00:00,170,299,Thursday,22,469
6882,MCAR,2016-06-09 23:00:00,100,167,Thursday,23,267
6883,MCAR,2016-06-10 00:00:00,35,133,Friday,0,168
6884,MCAR,2016-06-10 04:00:00,10,10,Friday,4,20
6885,MCAR,2016-06-10 05:00:00,84,61,Friday,5,145
6886,MCAR,2016-06-10 06:00:00,286,290,Friday,6,576
6887,MCAR,2016-06-10 07:00:00,709,651,Friday,7,1360
6888,MCAR,2016-06-10 08:00:00,1317,619,Friday,8,1936
6889,MCAR,2016-06-10 09:00:00,976,389,Friday,9,1365
6890,MCAR,2016-06-10 10:00:00,577,210,Friday,10,787
6891,MCAR,2016-06-10 11:00:00,393,235,Friday,11,628
6892,MCAR,2016-06-10 12:00:00,347,268,Friday,12,615
6893,MCAR,2016-06-10 13:00:00,355,356,Friday,13,711
6894,MCAR,2016-06-10 14:00:00,323,419,Friday,14,742
6895,MCAR,2016-06-10 15:00:00,368,538,Friday,15,906
6896,MCAR,2016-06-10 16:00:00,611,767,Friday,16,1378
6897,MCAR,2016-06-10 17:00:00,923,1227,Friday,17,2150
6898,MCAR,2016-06-10 18:00:00,758,976,Friday,18,1734
6899,MCAR,2016-06-10 19:00:00,386,589,Friday,19,975
6900,MCAR,2016-06-10 20:00:00,202,304,Friday,20,506
6901,MCAR,2016-06-10 21:00:00,192,437,Friday,21,629
6902,MCAR,2016-06-10 22:00:00,212,356,Friday,22,568
6903,MCAR,2016-06-10 23:00:00,125,299,Friday,23,424
6904,MCAR,2016-06-11 00:00:00,82,171,Saturday,0,253
6905,MCAR,2016-06-11 06:00:00,32,46,Saturday,6,78
6906,MCAR,2016-06-11 07:00:00,104,80,Saturday,7,184
6907,MCAR,2016-06-11 08:00:00,190,84,Saturday,8,274
6908,MCAR,2016-06-11 09:00:00,256,160,Saturday,9,416
6909,MCAR,2016-06-11 10:00:00,309,137,Saturday,10,446
6910,MCAR,2016-06-11 11:00:00,326,174,Saturday,11,500
6911,MCAR,2016-06-11 12:00:00,333,196,Saturday,12,529
6912,MCAR,2016-06-11 13:00:00,351,198,Saturday,13,549
6913,MCAR,2016-06-11 14:00:00,357,253,Saturday,14,610
6914,MCAR,2016-06-11 15:00:00,301,291,Saturday,15,592
6915,MCAR,2016-06-11 16:00:00,290,314,Saturday,16,604
6916,MCAR,2016-06-11 17:00:00,322,361,Saturday,17,683
6917,MCAR,2016-06-11 18:00:00,308,354,Saturday,18,662
6918,MCAR,2016-06-11 19:00:00,298,275,Saturday,19,573
6919,MCAR,2016-06-11 20:00:00,178,298,Saturday,20,476
6920,MCAR,2016-06-11 21:00:00,176,318,Saturday,21,494
6921,MCAR,2016-06-11 22:00:00,140,307,Saturday,22,447
6922,MCAR,2016-06-11 23:00:00,116,251,Saturday,23,367
6923,MCAR,2016-06-12 00:00:00,71,201,Sunday,0,272
6924,MCAR,2016-06-12 08:00:00,105,76,Sunday,8,181
6925,MCAR,2016-06-12 09:00:00,170,110,Sunday,9,280
6926,MCAR,2016-06-12 10:00:00,216,169,Sunday,10,385
6927,MCAR,2016-06-12 11:00:00,284,166,Sunday,11,450
6928,MCAR,2016-06-12 12:00:00,242,253,Sunday,12,495
6929,MCAR,2016-06-12 13:00:00,274,250,Sunday,13,524
6930,MCAR,2016-06-12 14:00:00,275,320,Sunday,14,595
6931,MCAR,2016-06-12 15:00:00,329,321,Sunday,15,650
6932,MCAR,2016-06-12 16:00:00,328,260,Sunday,16,588
6933,MCAR,2016-06-12 17:00:00,306,289,Sunday,17,595
6934,MCAR,2016-06-12 18:00:00,261,279,Sunday,18,540
6935,MCAR,2016-06-12 19:00:00,244,229,Sunday,19,473
6936,MCAR,2016-06-12 20:00:00,152,204,Sunday,20,356
6937,MCAR,2016-06-12 21:00:00,129,222,Sunday,21,351
6938,MCAR,2016-06-12 22:00:00,130,241,Sunday,22,371
6939,MCAR,2016-06-12 23:00:00,49,115,Sunday,23,164
6940,MCAR,2016-06-13 00:00:00,33,85,Monday,0,118
6941,MCAR,2016-06-13 04:00:00,17,7,Monday,4,24
6942,MCAR,2016-06-13 05:00:00,98,83,Monday,5,181
6943,MCAR,2016-06-13 06:00:00,283,306,Monday,6,589
6944,MCAR,2016-06-13 07:00:00,790,608,Monday,7,1398
6945,MCAR,2016-06-13 08:00:00,1448,717,Monday,8,2165
6946,MCAR,2016-06-13 09:00:00,1152,371,Monday,9,1523
6947,MCAR,2016-06-13 10:00:00,446,200,Monday,10,646
6948,MCAR,2016-06-13 11:00:00,329,195,Monday,11,524
6949,MCAR,2016-06-13 12:00:00,287,219,Monday,12,506
6950,MCAR,2016-06-13 13:00:00,257,274,Monday,13,531
6951,MCAR,2016-06-13 14:00:00,314,288,Monday,14,602
6952,MCAR,2016-06-13 15:00:00,310,430,Monday,15,740
6953,MCAR,2016-06-13 16:00:00,558,685,Monday,16,1243
6954,MCAR,2016-06-13 17:00:00,892,1493,Monday,17,2385
6955,MCAR,2016-06-13 18:00:00,829,1271,Monday,18,2100
6956,MCAR,2016-06-13 19:00:00,321,612,Monday,19,933
6957,MCAR,2016-06-13 20:00:00,143,327,Monday,20,470
6958,MCAR,2016-06-13 21:00:00,177,511,Monday,21,688
6959,MCAR,2016-06-13 22:00:00,164,362,Monday,22,526
6960,MCAR,2016-06-13 23:00:00,97,180,Monday,23,277
6961,MCAR,2016-06-14 00:00:00,25,69,Tuesday,0,94
6962,MCAR,2016-06-14 04:00:00,16,6,Tuesday,4,22
6963,MCAR,2016-06-14 05:00:00,100,101,Tuesday,5,201
6964,MCAR,2016-06-14 06:00:00,310,335,Tuesday,6,645
6965,MCAR,2016-06-14 07:00:00,832,664,Tuesday,7,1496
6966,MCAR,2016-06-14 08:00:00,1555,697,Tuesday,8,2252
6967,MCAR,2016-06-14 09:00:00,1174,414,Tuesday,9,1588
6968,MCAR,2016-06-14 10:00:00,569,237,Tuesday,10,806
6969,MCAR,2016-06-14 11:00:00,378,202,Tuesday,11,580
6970,MCAR,2016-06-14 12:00:00,321,237,Tuesday,12,558
6971,MCAR,2016-06-14 13:00:00,270,277,Tuesday,13,547
6972,MCAR,2016-06-14 14:00:00,318,307,Tuesday,14,625
6973,MCAR,2016-06-14 15:00:00,343,497,Tuesday,15,840
6974,MCAR,2016-06-14 16:00:00,619,642,Tuesday,16,1261
6975,MCAR,2016-06-14 17:00:00,841,1373,Tuesday,17,2214
6976,MCAR,2016-06-14 18:00:00,831,1283,Tuesday,18,2114
6977,MCAR,2016-06-14 19:00:00,377,727,Tuesday,19,1104
6978,MCAR,2016-06-14 20:00:00,172,547,Tuesday,20,719
6979,MCAR,2016-06-14 21:00:00,173,359,Tuesday,21,532
6980,MCAR,2016-06-14 22:00:00,147,271,Tuesday,22,418
6981,MCAR,2016-06-14 23:00:00,80,284,Tuesday,23,364
6982,MLBR,2016-06-01 01:00:00,2,10,Wednesday,1,12
6983,MLBR,2016-06-01 05:00:00,57,40,Wednesday,5,97
6984,MLBR,2016-06-01 06:00:00,217,181,Wednesday,6,398
6985,MLBR,2016-06-01 07:00:00,821,393,Wednesday,7,1214
6986,MLBR,2016-06-01 08:00:00,1561,459,Wednesday,8,2020
6987,MLBR,2016-06-01 09:00:00,1314,273,Wednesday,9,1587
6988,MLBR,2016-06-01 10:00:00,483,160,Wednesday,10,643
6989,MLBR,2016-06-01 11:00:00,255,141,Wednesday,11,396
6990,MLBR,2016-06-01 12:00:00,163,141,Wednesday,12,304
6991,MLBR,2016-06-01 13:00:00,163,149,Wednesday,13,312
6992,MLBR,2016-06-01 14:00:00,169,202,Wednesday,14,371
6993,MLBR,2016-06-01 15:00:00,160,315,Wednesday,15,475
6994,MLBR,2016-06-01 16:00:00,186,343,Wednesday,16,529
6995,MLBR,2016-06-01 17:00:00,540,1312,Wednesday,17,1852
6996,MLBR,2016-06-01 18:00:00,610,1167,Wednesday,18,1777
6997,MLBR,2016-06-01 19:00:00,318,603,Wednesday,19,921
6998,MLBR,2016-06-01 20:00:00,147,296,Wednesday,20,443
6999,MLBR,2016-06-01 21:00:00,104,245,Wednesday,21,349
7000,MLBR,2016-06-01 22:00:00,66,161,Wednesday,22,227
7001,MLBR,2016-06-01 23:00:00,40,90,Wednesday,23,130
7002,MLBR,2016-06-02 00:00:00,25,40,Thursday,0,65
7003,MLBR,2016-06-02 01:00:00,1,10,Thursday,1,11
7004,MLBR,2016-06-02 05:00:00,63,43,Thursday,5,106
7005,MLBR,2016-06-02 06:00:00,201,158,Thursday,6,359
7006,MLBR,2016-06-02 07:00:00,708,410,Thursday,7,1118
7007,MLBR,2016-06-02 08:00:00,1370,453,Thursday,8,1823
7008,MLBR,2016-06-02 09:00:00,1094,286,Thursday,9,1380
7009,MLBR,2016-06-02 10:00:00,499,161,Thursday,10,660
7010,MLBR,2016-06-02 11:00:00,276,144,Thursday,11,420
7011,MLBR,2016-06-02 12:00:00,197,136,Thursday,12,333
7012,MLBR,2016-06-02 13:00:00,167,156,Thursday,13,323
7013,MLBR,2016-06-02 14:00:00,169,231,Thursday,14,400
7014,MLBR,2016-06-02 15:00:00,171,320,Thursday,15,491
7015,MLBR,2016-06-02 16:00:00,326,609,Thursday,16,935
7016,MLBR,2016-06-02 17:00:00,613,1210,Thursday,17,1823
7017,MLBR,2016-06-02 18:00:00,588,872,Thursday,18,1460
7018,MLBR,2016-06-02 19:00:00,361,601,Thursday,19,962
7019,MLBR,2016-06-02 20:00:00,166,355,Thursday,20,521
7020,MLBR,2016-06-02 21:00:00,100,313,Thursday,21,413
7021,MLBR,2016-06-02 22:00:00,66,223,Thursday,22,289
7022,MLBR,2016-06-02 23:00:00,66,81,Thursday,23,147
7023,MLBR,2016-06-03 00:00:00,38,84,Friday,0,122
7024,MLBR,2016-06-03 05:00:00,60,45,Friday,5,105
7025,MLBR,2016-06-03 06:00:00,186,164,Friday,6,350
7026,MLBR,2016-06-03 07:00:00,635,355,Friday,7,990
7027,MLBR,2016-06-03 08:00:00,1151,389,Friday,8,1540
7028,MLBR,2016-06-03 09:00:00,895,268,Friday,9,1163
7029,MLBR,2016-06-03 10:00:00,477,173,Friday,10,650
7030,MLBR,2016-06-03 11:00:00,237,161,Friday,11,398
7031,MLBR,2016-06-03 12:00:00,231,151,Friday,12,382
7032,MLBR,2016-06-03 13:00:00,174,170,Friday,13,344
7033,MLBR,2016-06-03 14:00:00,194,289,Friday,14,483
7034,MLBR,2016-06-03 15:00:00,228,431,Friday,15,659
7035,MLBR,2016-06-03 16:00:00,290,666,Friday,16,956
7036,MLBR,2016-06-03 17:00:00,609,1010,Friday,17,1619
7037,MLBR,2016-06-03 18:00:00,603,931,Friday,18,1534
7038,MLBR,2016-06-03 19:00:00,496,479,Friday,19,975
7039,MLBR,2016-06-03 20:00:00,192,321,Friday,20,513
7040,MLBR,2016-06-03 21:00:00,100,204,Friday,21,304
7041,MLBR,2016-06-03 22:00:00,104,267,Friday,22,371
7042,MLBR,2016-06-03 23:00:00,124,182,Friday,23,306
7043,MLBR,2016-06-04 00:00:00,93,105,Saturday,0,198
7044,MLBR,2016-06-04 01:00:00,8,21,Saturday,1,29
7045,MLBR,2016-06-04 07:00:00,60,49,Saturday,7,109
7046,MLBR,2016-06-04 08:00:00,122,84,Saturday,8,206
7047,MLBR,2016-06-04 09:00:00,146,141,Saturday,9,287
7048,MLBR,2016-06-04 10:00:00,183,123,Saturday,10,306
7049,MLBR,2016-06-04 11:00:00,250,163,Saturday,11,413
7050,MLBR,2016-06-04 12:00:00,264,158,Saturday,12,422
7051,MLBR,2016-06-04 13:00:00,261,138,Saturday,13,399
7052,MLBR,2016-06-04 14:00:00,233,136,Saturday,14,369
7053,MLBR,2016-06-04 15:00:00,213,218,Saturday,15,431
7054,MLBR,2016-06-04 16:00:00,191,178,Saturday,16,369
7055,MLBR,2016-06-04 17:00:00,190,282,Saturday,17,472
7056,MLBR,2016-06-04 18:00:00,155,268,Saturday,18,423
7057,MLBR,2016-06-04 19:00:00,192,242,Saturday,19,434
7058,MLBR,2016-06-04 20:00:00,107,224,Saturday,20,331
7059,MLBR,2016-06-04 21:00:00,133,192,Saturday,21,325
7060,MLBR,2016-06-04 22:00:00,107,172,Saturday,22,279
7061,MLBR,2016-06-04 23:00:00,45,115,Saturday,23,160
7062,MLBR,2016-06-05 00:00:00,34,89,Sunday,0,123
7063,MLBR,2016-06-05 01:00:00,2,26,Sunday,1,28
7064,MLBR,2016-06-05 08:00:00,65,1,Sunday,8,66
7065,MLBR,2016-06-05 09:00:00,153,153,Sunday,9,306
7066,MLBR,2016-06-05 10:00:00,183,115,Sunday,10,298
7067,MLBR,2016-06-05 11:00:00,226,150,Sunday,11,376
7068,MLBR,2016-06-05 12:00:00,236,156,Sunday,12,392
7069,MLBR,2016-06-05 13:00:00,234,147,Sunday,13,381
7070,MLBR,2016-06-05 14:00:00,158,183,Sunday,14,341
7071,MLBR,2016-06-05 15:00:00,196,189,Sunday,15,385
7072,MLBR,2016-06-05 16:00:00,197,204,Sunday,16,401
7073,MLBR,2016-06-05 17:00:00,147,269,Sunday,17,416
7074,MLBR,2016-06-05 18:00:00,118,237,Sunday,18,355
7075,MLBR,2016-06-05 19:00:00,104,226,Sunday,19,330
7076,MLBR,2016-06-05 20:00:00,97,206,Sunday,20,303
7077,MLBR,2016-06-05 21:00:00,93,185,Sunday,21,278
7078,MLBR,2016-06-05 22:00:00,95,130,Sunday,22,225
7079,MLBR,2016-06-05 23:00:00,32,38,Sunday,23,70
7080,MLBR,2016-06-06 00:00:00,11,55,Monday,0,66
7081,MLBR,2016-06-06 01:00:00,1,7,Monday,1,8
7082,MLBR,2016-06-06 04:00:00,11,7,Monday,4,18
7083,MLBR,2016-06-06 05:00:00,69,44,Monday,5,113
7084,MLBR,2016-06-06 06:00:00,197,150,Monday,6,347
7085,MLBR,2016-06-06 07:00:00,766,399,Monday,7,1165
7086,MLBR,2016-06-06 08:00:00,1477,472,Monday,8,1949
7087,MLBR,2016-06-06 09:00:00,1172,299,Monday,9,1471
7088,MLBR,2016-06-06 10:00:00,499,166,Monday,10,665
7089,MLBR,2016-06-06 11:00:00,289,153,Monday,11,442
7090,MLBR,2016-06-06 12:00:00,206,148,Monday,12,354
7091,MLBR,2016-06-06 13:00:00,173,185,Monday,13,358
7092,MLBR,2016-06-06 14:00:00,178,307,Monday,14,485
7093,MLBR,2016-06-06 15:00:00,145,337,Monday,15,482
7094,MLBR,2016-06-06 16:00:00,243,578,Monday,16,821
7095,MLBR,2016-06-06 17:00:00,426,1216,Monday,17,1642
7096,MLBR,2016-06-06 18:00:00,555,1148,Monday,18,1703
7097,MLBR,2016-06-06 19:00:00,357,617,Monday,19,974
7098,MLBR,2016-06-06 20:00:00,146,311,Monday,20,457
7099,MLBR,2016-06-06 21:00:00,72,214,Monday,21,286
7100,MLBR,2016-06-06 22:00:00,73,209,Monday,22,282
7101,MLBR,2016-06-06 23:00:00,100,77,Monday,23,177
7102,MLBR,2016-06-07 00:00:00,73,49,Tuesday,0,122
7103,MLBR,2016-06-07 01:00:00,10,17,Tuesday,1,27
7104,MLBR,2016-06-07 05:00:00,73,40,Tuesday,5,113
7105,MLBR,2016-06-07 06:00:00,223,163,Tuesday,6,386
7106,MLBR,2016-06-07 07:00:00,705,413,Tuesday,7,1118
7107,MLBR,2016-06-07 08:00:00,1520,447,Tuesday,8,1967
7108,MLBR,2016-06-07 09:00:00,1145,230,Tuesday,9,1375
7109,MLBR,2016-06-07 10:00:00,549,221,Tuesday,10,770
7110,MLBR,2016-06-07 11:00:00,278,124,Tuesday,11,402
7111,MLBR,2016-06-07 12:00:00,208,144,Tuesday,12,352
7112,MLBR,2016-06-07 13:00:00,159,146,Tuesday,13,305
7113,MLBR,2016-06-07 14:00:00,189,227,Tuesday,14,416
7114,MLBR,2016-06-07 15:00:00,188,323,Tuesday,15,511
7115,MLBR,2016-06-07 16:00:00,293,610,Tuesday,16,903
7116,MLBR,2016-06-07 17:00:00,507,1163,Tuesday,17,1670
7117,MLBR,2016-06-07 18:00:00,652,1212,Tuesday,18,1864
7118,MLBR,2016-06-07 19:00:00,322,615,Tuesday,19,937
7119,MLBR,2016-06-07 20:00:00,150,337,Tuesday,20,487
7120,MLBR,2016-06-07 21:00:00,71,230,Tuesday,21,301
7121,MLBR,2016-06-07 22:00:00,91,193,Tuesday,22,284
7122,MLBR,2016-06-07 23:00:00,46,124,Tuesday,23,170
7123,MLBR,2016-06-08 00:00:00,19,63,Wednesday,0,82
7124,MLBR,2016-06-08 01:00:00,4,12,Wednesday,1,16
7125,MLBR,2016-06-08 05:00:00,64,46,Wednesday,5,110
7126,MLBR,2016-06-08 06:00:00,203,161,Wednesday,6,364
7127,MLBR,2016-06-08 07:00:00,718,427,Wednesday,7,1145
7128,MLBR,2016-06-08 08:00:00,1462,431,Wednesday,8,1893
7129,MLBR,2016-06-08 09:00:00,1116,249,Wednesday,9,1365
7130,MLBR,2016-06-08 10:00:00,496,163,Wednesday,10,659
7131,MLBR,2016-06-08 11:00:00,274,113,Wednesday,11,387
7132,MLBR,2016-06-08 12:00:00,194,143,Wednesday,12,337
7133,MLBR,2016-06-08 13:00:00,170,153,Wednesday,13,323
7134,MLBR,2016-06-08 14:00:00,193,230,Wednesday,14,423
7135,MLBR,2016-06-08 15:00:00,171,304,Wednesday,15,475
7136,MLBR,2016-06-08 16:00:00,322,600,Wednesday,16,922
7137,MLBR,2016-06-08 17:00:00,578,1260,Wednesday,17,1838
7138,MLBR,2016-06-08 18:00:00,649,1093,Wednesday,18,1742
7139,MLBR,2016-06-08 19:00:00,345,567,Wednesday,19,912
7140,MLBR,2016-06-08 20:00:00,142,306,Wednesday,20,448
7141,MLBR,2016-06-08 21:00:00,85,288,Wednesday,21,373
7142,MLBR,2016-06-08 22:00:00,76,252,Wednesday,22,328
7143,MLBR,2016-06-08 23:00:00,45,134,Wednesday,23,179
7144,MLBR,2016-06-09 00:00:00,12,68,Thursday,0,80
7145,MLBR,2016-06-09 01:00:00,3,11,Thursday,1,14
7146,MLBR,2016-06-09 05:00:00,68,37,Thursday,5,105
7147,MLBR,2016-06-09 06:00:00,206,147,Thursday,6,353
7148,MLBR,2016-06-09 07:00:00,702,410,Thursday,7,1112
7149,MLBR,2016-06-09 08:00:00,1405,447,Thursday,8,1852
7150,MLBR,2016-06-09 09:00:00,1119,258,Thursday,9,1377
7151,MLBR,2016-06-09 10:00:00,482,167,Thursday,10,649
7152,MLBR,2016-06-09 11:00:00,278,128,Thursday,11,406
7153,MLBR,2016-06-09 12:00:00,242,147,Thursday,12,389
7154,MLBR,2016-06-09 13:00:00,178,137,Thursday,13,315
7155,MLBR,2016-06-09 14:00:00,174,216,Thursday,14,390
7156,MLBR,2016-06-09 15:00:00,189,306,Thursday,15,495
7157,MLBR,2016-06-09 16:00:00,340,563,Thursday,16,903
7158,MLBR,2016-06-09 17:00:00,540,1150,Thursday,17,1690
7159,MLBR,2016-06-09 18:00:00,640,1087,Thursday,18,1727
7160,MLBR,2016-06-09 19:00:00,363,648,Thursday,19,1011
7161,MLBR,2016-06-09 20:00:00,144,209,Thursday,20,353
7162,MLBR,2016-06-09 21:00:00,98,426,Thursday,21,524
7163,MLBR,2016-06-09 22:00:00,96,216,Thursday,22,312
7164,MLBR,2016-06-09 23:00:00,65,150,Thursday,23,215
7165,MLBR,2016-06-10 00:00:00,24,69,Friday,0,93
7166,MLBR,2016-06-10 01:00:00,2,20,Friday,1,22
7167,MLBR,2016-06-10 05:00:00,63,38,Friday,5,101
7168,MLBR,2016-06-10 06:00:00,161,126,Friday,6,287
7169,MLBR,2016-06-10 07:00:00,580,344,Friday,7,924
7170,MLBR,2016-06-10 08:00:00,1168,381,Friday,8,1549
7171,MLBR,2016-06-10 09:00:00,960,261,Friday,9,1221
7172,MLBR,2016-06-10 10:00:00,450,163,Friday,10,613
7173,MLBR,2016-06-10 11:00:00,342,156,Friday,11,498
7174,MLBR,2016-06-10 12:00:00,277,134,Friday,12,411
7175,MLBR,2016-06-10 13:00:00,213,167,Friday,13,380
7176,MLBR,2016-06-10 14:00:00,224,266,Friday,14,490
7177,MLBR,2016-06-10 15:00:00,219,378,Friday,15,597
7178,MLBR,2016-06-10 16:00:00,378,635,Friday,16,1013
7179,MLBR,2016-06-10 17:00:00,561,1110,Friday,17,1671
7180,MLBR,2016-06-10 18:00:00,702,897,Friday,18,1599
7181,MLBR,2016-06-10 19:00:00,377,394,Friday,19,771
7182,MLBR,2016-06-10 20:00:00,171,256,Friday,20,427
7183,MLBR,2016-06-10 21:00:00,96,207,Friday,21,303
7184,MLBR,2016-06-10 22:00:00,97,236,Friday,22,333
7185,MLBR,2016-06-10 23:00:00,73,209,Friday,23,282
7186,MLBR,2016-06-11 00:00:00,51,114,Saturday,0,165
7187,MLBR,2016-06-11 01:00:00,2,22,Saturday,1,24
7188,MLBR,2016-06-11 07:00:00,61,56,Saturday,7,117
7189,MLBR,2016-06-11 08:00:00,109,89,Saturday,8,198
7190,MLBR,2016-06-11 09:00:00,210,143,Saturday,9,353
7191,MLBR,2016-06-11 10:00:00,211,148,Saturday,10,359
7192,MLBR,2016-06-11 11:00:00,296,135,Saturday,11,431
7193,MLBR,2016-06-11 12:00:00,385,160,Saturday,12,545
7194,MLBR,2016-06-11 13:00:00,297,165,Saturday,13,462
7195,MLBR,2016-06-11 14:00:00,301,178,Saturday,14,479
7196,MLBR,2016-06-11 15:00:00,303,217,Saturday,15,520
7197,MLBR,2016-06-11 16:00:00,222,202,Saturday,16,424
7198,MLBR,2016-06-11 17:00:00,192,287,Saturday,17,479
7199,MLBR,2016-06-11 18:00:00,185,217,Saturday,18,402
7200,MLBR,2016-06-11 19:00:00,139,246,Saturday,19,385
7201,MLBR,2016-06-11 20:00:00,124,202,Saturday,20,326
7202,MLBR,2016-06-11 21:00:00,95,258,Saturday,21,353
7203,MLBR,2016-06-11 22:00:00,104,204,Saturday,22,308
7204,MLBR,2016-06-11 23:00:00,63,154,Saturday,23,217
7205,MLBR,2016-06-12 00:00:00,29,90,Sunday,0,119
7206,MLBR,2016-06-12 01:00:00,2,25,Sunday,1,27
7207,MLBR,2016-06-12 08:00:00,57,1,Sunday,8,58
7208,MLBR,2016-06-12 09:00:00,136,142,Sunday,9,278
7209,MLBR,2016-06-12 10:00:00,165,159,Sunday,10,324
7210,MLBR,2016-06-12 11:00:00,232,136,Sunday,11,368
7211,MLBR,2016-06-12 12:00:00,343,124,Sunday,12,467
7212,MLBR,2016-06-12 13:00:00,226,178,Sunday,13,404
7213,MLBR,2016-06-12 14:00:00,150,145,Sunday,14,295
7214,MLBR,2016-06-12 15:00:00,180,176,Sunday,15,356
7215,MLBR,2016-06-12 16:00:00,164,218,Sunday,16,382
7216,MLBR,2016-06-12 17:00:00,164,298,Sunday,17,462
7217,MLBR,2016-06-12 18:00:00,156,246,Sunday,18,402
7218,MLBR,2016-06-12 19:00:00,158,207,Sunday,19,365
7219,MLBR,2016-06-12 20:00:00,95,224,Sunday,20,319
7220,MLBR,2016-06-12 21:00:00,98,170,Sunday,21,268
7221,MLBR,2016-06-12 22:00:00,89,151,Sunday,22,240
7222,MLBR,2016-06-12 23:00:00,47,83,Sunday,23,130
7223,MLBR,2016-06-13 00:00:00,6,61,Monday,0,67
7224,MLBR,2016-06-13 04:00:00,14,1,Monday,4,15
7225,MLBR,2016-06-13 05:00:00,66,46,Monday,5,112
7226,MLBR,2016-06-13 06:00:00,200,143,Monday,6,343
7227,MLBR,2016-06-13 07:00:00,742,381,Monday,7,1123
7228,MLBR,2016-06-13 08:00:00,1505,434,Monday,8,1939
7229,MLBR,2016-06-13 09:00:00,1123,283,Monday,9,1406
7230,MLBR,2016-06-13 10:00:00,489,155,Monday,10,644
7231,MLBR,2016-06-13 11:00:00,256,175,Monday,11,431
7232,MLBR,2016-06-13 12:00:00,206,150,Monday,12,356
7233,MLBR,2016-06-13 13:00:00,149,165,Monday,13,314
7234,MLBR,2016-06-13 14:00:00,174,172,Monday,14,346
7235,MLBR,2016-06-13 15:00:00,157,302,Monday,15,459
7236,MLBR,2016-06-13 16:00:00,317,643,Monday,16,960
7237,MLBR,2016-06-13 17:00:00,565,1332,Monday,17,1897
7238,MLBR,2016-06-13 18:00:00,669,1198,Monday,18,1867
7239,MLBR,2016-06-13 19:00:00,301,520,Monday,19,821
7240,MLBR,2016-06-13 20:00:00,114,262,Monday,20,376
7241,MLBR,2016-06-13 21:00:00,75,256,Monday,21,331
7242,MLBR,2016-06-13 22:00:00,86,264,Monday,22,350
7243,MLBR,2016-06-13 23:00:00,79,99,Monday,23,178
7244,MLBR,2016-06-14 00:00:00,37,57,Tuesday,0,94
7245,MLBR,2016-06-14 01:00:00,2,10,Tuesday,1,12
7246,MLBR,2016-06-14 05:00:00,66,36,Tuesday,5,102
7247,MLBR,2016-06-14 06:00:00,201,158,Tuesday,6,359
7248,MLBR,2016-06-14 07:00:00,747,439,Tuesday,7,1186
7249,MLBR,2016-06-14 08:00:00,1519,457,Tuesday,8,1976
7250,MLBR,2016-06-14 09:00:00,1050,277,Tuesday,9,1327
7251,MLBR,2016-06-14 10:00:00,605,150,Tuesday,10,755
7252,MLBR,2016-06-14 11:00:00,298,109,Tuesday,11,407
7253,MLBR,2016-06-14 12:00:00,202,116,Tuesday,12,318
7254,MLBR,2016-06-14 13:00:00,181,129,Tuesday,13,310
7255,MLBR,2016-06-14 14:00:00,146,236,Tuesday,14,382
7256,MLBR,2016-06-14 15:00:00,137,293,Tuesday,15,430
7257,MLBR,2016-06-14 16:00:00,267,561,Tuesday,16,828
7258,MLBR,2016-06-14 17:00:00,514,1260,Tuesday,17,1774
7259,MLBR,2016-06-14 18:00:00,621,1101,Tuesday,18,1722
7260,MLBR,2016-06-14 19:00:00,329,633,Tuesday,19,962
7261,MLBR,2016-06-14 20:00:00,161,331,Tuesday,20,492
7262,MLBR,2016-06-14 21:00:00,94,255,Tuesday,21,349
7263,MLBR,2016-06-14 22:00:00,70,129,Tuesday,22,199
7264,MLBR,2016-06-14 23:00:00,48,194,Tuesday,23,242
7265,MONT,2016-06-01 01:00:00,69,4,Wednesday,1,73
7266,MONT,2016-06-01 04:00:00,6,128,Wednesday,4,134
7267,MONT,2016-06-01 05:00:00,46,1205,Wednesday,5,1251
7268,MONT,2016-06-01 06:00:00,115,2856,Wednesday,6,2971
7269,MONT,2016-06-01 07:00:00,412,7408,Wednesday,7,7820
7270,MONT,2016-06-01 08:00:00,648,13322,Wednesday,8,13970
7271,MONT,2016-06-01 09:00:00,473,8847,Wednesday,9,9320
7272,MONT,2016-06-01 10:00:00,394,4032,Wednesday,10,4426
7273,MONT,2016-06-01 11:00:00,509,1624,Wednesday,11,2133
7274,MONT,2016-06-01 12:00:00,785,1303,Wednesday,12,2088
7275,MONT,2016-06-01 13:00:00,1005,1068,Wednesday,13,2073
7276,MONT,2016-06-01 14:00:00,1416,970,Wednesday,14,2386
7277,MONT,2016-06-01 15:00:00,2304,820,Wednesday,15,3124
7278,MONT,2016-06-01 16:00:00,4595,895,Wednesday,16,5490
7279,MONT,2016-06-01 17:00:00,9762,1111,Wednesday,17,10873
7280,MONT,2016-06-01 18:00:00,11243,819,Wednesday,18,12062
7281,MONT,2016-06-01 19:00:00,5286,357,Wednesday,19,5643
7282,MONT,2016-06-01 20:00:00,2551,211,Wednesday,20,2762
7283,MONT,2016-06-01 21:00:00,1604,195,Wednesday,21,1799
7284,MONT,2016-06-01 22:00:00,1034,178,Wednesday,22,1212
7285,MONT,2016-06-01 23:00:00,613,96,Wednesday,23,709
7286,MONT,2016-06-02 00:00:00,352,34,Thursday,0,386
7287,MONT,2016-06-02 01:00:00,59,3,Thursday,1,62
7288,MONT,2016-06-02 04:00:00,7,135,Thursday,4,142
7289,MONT,2016-06-02 05:00:00,50,1190,Thursday,5,1240
7290,MONT,2016-06-02 06:00:00,135,2753,Thursday,6,2888
7291,MONT,2016-06-02 07:00:00,358,7168,Thursday,7,7526
7292,MONT,2016-06-02 08:00:00,615,11994,Thursday,8,12609
7293,MONT,2016-06-02 09:00:00,489,9838,Thursday,9,10327
7294,MONT,2016-06-02 10:00:00,414,4005,Thursday,10,4419
7295,MONT,2016-06-02 11:00:00,507,1867,Thursday,11,2374
7296,MONT,2016-06-02 12:00:00,720,1351,Thursday,12,2071
7297,MONT,2016-06-02 13:00:00,973,1122,Thursday,13,2095
7298,MONT,2016-06-02 14:00:00,1535,1152,Thursday,14,2687
7299,MONT,2016-06-02 15:00:00,2644,856,Thursday,15,3500
7300,MONT,2016-06-02 16:00:00,4565,928,Thursday,16,5493
7301,MONT,2016-06-02 17:00:00,11577,1246,Thursday,17,12823
7302,MONT,2016-06-02 18:00:00,9692,958,Thursday,18,10650
7303,MONT,2016-06-02 19:00:00,4953,388,Thursday,19,5341
7304,MONT,2016-06-02 20:00:00,2299,239,Thursday,20,2538
7305,MONT,2016-06-02 21:00:00,2063,494,Thursday,21,2557
7306,MONT,2016-06-02 22:00:00,1113,203,Thursday,22,1316
7307,MONT,2016-06-02 23:00:00,679,92,Thursday,23,771
7308,MONT,2016-06-03 00:00:00,407,31,Friday,0,438
7309,MONT,2016-06-03 01:00:00,93,12,Friday,1,105
7310,MONT,2016-06-03 04:00:00,13,111,Friday,4,124
7311,MONT,2016-06-03 05:00:00,42,1089,Friday,5,1131
7312,MONT,2016-06-03 06:00:00,119,2432,Friday,6,2551
7313,MONT,2016-06-03 07:00:00,379,6096,Friday,7,6475
7314,MONT,2016-06-03 08:00:00,553,11231,Friday,8,11784
7315,MONT,2016-06-03 09:00:00,495,8627,Friday,9,9122
7316,MONT,2016-06-03 10:00:00,435,3653,Friday,10,4088
7317,MONT,2016-06-03 11:00:00,600,1709,Friday,11,2309
7318,MONT,2016-06-03 12:00:00,1002,1299,Friday,12,2301
7319,MONT,2016-06-03 13:00:00,1554,1087,Friday,13,2641
7320,MONT,2016-06-03 14:00:00,2027,1056,Friday,14,3083
7321,MONT,2016-06-03 15:00:00,2940,917,Friday,15,3857
7322,MONT,2016-06-03 16:00:00,5085,953,Friday,16,6038
7323,MONT,2016-06-03 17:00:00,8716,932,Friday,17,9648
7324,MONT,2016-06-03 18:00:00,8357,694,Friday,18,9051
7325,MONT,2016-06-03 19:00:00,3749,499,Friday,19,4248
7326,MONT,2016-06-03 20:00:00,1850,320,Friday,20,2170
7327,MONT,2016-06-03 21:00:00,1295,283,Friday,21,1578
7328,MONT,2016-06-03 22:00:00,801,306,Friday,22,1107
7329,MONT,2016-06-03 23:00:00,743,246,Friday,23,989
7330,MONT,2016-06-04 00:00:00,503,90,Saturday,0,593
7331,MONT,2016-06-04 01:00:00,84,7,Saturday,1,91
7332,MONT,2016-06-04 06:00:00,21,310,Saturday,6,331
7333,MONT,2016-06-04 07:00:00,89,530,Saturday,7,619
7334,MONT,2016-06-04 08:00:00,112,969,Saturday,8,1081
7335,MONT,2016-06-04 09:00:00,178,951,Saturday,9,1129
7336,MONT,2016-06-04 10:00:00,182,1167,Saturday,10,1349
7337,MONT,2016-06-04 11:00:00,296,945,Saturday,11,1241
7338,MONT,2016-06-04 12:00:00,383,914,Saturday,12,1297
7339,MONT,2016-06-04 13:00:00,395,848,Saturday,13,1243
7340,MONT,2016-06-04 14:00:00,525,811,Saturday,14,1336
7341,MONT,2016-06-04 15:00:00,729,654,Saturday,15,1383
7342,MONT,2016-06-04 16:00:00,738,553,Saturday,16,1291
7343,MONT,2016-06-04 17:00:00,926,528,Saturday,17,1454
7344,MONT,2016-06-04 18:00:00,870,424,Saturday,18,1294
7345,MONT,2016-06-04 19:00:00,720,321,Saturday,19,1041
7346,MONT,2016-06-04 20:00:00,525,290,Saturday,20,815
7347,MONT,2016-06-04 21:00:00,416,246,Saturday,21,662
7348,MONT,2016-06-04 22:00:00,475,292,Saturday,22,767
7349,MONT,2016-06-04 23:00:00,469,167,Saturday,23,636
7350,MONT,2016-06-05 00:00:00,375,48,Sunday,0,423
7351,MONT,2016-06-05 01:00:00,50,9,Sunday,1,59
7352,MONT,2016-06-05 08:00:00,117,515,Sunday,8,632
7353,MONT,2016-06-05 09:00:00,137,608,Sunday,9,745
7354,MONT,2016-06-05 10:00:00,195,834,Sunday,10,1029
7355,MONT,2016-06-05 11:00:00,242,1041,Sunday,11,1283
7356,MONT,2016-06-05 12:00:00,255,733,Sunday,12,988
7357,MONT,2016-06-05 13:00:00,316,643,Sunday,13,959
7358,MONT,2016-06-05 14:00:00,363,634,Sunday,14,997
7359,MONT,2016-06-05 15:00:00,487,444,Sunday,15,931
7360,MONT,2016-06-05 16:00:00,637,391,Sunday,16,1028
7361,MONT,2016-06-05 17:00:00,755,295,Sunday,17,1050
7362,MONT,2016-06-05 18:00:00,612,277,Sunday,18,889
7363,MONT,2016-06-05 19:00:00,474,208,Sunday,19,682
7364,MONT,2016-06-05 20:00:00,419,411,Sunday,20,830
7365,MONT,2016-06-05 21:00:00,329,223,Sunday,21,552
7366,MONT,2016-06-05 22:00:00,255,170,Sunday,22,425
7367,MONT,2016-06-05 23:00:00,229,75,Sunday,23,304
7368,MONT,2016-06-06 00:00:00,145,28,Monday,0,173
7369,MONT,2016-06-06 01:00:00,21,4,Monday,1,25
7370,MONT,2016-06-06 04:00:00,4,168,Monday,4,172
7371,MONT,2016-06-06 05:00:00,26,1167,Monday,5,1193
7372,MONT,2016-06-06 06:00:00,107,2641,Monday,6,2748
7373,MONT,2016-06-06 07:00:00,389,6955,Monday,7,7344
7374,MONT,2016-06-06 08:00:00,622,13011,Monday,8,13633
7375,MONT,2016-06-06 09:00:00,494,9761,Monday,9,10255
7376,MONT,2016-06-06 10:00:00,400,3654,Monday,10,4054
7377,MONT,2016-06-06 11:00:00,528,1634,Monday,11,2162
7378,MONT,2016-06-06 12:00:00,706,1282,Monday,12,1988
7379,MONT,2016-06-06 13:00:00,900,1041,Monday,13,1941
7380,MONT,2016-06-06 14:00:00,1547,939,Monday,14,2486
7381,MONT,2016-06-06 15:00:00,2344,779,Monday,15,3123
7382,MONT,2016-06-06 16:00:00,4927,819,Monday,16,5746
7383,MONT,2016-06-06 17:00:00,9979,970,Monday,17,10949
7384,MONT,2016-06-06 18:00:00,10982,767,Monday,18,11749
7385,MONT,2016-06-06 19:00:00,5342,315,Monday,19,5657
7386,MONT,2016-06-06 20:00:00,2347,194,Monday,20,2541
7387,MONT,2016-06-06 21:00:00,1434,169,Monday,21,1603
7388,MONT,2016-06-06 22:00:00,876,188,Monday,22,1064
7389,MONT,2016-06-06 23:00:00,564,85,Monday,23,649
7390,MONT,2016-06-07 00:00:00,266,26,Tuesday,0,292
7391,MONT,2016-06-07 01:00:00,51,8,Tuesday,1,59
7392,MONT,2016-06-07 04:00:00,12,174,Tuesday,4,186
7393,MONT,2016-06-07 05:00:00,39,1199,Tuesday,5,1238
7394,MONT,2016-06-07 06:00:00,110,2710,Tuesday,6,2820
7395,MONT,2016-06-07 07:00:00,394,6861,Tuesday,7,7255
7396,MONT,2016-06-07 08:00:00,677,13260,Tuesday,8,13937
7397,MONT,2016-06-07 09:00:00,490,9681,Tuesday,9,10171
7398,MONT,2016-06-07 10:00:00,422,4100,Tuesday,10,4522
7399,MONT,2016-06-07 11:00:00,492,1751,Tuesday,11,2243
7400,MONT,2016-06-07 12:00:00,708,1394,Tuesday,12,2102
7401,MONT,2016-06-07 13:00:00,920,1137,Tuesday,13,2057
7402,MONT,2016-06-07 14:00:00,1597,1057,Tuesday,14,2654
7403,MONT,2016-06-07 15:00:00,2402,939,Tuesday,15,3341
7404,MONT,2016-06-07 16:00:00,5088,949,Tuesday,16,6037
7405,MONT,2016-06-07 17:00:00,10262,1407,Tuesday,17,11669
7406,MONT,2016-06-07 18:00:00,10556,1242,Tuesday,18,11798
7407,MONT,2016-06-07 19:00:00,5577,430,Tuesday,19,6007
7408,MONT,2016-06-07 20:00:00,2446,226,Tuesday,20,2672
7409,MONT,2016-06-07 21:00:00,1519,201,Tuesday,21,1720
7410,MONT,2016-06-07 22:00:00,1382,188,Tuesday,22,1570
7411,MONT,2016-06-07 23:00:00,1406,78,Tuesday,23,1484
7412,MONT,2016-06-08 00:00:00,552,36,Wednesday,0,588
7413,MONT,2016-06-08 01:00:00,86,3,Wednesday,1,89
7414,MONT,2016-06-08 03:00:00,1,1,Wednesday,3,2
7415,MONT,2016-06-08 04:00:00,12,178,Wednesday,4,190
7416,MONT,2016-06-08 05:00:00,40,1178,Wednesday,5,1218
7417,MONT,2016-06-08 06:00:00,100,2732,Wednesday,6,2832
7418,MONT,2016-06-08 07:00:00,381,7259,Wednesday,7,7640
7419,MONT,2016-06-08 08:00:00,606,12187,Wednesday,8,12793
7420,MONT,2016-06-08 09:00:00,517,9843,Wednesday,9,10360
7421,MONT,2016-06-08 10:00:00,451,4000,Wednesday,10,4451
7422,MONT,2016-06-08 11:00:00,485,1740,Wednesday,11,2225
7423,MONT,2016-06-08 12:00:00,741,1417,Wednesday,12,2158
7424,MONT,2016-06-08 13:00:00,1015,1101,Wednesday,13,2116
7425,MONT,2016-06-08 14:00:00,1588,990,Wednesday,14,2578
7426,MONT,2016-06-08 15:00:00,2346,887,Wednesday,15,3233
7427,MONT,2016-06-08 16:00:00,4990,992,Wednesday,16,5982
7428,MONT,2016-06-08 17:00:00,10598,1368,Wednesday,17,11966
7429,MONT,2016-06-08 18:00:00,10731,1148,Wednesday,18,11879
7430,MONT,2016-06-08 19:00:00,4545,420,Wednesday,19,4965
7431,MONT,2016-06-08 20:00:00,2271,183,Wednesday,20,2454
7432,MONT,2016-06-08 21:00:00,1858,322,Wednesday,21,2180
7433,MONT,2016-06-08 22:00:00,1430,190,Wednesday,22,1620
7434,MONT,2016-06-08 23:00:00,1489,140,Wednesday,23,1629
7435,MONT,2016-06-09 00:00:00,473,47,Thursday,0,520
7436,MONT,2016-06-09 01:00:00,78,8,Thursday,1,86
7437,MONT,2016-06-09 03:00:00,1,1,Thursday,3,2
7438,MONT,2016-06-09 04:00:00,16,117,Thursday,4,133
7439,MONT,2016-06-09 05:00:00,46,1210,Thursday,5,1256
7440,MONT,2016-06-09 06:00:00,111,2675,Thursday,6,2786
7441,MONT,2016-06-09 07:00:00,368,6379,Thursday,7,6747
7442,MONT,2016-06-09 08:00:00,640,12978,Thursday,8,13618
7443,MONT,2016-06-09 09:00:00,486,9345,Thursday,9,9831
7444,MONT,2016-06-09 10:00:00,422,3991,Thursday,10,4413
7445,MONT,2016-06-09 11:00:00,554,1922,Thursday,11,2476
7446,MONT,2016-06-09 12:00:00,821,1423,Thursday,12,2244
7447,MONT,2016-06-09 13:00:00,994,1067,Thursday,13,2061
7448,MONT,2016-06-09 14:00:00,1552,1114,Thursday,14,2666
7449,MONT,2016-06-09 15:00:00,2548,951,Thursday,15,3499
7450,MONT,2016-06-09 16:00:00,4868,920,Thursday,16,5788
7451,MONT,2016-06-09 17:00:00,9815,1261,Thursday,17,11076
7452,MONT,2016-06-09 18:00:00,10429,935,Thursday,18,11364
7453,MONT,2016-06-09 19:00:00,5287,397,Thursday,19,5684
7454,MONT,2016-06-09 20:00:00,2555,264,Thursday,20,2819
7455,MONT,2016-06-09 21:00:00,1997,224,Thursday,21,2221
7456,MONT,2016-06-09 22:00:00,1189,209,Thursday,22,1398
7457,MONT,2016-06-09 23:00:00,799,121,Thursday,23,920
7458,MONT,2016-06-10 00:00:00,424,51,Friday,0,475
7459,MONT,2016-06-10 01:00:00,64,4,Friday,1,68
7460,MONT,2016-06-10 03:00:00,1,1,Friday,3,2
7461,MONT,2016-06-10 04:00:00,12,103,Friday,4,115
7462,MONT,2016-06-10 05:00:00,45,1071,Friday,5,1116
7463,MONT,2016-06-10 06:00:00,98,2376,Friday,6,2474
7464,MONT,2016-06-10 07:00:00,371,6067,Friday,7,6438
7465,MONT,2016-06-10 08:00:00,561,11200,Friday,8,11761
7466,MONT,2016-06-10 09:00:00,442,8099,Friday,9,8541
7467,MONT,2016-06-10 10:00:00,428,3730,Friday,10,4158
7468,MONT,2016-06-10 11:00:00,567,1864,Friday,11,2431
7469,MONT,2016-06-10 12:00:00,885,1444,Friday,12,2329
7470,MONT,2016-06-10 13:00:00,1354,1137,Friday,13,2491
7471,MONT,2016-06-10 14:00:00,1989,1056,Friday,14,3045
7472,MONT,2016-06-10 15:00:00,2983,1047,Friday,15,4030
7473,MONT,2016-06-10 16:00:00,5082,1106,Friday,16,6188
7474,MONT,2016-06-10 17:00:00,9213,1371,Friday,17,10584
7475,MONT,2016-06-10 18:00:00,7856,1156,Friday,18,9012
7476,MONT,2016-06-10 19:00:00,3243,523,Friday,19,3766
7477,MONT,2016-06-10 20:00:00,1472,299,Friday,20,1771
7478,MONT,2016-06-10 21:00:00,1249,316,Friday,21,1565
7479,MONT,2016-06-10 22:00:00,1294,336,Friday,22,1630
7480,MONT,2016-06-10 23:00:00,1540,188,Friday,23,1728
7481,MONT,2016-06-11 00:00:00,657,103,Saturday,0,760
7482,MONT,2016-06-11 01:00:00,120,7,Saturday,1,127
7483,MONT,2016-06-11 06:00:00,47,211,Saturday,6,258
7484,MONT,2016-06-11 07:00:00,90,579,Saturday,7,669
7485,MONT,2016-06-11 08:00:00,130,828,Saturday,8,958
7486,MONT,2016-06-11 09:00:00,173,1133,Saturday,9,1306
7487,MONT,2016-06-11 10:00:00,233,1160,Saturday,10,1393
7488,MONT,2016-06-11 11:00:00,280,1086,Saturday,11,1366
7489,MONT,2016-06-11 12:00:00,353,1210,Saturday,12,1563
7490,MONT,2016-06-11 13:00:00,370,1162,Saturday,13,1532
7491,MONT,2016-06-11 14:00:00,485,1345,Saturday,14,1830
7492,MONT,2016-06-11 15:00:00,666,1113,Saturday,15,1779
7493,MONT,2016-06-11 16:00:00,849,777,Saturday,16,1626
7494,MONT,2016-06-11 17:00:00,1020,495,Saturday,17,1515
7495,MONT,2016-06-11 18:00:00,972,478,Saturday,18,1450
7496,MONT,2016-06-11 19:00:00,892,279,Saturday,19,1171
7497,MONT,2016-06-11 20:00:00,774,333,Saturday,20,1107
7498,MONT,2016-06-11 21:00:00,973,269,Saturday,21,1242
7499,MONT,2016-06-11 22:00:00,953,239,Saturday,22,1192
7500,MONT,2016-06-11 23:00:00,565,222,Saturday,23,787
7501,MONT,2016-06-12 00:00:00,410,84,Sunday,0,494
7502,MONT,2016-06-12 01:00:00,97,4,Sunday,1,101
7503,MONT,2016-06-12 07:00:00,1,1,Sunday,7,2
7504,MONT,2016-06-12 08:00:00,99,500,Sunday,8,599
7505,MONT,2016-06-12 09:00:00,172,617,Sunday,9,789
7506,MONT,2016-06-12 10:00:00,181,792,Sunday,10,973
7507,MONT,2016-06-12 11:00:00,242,889,Sunday,11,1131
7508,MONT,2016-06-12 12:00:00,252,924,Sunday,12,1176
7509,MONT,2016-06-12 13:00:00,296,742,Sunday,13,1038
7510,MONT,2016-06-12 14:00:00,367,770,Sunday,14,1137
7511,MONT,2016-06-12 15:00:00,460,681,Sunday,15,1141
7512,MONT,2016-06-12 16:00:00,519,640,Sunday,16,1159
7513,MONT,2016-06-12 17:00:00,746,405,Sunday,17,1151
7514,MONT,2016-06-12 18:00:00,714,281,Sunday,18,995
7515,MONT,2016-06-12 19:00:00,541,233,Sunday,19,774
7516,MONT,2016-06-12 20:00:00,426,206,Sunday,20,632
7517,MONT,2016-06-12 21:00:00,837,187,Sunday,21,1024
7518,MONT,2016-06-12 22:00:00,759,184,Sunday,22,943
7519,MONT,2016-06-12 23:00:00,295,95,Sunday,23,390
7520,MONT,2016-06-13 00:00:00,170,58,Monday,0,228
7521,MONT,2016-06-13 01:00:00,23,8,Monday,1,31
7522,MONT,2016-06-13 04:00:00,6,157,Monday,4,163
7523,MONT,2016-06-13 05:00:00,36,1152,Monday,5,1188
7524,MONT,2016-06-13 06:00:00,103,2507,Monday,6,2610
7525,MONT,2016-06-13 07:00:00,363,7097,Monday,7,7460
7526,MONT,2016-06-13 08:00:00,686,13019,Monday,8,13705
7527,MONT,2016-06-13 09:00:00,506,9336,Monday,9,9842
7528,MONT,2016-06-13 10:00:00,363,3797,Monday,10,4160
7529,MONT,2016-06-13 11:00:00,457,1641,Monday,11,2098
7530,MONT,2016-06-13 12:00:00,667,1286,Monday,12,1953
7531,MONT,2016-06-13 13:00:00,891,1083,Monday,13,1974
7532,MONT,2016-06-13 14:00:00,1514,924,Monday,14,2438
7533,MONT,2016-06-13 15:00:00,2446,875,Monday,15,3321
7534,MONT,2016-06-13 16:00:00,5335,912,Monday,16,6247
7535,MONT,2016-06-13 17:00:00,11444,1232,Monday,17,12676
7536,MONT,2016-06-13 18:00:00,10745,985,Monday,18,11730
7537,MONT,2016-06-13 19:00:00,4349,335,Monday,19,4684
7538,MONT,2016-06-13 20:00:00,1801,182,Monday,20,1983
7539,MONT,2016-06-13 21:00:00,1701,508,Monday,21,2209
7540,MONT,2016-06-13 22:00:00,1153,257,Monday,22,1410
7541,MONT,2016-06-13 23:00:00,1055,123,Monday,23,1178
7542,MONT,2016-06-14 00:00:00,468,31,Tuesday,0,499
7543,MONT,2016-06-14 01:00:00,63,5,Tuesday,1,68
7544,MONT,2016-06-14 04:00:00,9,172,Tuesday,4,181
7545,MONT,2016-06-14 05:00:00,49,1149,Tuesday,5,1198
7546,MONT,2016-06-14 06:00:00,130,2819,Tuesday,6,2949
7547,MONT,2016-06-14 07:00:00,422,7069,Tuesday,7,7491
7548,MONT,2016-06-14 08:00:00,665,13153,Tuesday,8,13818
7549,MONT,2016-06-14 09:00:00,525,9887,Tuesday,9,10412
7550,MONT,2016-06-14 10:00:00,419,3916,Tuesday,10,4335
7551,MONT,2016-06-14 11:00:00,537,1861,Tuesday,11,2398
7552,MONT,2016-06-14 12:00:00,739,1269,Tuesday,12,2008
7553,MONT,2016-06-14 13:00:00,956,1076,Tuesday,13,2032
7554,MONT,2016-06-14 14:00:00,1491,1029,Tuesday,14,2520
7555,MONT,2016-06-14 15:00:00,2319,887,Tuesday,15,3206
7556,MONT,2016-06-14 16:00:00,4584,918,Tuesday,16,5502
7557,MONT,2016-06-14 17:00:00,10471,1297,Tuesday,17,11768
7558,MONT,2016-06-14 18:00:00,10819,1203,Tuesday,18,12022
7559,MONT,2016-06-14 19:00:00,5457,447,Tuesday,19,5904
7560,MONT,2016-06-14 20:00:00,2502,186,Tuesday,20,2688
7561,MONT,2016-06-14 21:00:00,1498,252,Tuesday,21,1750
7562,MONT,2016-06-14 22:00:00,1365,198,Tuesday,22,1563
7563,MONT,2016-06-14 23:00:00,1458,88,Tuesday,23,1546
7564,NBRK,2016-06-01 05:00:00,45,18,Wednesday,5,63
7565,NBRK,2016-06-01 06:00:00,186,41,Wednesday,6,227
7566,NBRK,2016-06-01 07:00:00,507,156,Wednesday,7,663
7567,NBRK,2016-06-01 08:00:00,987,198,Wednesday,8,1185
7568,NBRK,2016-06-01 09:00:00,754,128,Wednesday,9,882
7569,NBRK,2016-06-01 10:00:00,380,70,Wednesday,10,450
7570,NBRK,2016-06-01 11:00:00,213,96,Wednesday,11,309
7571,NBRK,2016-06-01 12:00:00,210,93,Wednesday,12,303
7572,NBRK,2016-06-01 13:00:00,145,187,Wednesday,13,332
7573,NBRK,2016-06-01 14:00:00,127,141,Wednesday,14,268
7574,NBRK,2016-06-01 15:00:00,165,323,Wednesday,15,488
7575,NBRK,2016-06-01 16:00:00,193,383,Wednesday,16,576
7576,NBRK,2016-06-01 17:00:00,267,822,Wednesday,17,1089
7577,NBRK,2016-06-01 18:00:00,254,919,Wednesday,18,1173
7578,NBRK,2016-06-01 19:00:00,122,534,Wednesday,19,656
7579,NBRK,2016-06-01 20:00:00,60,257,Wednesday,20,317
7580,NBRK,2016-06-01 21:00:00,55,228,Wednesday,21,283
7581,NBRK,2016-06-01 22:00:00,55,125,Wednesday,22,180
7582,NBRK,2016-06-01 23:00:00,31,88,Wednesday,23,119
7583,NBRK,2016-06-02 00:00:00,11,44,Thursday,0,55
7584,NBRK,2016-06-02 01:00:00,1,6,Thursday,1,7
7585,NBRK,2016-06-02 05:00:00,38,12,Thursday,5,50
7586,NBRK,2016-06-02 06:00:00,189,31,Thursday,6,220
7587,NBRK,2016-06-02 07:00:00,508,142,Thursday,7,650
7588,NBRK,2016-06-02 08:00:00,915,209,Thursday,8,1124
7589,NBRK,2016-06-02 09:00:00,790,116,Thursday,9,906
7590,NBRK,2016-06-02 10:00:00,361,104,Thursday,10,465
7591,NBRK,2016-06-02 11:00:00,226,96,Thursday,11,322
7592,NBRK,2016-06-02 12:00:00,180,128,Thursday,12,308
7593,NBRK,2016-06-02 13:00:00,148,158,Thursday,13,306
7594,NBRK,2016-06-02 14:00:00,153,159,Thursday,14,312
7595,NBRK,2016-06-02 15:00:00,178,250,Thursday,15,428
7596,NBRK,2016-06-02 16:00:00,197,472,Thursday,16,669
7597,NBRK,2016-06-02 17:00:00,292,826,Thursday,17,1118
7598,NBRK,2016-06-02 18:00:00,299,913,Thursday,18,1212
7599,NBRK,2016-06-02 19:00:00,160,454,Thursday,19,614
7600,NBRK,2016-06-02 20:00:00,99,310,Thursday,20,409
7601,NBRK,2016-06-02 21:00:00,74,321,Thursday,21,395
7602,NBRK,2016-06-02 22:00:00,52,183,Thursday,22,235
7603,NBRK,2016-06-02 23:00:00,34,86,Thursday,23,120
7604,NBRK,2016-06-03 00:00:00,13,66,Friday,0,79
7605,NBRK,2016-06-03 01:00:00,2,4,Friday,1,6
7606,NBRK,2016-06-03 05:00:00,45,12,Friday,5,57
7607,NBRK,2016-06-03 06:00:00,168,35,Friday,6,203
7608,NBRK,2016-06-03 07:00:00,404,118,Friday,7,522
7609,NBRK,2016-06-03 08:00:00,777,196,Friday,8,973
7610,NBRK,2016-06-03 09:00:00,823,126,Friday,9,949
7611,NBRK,2016-06-03 10:00:00,369,90,Friday,10,459
7612,NBRK,2016-06-03 11:00:00,227,145,Friday,11,372
7613,NBRK,2016-06-03 12:00:00,185,151,Friday,12,336
7614,NBRK,2016-06-03 13:00:00,147,267,Friday,13,414
7615,NBRK,2016-06-03 14:00:00,149,205,Friday,14,354
7616,NBRK,2016-06-03 15:00:00,165,309,Friday,15,474
7617,NBRK,2016-06-03 16:00:00,224,415,Friday,16,639
7618,NBRK,2016-06-03 17:00:00,280,749,Friday,17,1029
7619,NBRK,2016-06-03 18:00:00,283,747,Friday,18,1030
7620,NBRK,2016-06-03 19:00:00,216,378,Friday,19,594
7621,NBRK,2016-06-03 20:00:00,91,168,Friday,20,259
7622,NBRK,2016-06-03 21:00:00,50,239,Friday,21,289
7623,NBRK,2016-06-03 22:00:00,62,181,Friday,22,243
7624,NBRK,2016-06-03 23:00:00,43,192,Friday,23,235
7625,NBRK,2016-06-04 00:00:00,14,115,Saturday,0,129
7626,NBRK,2016-06-04 01:00:00,4,3,Saturday,1,7
7627,NBRK,2016-06-04 06:00:00,11,11,Saturday,6,22
7628,NBRK,2016-06-04 07:00:00,52,30,Saturday,7,82
7629,NBRK,2016-06-04 08:00:00,118,51,Saturday,8,169
7630,NBRK,2016-06-04 09:00:00,157,84,Saturday,9,241
7631,NBRK,2016-06-04 10:00:00,198,121,Saturday,10,319
7632,NBRK,2016-06-04 11:00:00,193,117,Saturday,11,310
7633,NBRK,2016-06-04 12:00:00,231,144,Saturday,12,375
7634,NBRK,2016-06-04 13:00:00,173,202,Saturday,13,375
7635,NBRK,2016-06-04 14:00:00,158,147,Saturday,14,305
7636,NBRK,2016-06-04 15:00:00,161,171,Saturday,15,332
7637,NBRK,2016-06-04 16:00:00,184,226,Saturday,16,410
7638,NBRK,2016-06-04 17:00:00,207,203,Saturday,17,410
7639,NBRK,2016-06-04 18:00:00,195,227,Saturday,18,422
7640,NBRK,2016-06-04 19:00:00,173,142,Saturday,19,315
7641,NBRK,2016-06-04 20:00:00,118,117,Saturday,20,235
7642,NBRK,2016-06-04 21:00:00,88,117,Saturday,21,205
7643,NBRK,2016-06-04 22:00:00,86,192,Saturday,22,278
7644,NBRK,2016-06-04 23:00:00,50,103,Saturday,23,153
7645,NBRK,2016-06-05 00:00:00,24,91,Sunday,0,115
7646,NBRK,2016-06-05 08:00:00,58,37,Sunday,8,95
7647,NBRK,2016-06-05 09:00:00,104,66,Sunday,9,170
7648,NBRK,2016-06-05 10:00:00,142,103,Sunday,10,245
7649,NBRK,2016-06-05 11:00:00,217,125,Sunday,11,342
7650,NBRK,2016-06-05 12:00:00,190,154,Sunday,12,344
7651,NBRK,2016-06-05 13:00:00,171,172,Sunday,13,343
7652,NBRK,2016-06-05 14:00:00,163,148,Sunday,14,311
7653,NBRK,2016-06-05 15:00:00,143,156,Sunday,15,299
7654,NBRK,2016-06-05 16:00:00,170,174,Sunday,16,344
7655,NBRK,2016-06-05 17:00:00,175,168,Sunday,17,343
7656,NBRK,2016-06-05 18:00:00,158,160,Sunday,18,318
7657,NBRK,2016-06-05 19:00:00,76,110,Sunday,19,186
7658,NBRK,2016-06-05 20:00:00,71,192,Sunday,20,263
7659,NBRK,2016-06-05 21:00:00,55,108,Sunday,21,163
7660,NBRK,2016-06-05 22:00:00,55,100,Sunday,22,155
7661,NBRK,2016-06-05 23:00:00,18,43,Sunday,23,61
7662,NBRK,2016-06-06 00:00:00,12,22,Monday,0,34
7663,NBRK,2016-06-06 01:00:00,2,7,Monday,1,9
7664,NBRK,2016-06-06 05:00:00,32,7,Monday,5,39
7665,NBRK,2016-06-06 06:00:00,183,38,Monday,6,221
7666,NBRK,2016-06-06 07:00:00,505,103,Monday,7,608
7667,NBRK,2016-06-06 08:00:00,920,182,Monday,8,1102
7668,NBRK,2016-06-06 09:00:00,803,106,Monday,9,909
7669,NBRK,2016-06-06 10:00:00,346,65,Monday,10,411
7670,NBRK,2016-06-06 11:00:00,192,75,Monday,11,267
7671,NBRK,2016-06-06 12:00:00,180,116,Monday,12,296
7672,NBRK,2016-06-06 13:00:00,148,126,Monday,13,274
7673,NBRK,2016-06-06 14:00:00,147,147,Monday,14,294
7674,NBRK,2016-06-06 15:00:00,112,240,Monday,15,352
7675,NBRK,2016-06-06 16:00:00,169,428,Monday,16,597
7676,NBRK,2016-06-06 17:00:00,218,764,Monday,17,982
7677,NBRK,2016-06-06 18:00:00,172,943,Monday,18,1115
7678,NBRK,2016-06-06 19:00:00,110,509,Monday,19,619
7679,NBRK,2016-06-06 20:00:00,50,224,Monday,20,274
7680,NBRK,2016-06-06 21:00:00,69,238,Monday,21,307
7681,NBRK,2016-06-06 22:00:00,52,142,Monday,22,194
7682,NBRK,2016-06-06 23:00:00,22,88,Monday,23,110
7683,NBRK,2016-06-07 00:00:00,16,46,Tuesday,0,62
7684,NBRK,2016-06-07 04:00:00,5,1,Tuesday,4,6
7685,NBRK,2016-06-07 05:00:00,45,14,Tuesday,5,59
7686,NBRK,2016-06-07 06:00:00,195,40,Tuesday,6,235
7687,NBRK,2016-06-07 07:00:00,430,135,Tuesday,7,565
7688,NBRK,2016-06-07 08:00:00,1027,191,Tuesday,8,1218
7689,NBRK,2016-06-07 09:00:00,816,122,Tuesday,9,938
7690,NBRK,2016-06-07 10:00:00,383,81,Tuesday,10,464
7691,NBRK,2016-06-07 11:00:00,201,113,Tuesday,11,314
7692,NBRK,2016-06-07 12:00:00,174,113,Tuesday,12,287
7693,NBRK,2016-06-07 13:00:00,140,122,Tuesday,13,262
7694,NBRK,2016-06-07 14:00:00,122,167,Tuesday,14,289
7695,NBRK,2016-06-07 15:00:00,157,250,Tuesday,15,407
7696,NBRK,2016-06-07 16:00:00,189,425,Tuesday,16,614
7697,NBRK,2016-06-07 17:00:00,273,934,Tuesday,17,1207
7698,NBRK,2016-06-07 18:00:00,266,881,Tuesday,18,1147
7699,NBRK,2016-06-07 19:00:00,156,490,Tuesday,19,646
7700,NBRK,2016-06-07 20:00:00,72,269,Tuesday,20,341
7701,NBRK,2016-06-07 21:00:00,51,190,Tuesday,21,241
7702,NBRK,2016-06-07 22:00:00,53,154,Tuesday,22,207
7703,NBRK,2016-06-07 23:00:00,33,181,Tuesday,23,214
7704,NBRK,2016-06-08 00:00:00,17,46,Wednesday,0,63
7705,NBRK,2016-06-08 01:00:00,2,5,Wednesday,1,7
7706,NBRK,2016-06-08 05:00:00,40,18,Wednesday,5,58
7707,NBRK,2016-06-08 06:00:00,189,41,Wednesday,6,230
7708,NBRK,2016-06-08 07:00:00,497,115,Wednesday,7,612
7709,NBRK,2016-06-08 08:00:00,977,210,Wednesday,8,1187
7710,NBRK,2016-06-08 09:00:00,762,119,Wednesday,9,881
7711,NBRK,2016-06-08 10:00:00,449,96,Wednesday,10,545
7712,NBRK,2016-06-08 11:00:00,247,86,Wednesday,11,333
7713,NBRK,2016-06-08 12:00:00,185,108,Wednesday,12,293
7714,NBRK,2016-06-08 13:00:00,166,229,Wednesday,13,395
7715,NBRK,2016-06-08 14:00:00,143,215,Wednesday,14,358
7716,NBRK,2016-06-08 15:00:00,155,215,Wednesday,15,370
7717,NBRK,2016-06-08 16:00:00,179,521,Wednesday,16,700
7718,NBRK,2016-06-08 17:00:00,283,734,Wednesday,17,1017
7719,NBRK,2016-06-08 18:00:00,290,885,Wednesday,18,1175
7720,NBRK,2016-06-08 19:00:00,135,447,Wednesday,19,582
7721,NBRK,2016-06-08 20:00:00,69,269,Wednesday,20,338
7722,NBRK,2016-06-08 21:00:00,57,293,Wednesday,21,350
7723,NBRK,2016-06-08 22:00:00,59,202,Wednesday,22,261
7724,NBRK,2016-06-08 23:00:00,40,138,Wednesday,23,178
7725,NBRK,2016-06-09 00:00:00,20,71,Thursday,0,91
7726,NBRK,2016-06-09 04:00:00,4,3,Thursday,4,7
7727,NBRK,2016-06-09 05:00:00,41,9,Thursday,5,50
7728,NBRK,2016-06-09 06:00:00,188,38,Thursday,6,226
7729,NBRK,2016-06-09 07:00:00,476,120,Thursday,7,596
7730,NBRK,2016-06-09 08:00:00,867,172,Thursday,8,1039
7731,NBRK,2016-06-09 09:00:00,818,115,Thursday,9,933
7732,NBRK,2016-06-09 10:00:00,400,100,Thursday,10,500
7733,NBRK,2016-06-09 11:00:00,237,130,Thursday,11,367
7734,NBRK,2016-06-09 12:00:00,200,162,Thursday,12,362
7735,NBRK,2016-06-09 13:00:00,143,148,Thursday,13,291
7736,NBRK,2016-06-09 14:00:00,139,194,Thursday,14,333
7737,NBRK,2016-06-09 15:00:00,134,246,Thursday,15,380
7738,NBRK,2016-06-09 16:00:00,195,468,Thursday,16,663
7739,NBRK,2016-06-09 17:00:00,250,781,Thursday,17,1031
7740,NBRK,2016-06-09 18:00:00,283,907,Thursday,18,1190
7741,NBRK,2016-06-09 19:00:00,156,433,Thursday,19,589
7742,NBRK,2016-06-09 20:00:00,83,304,Thursday,20,387
7743,NBRK,2016-06-09 21:00:00,57,272,Thursday,21,329
7744,NBRK,2016-06-09 22:00:00,56,185,Thursday,22,241
7745,NBRK,2016-06-09 23:00:00,41,112,Thursday,23,153
7746,NBRK,2016-06-10 00:00:00,13,51,Friday,0,64
7747,NBRK,2016-06-10 01:00:00,1,2,Friday,1,3
7748,NBRK,2016-06-10 04:00:00,4,1,Friday,4,5
7749,NBRK,2016-06-10 05:00:00,34,16,Friday,5,50
7750,NBRK,2016-06-10 06:00:00,184,37,Friday,6,221
7751,NBRK,2016-06-10 07:00:00,407,108,Friday,7,515
7752,NBRK,2016-06-10 08:00:00,817,158,Friday,8,975
7753,NBRK,2016-06-10 09:00:00,659,123,Friday,9,782
7754,NBRK,2016-06-10 10:00:00,344,112,Friday,10,456
7755,NBRK,2016-06-10 11:00:00,224,102,Friday,11,326
7756,NBRK,2016-06-10 12:00:00,189,150,Friday,12,339
7757,NBRK,2016-06-10 13:00:00,170,191,Friday,13,361
7758,NBRK,2016-06-10 14:00:00,150,168,Friday,14,318
7759,NBRK,2016-06-10 15:00:00,165,310,Friday,15,475
7760,NBRK,2016-06-10 16:00:00,221,500,Friday,16,721
7761,NBRK,2016-06-10 17:00:00,337,708,Friday,17,1045
7762,NBRK,2016-06-10 18:00:00,286,780,Friday,18,1066
7763,NBRK,2016-06-10 19:00:00,155,330,Friday,19,485
7764,NBRK,2016-06-10 20:00:00,92,180,Friday,20,272
7765,NBRK,2016-06-10 21:00:00,69,205,Friday,21,274
7766,NBRK,2016-06-10 22:00:00,63,220,Friday,22,283
7767,NBRK,2016-06-10 23:00:00,50,190,Friday,23,240
7768,NBRK,2016-06-11 00:00:00,30,70,Saturday,0,100
7769,NBRK,2016-06-11 06:00:00,15,17,Saturday,6,32
7770,NBRK,2016-06-11 07:00:00,59,23,Saturday,7,82
7771,NBRK,2016-06-11 08:00:00,81,75,Saturday,8,156
7772,NBRK,2016-06-11 09:00:00,154,111,Saturday,9,265
7773,NBRK,2016-06-11 10:00:00,154,132,Saturday,10,286
7774,NBRK,2016-06-11 11:00:00,209,164,Saturday,11,373
7775,NBRK,2016-06-11 12:00:00,248,168,Saturday,12,416
7776,NBRK,2016-06-11 13:00:00,228,121,Saturday,13,349
7777,NBRK,2016-06-11 14:00:00,198,148,Saturday,14,346
7778,NBRK,2016-06-11 15:00:00,208,151,Saturday,15,359
7779,NBRK,2016-06-11 16:00:00,250,183,Saturday,16,433
7780,NBRK,2016-06-11 17:00:00,237,195,Saturday,17,432
7781,NBRK,2016-06-11 18:00:00,209,207,Saturday,18,416
7782,NBRK,2016-06-11 19:00:00,155,208,Saturday,19,363
7783,NBRK,2016-06-11 20:00:00,81,96,Saturday,20,177
7784,NBRK,2016-06-11 21:00:00,85,113,Saturday,21,198
7785,NBRK,2016-06-11 22:00:00,36,263,Saturday,22,299
7786,NBRK,2016-06-11 23:00:00,45,127,Saturday,23,172
7787,NBRK,2016-06-12 00:00:00,31,67,Sunday,0,98
7788,NBRK,2016-06-12 01:00:00,5,17,Sunday,1,22
7789,NBRK,2016-06-12 08:00:00,47,29,Sunday,8,76
7790,NBRK,2016-06-12 09:00:00,79,69,Sunday,9,148
7791,NBRK,2016-06-12 10:00:00,119,91,Sunday,10,210
7792,NBRK,2016-06-12 11:00:00,180,149,Sunday,11,329
7793,NBRK,2016-06-12 12:00:00,186,160,Sunday,12,346
7794,NBRK,2016-06-12 13:00:00,168,137,Sunday,13,305
7795,NBRK,2016-06-12 14:00:00,150,133,Sunday,14,283
7796,NBRK,2016-06-12 15:00:00,177,127,Sunday,15,304
7797,NBRK,2016-06-12 16:00:00,180,146,Sunday,16,326
7798,NBRK,2016-06-12 17:00:00,193,166,Sunday,17,359
7799,NBRK,2016-06-12 18:00:00,172,167,Sunday,18,339
7800,NBRK,2016-06-12 19:00:00,131,121,Sunday,19,252
7801,NBRK,2016-06-12 20:00:00,91,134,Sunday,20,225
7802,NBRK,2016-06-12 21:00:00,50,158,Sunday,21,208
7803,NBRK,2016-06-12 22:00:00,37,147,Sunday,22,184
7804,NBRK,2016-06-12 23:00:00,16,50,Sunday,23,66
7805,NBRK,2016-06-13 00:00:00,12,25,Monday,0,37
7806,NBRK,2016-06-13 01:00:00,1,4,Monday,1,5
7807,NBRK,2016-06-13 05:00:00,37,13,Monday,5,50
7808,NBRK,2016-06-13 06:00:00,173,32,Monday,6,205
7809,NBRK,2016-06-13 07:00:00,467,110,Monday,7,577
7810,NBRK,2016-06-13 08:00:00,968,156,Monday,8,1124
7811,NBRK,2016-06-13 09:00:00,877,113,Monday,9,990
7812,NBRK,2016-06-13 10:00:00,323,86,Monday,10,409
7813,NBRK,2016-06-13 11:00:00,213,83,Monday,11,296
7814,NBRK,2016-06-13 12:00:00,224,110,Monday,12,334
7815,NBRK,2016-06-13 13:00:00,122,107,Monday,13,229
7816,NBRK,2016-06-13 14:00:00,100,196,Monday,14,296
7817,NBRK,2016-06-13 15:00:00,159,293,Monday,15,452
7818,NBRK,2016-06-13 16:00:00,154,406,Monday,16,560
7819,NBRK,2016-06-13 17:00:00,291,960,Monday,17,1251
7820,NBRK,2016-06-13 18:00:00,232,869,Monday,18,1101
7821,NBRK,2016-06-13 19:00:00,135,439,Monday,19,574
7822,NBRK,2016-06-13 20:00:00,34,203,Monday,20,237
7823,NBRK,2016-06-13 21:00:00,63,233,Monday,21,296
7824,NBRK,2016-06-13 22:00:00,53,198,Monday,22,251
7825,NBRK,2016-06-13 23:00:00,37,114,Monday,23,151
7826,NBRK,2016-06-14 00:00:00,8,41,Tuesday,0,49
7827,NBRK,2016-06-14 01:00:00,2,1,Tuesday,1,3
7828,NBRK,2016-06-14 05:00:00,44,15,Tuesday,5,59
7829,NBRK,2016-06-14 06:00:00,188,34,Tuesday,6,222
7830,NBRK,2016-06-14 07:00:00,493,109,Tuesday,7,602
7831,NBRK,2016-06-14 08:00:00,973,164,Tuesday,8,1137
7832,NBRK,2016-06-14 09:00:00,864,164,Tuesday,9,1028
7833,NBRK,2016-06-14 10:00:00,420,77,Tuesday,10,497
7834,NBRK,2016-06-14 11:00:00,223,79,Tuesday,11,302
7835,NBRK,2016-06-14 12:00:00,188,134,Tuesday,12,322
7836,NBRK,2016-06-14 13:00:00,124,161,Tuesday,13,285
7837,NBRK,2016-06-14 14:00:00,118,161,Tuesday,14,279
7838,NBRK,2016-06-14 15:00:00,135,271,Tuesday,15,406
7839,NBRK,2016-06-14 16:00:00,156,521,Tuesday,16,677
7840,NBRK,2016-06-14 17:00:00,304,772,Tuesday,17,1076
7841,NBRK,2016-06-14 18:00:00,305,839,Tuesday,18,1144
7842,NBRK,2016-06-14 19:00:00,142,549,Tuesday,19,691
7843,NBRK,2016-06-14 20:00:00,67,297,Tuesday,20,364
7844,NBRK,2016-06-14 21:00:00,65,187,Tuesday,21,252
7845,NBRK,2016-06-14 22:00:00,48,178,Tuesday,22,226
7846,NBRK,2016-06-14 23:00:00,37,198,Tuesday,23,235
7847,NCON,2016-06-01 01:00:00,2,2,Wednesday,1,4
7848,NCON,2016-06-01 04:00:00,6,1,Wednesday,4,7
7849,NCON,2016-06-01 05:00:00,187,16,Wednesday,5,203
7850,NCON,2016-06-01 06:00:00,349,34,Wednesday,6,383
7851,NCON,2016-06-01 07:00:00,639,48,Wednesday,7,687
7852,NCON,2016-06-01 08:00:00,769,41,Wednesday,8,810
7853,NCON,2016-06-01 09:00:00,441,33,Wednesday,9,474
7854,NCON,2016-06-01 10:00:00,189,29,Wednesday,10,218
7855,NCON,2016-06-01 11:00:00,65,26,Wednesday,11,91
7856,NCON,2016-06-01 12:00:00,71,39,Wednesday,12,110
7857,NCON,2016-06-01 13:00:00,65,56,Wednesday,13,121
7858,NCON,2016-06-01 14:00:00,47,195,Wednesday,14,242
7859,NCON,2016-06-01 15:00:00,54,202,Wednesday,15,256
7860,NCON,2016-06-01 16:00:00,44,345,Wednesday,16,389
7861,NCON,2016-06-01 17:00:00,54,486,Wednesday,17,540
7862,NCON,2016-06-01 18:00:00,26,751,Wednesday,18,777
7863,NCON,2016-06-01 19:00:00,31,249,Wednesday,19,280
7864,NCON,2016-06-01 20:00:00,15,168,Wednesday,20,183
7865,NCON,2016-06-01 21:00:00,15,100,Wednesday,21,115
7866,NCON,2016-06-01 22:00:00,17,58,Wednesday,22,75
7867,NCON,2016-06-01 23:00:00,4,55,Wednesday,23,59
7868,NCON,2016-06-02 00:00:00,4,34,Thursday,0,38
7869,NCON,2016-06-02 01:00:00,4,8,Thursday,1,12
7870,NCON,2016-06-02 04:00:00,4,1,Thursday,4,5
7871,NCON,2016-06-02 05:00:00,189,17,Thursday,5,206
7872,NCON,2016-06-02 06:00:00,353,25,Thursday,6,378
7873,NCON,2016-06-02 07:00:00,564,42,Thursday,7,606
7874,NCON,2016-06-02 08:00:00,717,45,Thursday,8,762
7875,NCON,2016-06-02 09:00:00,414,16,Thursday,9,430
7876,NCON,2016-06-02 10:00:00,157,25,Thursday,10,182
7877,NCON,2016-06-02 11:00:00,65,23,Thursday,11,88
7878,NCON,2016-06-02 12:00:00,73,31,Thursday,12,104
7879,NCON,2016-06-02 13:00:00,78,53,Thursday,13,131
7880,NCON,2016-06-02 14:00:00,43,97,Thursday,14,140
7881,NCON,2016-06-02 15:00:00,63,213,Thursday,15,276
7882,NCON,2016-06-02 16:00:00,50,276,Thursday,16,326
7883,NCON,2016-06-02 17:00:00,56,582,Thursday,17,638
7884,NCON,2016-06-02 18:00:00,39,758,Thursday,18,797
7885,NCON,2016-06-02 19:00:00,20,205,Thursday,19,225
7886,NCON,2016-06-02 20:00:00,17,151,Thursday,20,168
7887,NCON,2016-06-02 21:00:00,16,90,Thursday,21,106
7888,NCON,2016-06-02 22:00:00,19,82,Thursday,22,101
7889,NCON,2016-06-02 23:00:00,14,45,Thursday,23,59
7890,NCON,2016-06-03 00:00:00,3,35,Friday,0,38
7891,NCON,2016-06-03 04:00:00,3,4,Friday,4,7
7892,NCON,2016-06-03 05:00:00,166,15,Friday,5,181
7893,NCON,2016-06-03 06:00:00,275,25,Friday,6,300
7894,NCON,2016-06-03 07:00:00,483,42,Friday,7,525
7895,NCON,2016-06-03 08:00:00,568,38,Friday,8,606
7896,NCON,2016-06-03 09:00:00,306,31,Friday,9,337
7897,NCON,2016-06-03 10:00:00,126,27,Friday,10,153
7898,NCON,2016-06-03 11:00:00,67,30,Friday,11,97
7899,NCON,2016-06-03 12:00:00,54,33,Friday,12,87
7900,NCON,2016-06-03 13:00:00,43,40,Friday,13,83
7901,NCON,2016-06-03 14:00:00,46,133,Friday,14,179
7902,NCON,2016-06-03 15:00:00,53,195,Friday,15,248
7903,NCON,2016-06-03 16:00:00,46,283,Friday,16,329
7904,NCON,2016-06-03 17:00:00,50,257,Friday,17,307
7905,NCON,2016-06-03 18:00:00,52,628,Friday,18,680
7906,NCON,2016-06-03 19:00:00,27,184,Friday,19,211
7907,NCON,2016-06-03 20:00:00,28,90,Friday,20,118
7908,NCON,2016-06-03 21:00:00,15,74,Friday,21,89
7909,NCON,2016-06-03 22:00:00,12,61,Friday,22,73
7910,NCON,2016-06-03 23:00:00,10,64,Friday,23,74
7911,NCON,2016-06-04 00:00:00,6,51,Saturday,0,57
7912,NCON,2016-06-04 06:00:00,31,5,Saturday,6,36
7913,NCON,2016-06-04 07:00:00,33,10,Saturday,7,43
7914,NCON,2016-06-04 08:00:00,50,17,Saturday,8,67
7915,NCON,2016-06-04 09:00:00,74,16,Saturday,9,90
7916,NCON,2016-06-04 10:00:00,60,22,Saturday,10,82
7917,NCON,2016-06-04 11:00:00,71,18,Saturday,11,89
7918,NCON,2016-06-04 12:00:00,59,32,Saturday,12,91
7919,NCON,2016-06-04 13:00:00,43,25,Saturday,13,68
7920,NCON,2016-06-04 14:00:00,42,42,Saturday,14,84
7921,NCON,2016-06-04 15:00:00,33,51,Saturday,15,84
7922,NCON,2016-06-04 16:00:00,34,48,Saturday,16,82
7923,NCON,2016-06-04 17:00:00,26,63,Saturday,17,89
7924,NCON,2016-06-04 18:00:00,23,65,Saturday,18,88
7925,NCON,2016-06-04 19:00:00,28,43,Saturday,19,71
7926,NCON,2016-06-04 20:00:00,13,58,Saturday,20,71
7927,NCON,2016-06-04 21:00:00,15,34,Saturday,21,49
7928,NCON,2016-06-04 22:00:00,8,50,Saturday,22,58
7929,NCON,2016-06-04 23:00:00,8,37,Saturday,23,45
7930,NCON,2016-06-05 00:00:00,5,29,Sunday,0,34
7931,NCON,2016-06-05 08:00:00,31,7,Sunday,8,38
7932,NCON,2016-06-05 09:00:00,47,24,Sunday,9,71
7933,NCON,2016-06-05 10:00:00,48,7,Sunday,10,55
7934,NCON,2016-06-05 11:00:00,38,17,Sunday,11,55
7935,NCON,2016-06-05 12:00:00,41,28,Sunday,12,69
7936,NCON,2016-06-05 13:00:00,50,23,Sunday,13,73
7937,NCON,2016-06-05 14:00:00,33,33,Sunday,14,66
7938,NCON,2016-06-05 15:00:00,31,38,Sunday,15,69
7939,NCON,2016-06-05 16:00:00,32,44,Sunday,16,76
7940,NCON,2016-06-05 17:00:00,18,34,Sunday,17,52
7941,NCON,2016-06-05 18:00:00,14,31,Sunday,18,45
7942,NCON,2016-06-05 19:00:00,16,35,Sunday,19,51
7943,NCON,2016-06-05 20:00:00,15,53,Sunday,20,68
7944,NCON,2016-06-05 21:00:00,16,48,Sunday,21,64
7945,NCON,2016-06-05 22:00:00,13,19,Sunday,22,32
7946,NCON,2016-06-05 23:00:00,9,16,Sunday,23,25
7947,NCON,2016-06-06 00:00:00,4,21,Monday,0,25
7948,NCON,2016-06-06 04:00:00,20,4,Monday,4,24
7949,NCON,2016-06-06 05:00:00,158,13,Monday,5,171
7950,NCON,2016-06-06 06:00:00,339,27,Monday,6,366
7951,NCON,2016-06-06 07:00:00,582,29,Monday,7,611
7952,NCON,2016-06-06 08:00:00,703,51,Monday,8,754
7953,NCON,2016-06-06 09:00:00,412,29,Monday,9,441
7954,NCON,2016-06-06 10:00:00,138,18,Monday,10,156
7955,NCON,2016-06-06 11:00:00,76,21,Monday,11,97
7956,NCON,2016-06-06 12:00:00,55,46,Monday,12,101
7957,NCON,2016-06-06 13:00:00,47,63,Monday,13,110
7958,NCON,2016-06-06 14:00:00,52,93,Monday,14,145
7959,NCON,2016-06-06 15:00:00,56,156,Monday,15,212
7960,NCON,2016-06-06 16:00:00,43,400,Monday,16,443
7961,NCON,2016-06-06 17:00:00,48,424,Monday,17,472
7962,NCON,2016-06-06 18:00:00,39,755,Monday,18,794
7963,NCON,2016-06-06 19:00:00,19,300,Monday,19,319
7964,NCON,2016-06-06 20:00:00,11,103,Monday,20,114
7965,NCON,2016-06-06 21:00:00,5,70,Monday,21,75
7966,NCON,2016-06-06 22:00:00,10,65,Monday,22,75
7967,NCON,2016-06-06 23:00:00,6,42,Monday,23,48
7968,NCON,2016-06-07 00:00:00,2,30,Tuesday,0,32
7969,NCON,2016-06-07 04:00:00,15,2,Tuesday,4,17
7970,NCON,2016-06-07 05:00:00,163,18,Tuesday,5,181
7971,NCON,2016-06-07 06:00:00,352,30,Tuesday,6,382
7972,NCON,2016-06-07 07:00:00,633,43,Tuesday,7,676
7973,NCON,2016-06-07 08:00:00,781,33,Tuesday,8,814
7974,NCON,2016-06-07 09:00:00,387,21,Tuesday,9,408
7975,NCON,2016-06-07 10:00:00,155,14,Tuesday,10,169
7976,NCON,2016-06-07 11:00:00,55,40,Tuesday,11,95
7977,NCON,2016-06-07 12:00:00,75,52,Tuesday,12,127
7978,NCON,2016-06-07 13:00:00,56,64,Tuesday,13,120
7979,NCON,2016-06-07 14:00:00,75,60,Tuesday,14,135
7980,NCON,2016-06-07 15:00:00,67,199,Tuesday,15,266
7981,NCON,2016-06-07 16:00:00,61,424,Tuesday,16,485
7982,NCON,2016-06-07 17:00:00,66,467,Tuesday,17,533
7983,NCON,2016-06-07 18:00:00,49,773,Tuesday,18,822
7984,NCON,2016-06-07 19:00:00,32,273,Tuesday,19,305
7985,NCON,2016-06-07 20:00:00,15,111,Tuesday,20,126
7986,NCON,2016-06-07 21:00:00,10,89,Tuesday,21,99
7987,NCON,2016-06-07 22:00:00,11,70,Tuesday,22,81
7988,NCON,2016-06-07 23:00:00,9,96,Tuesday,23,105
7989,NCON,2016-06-08 00:00:00,3,55,Wednesday,0,58
7990,NCON,2016-06-08 01:00:00,1,2,Wednesday,1,3
7991,NCON,2016-06-08 04:00:00,21,3,Wednesday,4,24
7992,NCON,2016-06-08 05:00:00,173,13,Wednesday,5,186
7993,NCON,2016-06-08 06:00:00,356,35,Wednesday,6,391
7994,NCON,2016-06-08 07:00:00,631,31,Wednesday,7,662
7995,NCON,2016-06-08 08:00:00,698,47,Wednesday,8,745
7996,NCON,2016-06-08 09:00:00,415,22,Wednesday,9,437
7997,NCON,2016-06-08 10:00:00,138,30,Wednesday,10,168
7998,NCON,2016-06-08 11:00:00,54,36,Wednesday,11,90
7999,NCON,2016-06-08 12:00:00,70,52,Wednesday,12,122
8000,NCON,2016-06-08 13:00:00,51,62,Wednesday,13,113
8001,NCON,2016-06-08 14:00:00,58,105,Wednesday,14,163
8002,NCON,2016-06-08 15:00:00,57,201,Wednesday,15,258
8003,NCON,2016-06-08 16:00:00,62,394,Wednesday,16,456
8004,NCON,2016-06-08 17:00:00,71,441,Wednesday,17,512
8005,NCON,2016-06-08 18:00:00,70,715,Wednesday,18,785
8006,NCON,2016-06-08 19:00:00,30,268,Wednesday,19,298
8007,NCON,2016-06-08 20:00:00,12,93,Wednesday,20,105
8008,NCON,2016-06-08 21:00:00,10,109,Wednesday,21,119
8009,NCON,2016-06-08 22:00:00,17,90,Wednesday,22,107
8010,NCON,2016-06-08 23:00:00,6,109,Wednesday,23,115
8011,NCON,2016-06-09 00:00:00,3,42,Thursday,0,45
8012,NCON,2016-06-09 04:00:00,10,2,Thursday,4,12
8013,NCON,2016-06-09 05:00:00,183,14,Thursday,5,197
8014,NCON,2016-06-09 06:00:00,344,20,Thursday,6,364
8015,NCON,2016-06-09 07:00:00,596,47,Thursday,7,643
8016,NCON,2016-06-09 08:00:00,710,37,Thursday,8,747
8017,NCON,2016-06-09 09:00:00,446,24,Thursday,9,470
8018,NCON,2016-06-09 10:00:00,138,25,Thursday,10,163
8019,NCON,2016-06-09 11:00:00,85,33,Thursday,11,118
8020,NCON,2016-06-09 12:00:00,50,35,Thursday,12,85
8021,NCON,2016-06-09 13:00:00,54,85,Thursday,13,139
8022,NCON,2016-06-09 14:00:00,52,86,Thursday,14,138
8023,NCON,2016-06-09 15:00:00,68,158,Thursday,15,226
8024,NCON,2016-06-09 16:00:00,52,330,Thursday,16,382
8025,NCON,2016-06-09 17:00:00,46,621,Thursday,17,667
8026,NCON,2016-06-09 18:00:00,41,638,Thursday,18,679
8027,NCON,2016-06-09 19:00:00,17,242,Thursday,19,259
8028,NCON,2016-06-09 20:00:00,18,132,Thursday,20,150
8029,NCON,2016-06-09 21:00:00,14,113,Thursday,21,127
8030,NCON,2016-06-09 22:00:00,13,63,Thursday,22,76
8031,NCON,2016-06-09 23:00:00,10,52,Thursday,23,62
8032,NCON,2016-06-10 00:00:00,9,37,Friday,0,46
8033,NCON,2016-06-10 04:00:00,3,4,Friday,4,7
8034,NCON,2016-06-10 05:00:00,136,15,Friday,5,151
8035,NCON,2016-06-10 06:00:00,287,30,Friday,6,317
8036,NCON,2016-06-10 07:00:00,490,41,Friday,7,531
8037,NCON,2016-06-10 08:00:00,497,32,Friday,8,529
8038,NCON,2016-06-10 09:00:00,278,16,Friday,9,294
8039,NCON,2016-06-10 10:00:00,129,15,Friday,10,144
8040,NCON,2016-06-10 11:00:00,71,23,Friday,11,94
8041,NCON,2016-06-10 12:00:00,76,38,Friday,12,114
8042,NCON,2016-06-10 13:00:00,70,73,Friday,13,143
8043,NCON,2016-06-10 14:00:00,69,84,Friday,14,153
8044,NCON,2016-06-10 15:00:00,63,133,Friday,15,196
8045,NCON,2016-06-10 16:00:00,63,354,Friday,16,417
8046,NCON,2016-06-10 17:00:00,66,358,Friday,17,424
8047,NCON,2016-06-10 18:00:00,75,504,Friday,18,579
8048,NCON,2016-06-10 19:00:00,40,163,Friday,19,203
8049,NCON,2016-06-10 20:00:00,18,103,Friday,20,121
8050,NCON,2016-06-10 21:00:00,12,73,Friday,21,85
8051,NCON,2016-06-10 22:00:00,17,110,Friday,22,127
8052,NCON,2016-06-10 23:00:00,13,123,Friday,23,136
8053,NCON,2016-06-11 00:00:00,3,45,Saturday,0,48
8054,NCON,2016-06-11 06:00:00,9,1,Saturday,6,10
8055,NCON,2016-06-11 07:00:00,49,12,Saturday,7,61
8056,NCON,2016-06-11 08:00:00,46,12,Saturday,8,58
8057,NCON,2016-06-11 09:00:00,48,18,Saturday,9,66
8058,NCON,2016-06-11 10:00:00,51,18,Saturday,10,69
8059,NCON,2016-06-11 11:00:00,75,18,Saturday,11,93
8060,NCON,2016-06-11 12:00:00,63,21,Saturday,12,84
8061,NCON,2016-06-11 13:00:00,64,31,Saturday,13,95
8062,NCON,2016-06-11 14:00:00,83,42,Saturday,14,125
8063,NCON,2016-06-11 15:00:00,55,32,Saturday,15,87
8064,NCON,2016-06-11 16:00:00,47,49,Saturday,16,96
8065,NCON,2016-06-11 17:00:00,32,48,Saturday,17,80
8066,NCON,2016-06-11 18:00:00,34,85,Saturday,18,119
8067,NCON,2016-06-11 19:00:00,21,41,Saturday,19,62
8068,NCON,2016-06-11 20:00:00,15,66,Saturday,20,81
8069,NCON,2016-06-11 21:00:00,10,48,Saturday,21,58
8070,NCON,2016-06-11 22:00:00,17,107,Saturday,22,124
8071,NCON,2016-06-11 23:00:00,14,42,Saturday,23,56
8072,NCON,2016-06-12 00:00:00,4,37,Sunday,0,41
8073,NCON,2016-06-12 01:00:00,1,7,Sunday,1,8
8074,NCON,2016-06-12 08:00:00,24,10,Sunday,8,34
8075,NCON,2016-06-12 09:00:00,37,12,Sunday,9,49
8076,NCON,2016-06-12 10:00:00,42,8,Sunday,10,50
8077,NCON,2016-06-12 11:00:00,52,13,Sunday,11,65
8078,NCON,2016-06-12 12:00:00,43,19,Sunday,12,62
8079,NCON,2016-06-12 13:00:00,68,42,Sunday,13,110
8080,NCON,2016-06-12 14:00:00,55,27,Sunday,14,82
8081,NCON,2016-06-12 15:00:00,44,19,Sunday,15,63
8082,NCON,2016-06-12 16:00:00,63,38,Sunday,16,101
8083,NCON,2016-06-12 17:00:00,39,40,Sunday,17,79
8084,NCON,2016-06-12 18:00:00,23,48,Sunday,18,71
8085,NCON,2016-06-12 19:00:00,30,41,Sunday,19,71
8086,NCON,2016-06-12 20:00:00,27,49,Sunday,20,76
8087,NCON,2016-06-12 21:00:00,21,49,Sunday,21,70
8088,NCON,2016-06-12 22:00:00,7,103,Sunday,22,110
8089,NCON,2016-06-12 23:00:00,6,30,Sunday,23,36
8090,NCON,2016-06-13 00:00:00,6,41,Monday,0,47
8091,NCON,2016-06-13 04:00:00,24,3,Monday,4,27
8092,NCON,2016-06-13 05:00:00,153,12,Monday,5,165
8093,NCON,2016-06-13 06:00:00,321,20,Monday,6,341
8094,NCON,2016-06-13 07:00:00,616,36,Monday,7,652
8095,NCON,2016-06-13 08:00:00,690,27,Monday,8,717
8096,NCON,2016-06-13 09:00:00,393,20,Monday,9,413
8097,NCON,2016-06-13 10:00:00,125,24,Monday,10,149
8098,NCON,2016-06-13 11:00:00,85,28,Monday,11,113
8099,NCON,2016-06-13 12:00:00,54,30,Monday,12,84
8100,NCON,2016-06-13 13:00:00,59,59,Monday,13,118
8101,NCON,2016-06-13 14:00:00,54,101,Monday,14,155
8102,NCON,2016-06-13 15:00:00,80,153,Monday,15,233
8103,NCON,2016-06-13 16:00:00,55,287,Monday,16,342
8104,NCON,2016-06-13 17:00:00,112,588,Monday,17,700
8105,NCON,2016-06-13 18:00:00,61,763,Monday,18,824
8106,NCON,2016-06-13 19:00:00,33,220,Monday,19,253
8107,NCON,2016-06-13 20:00:00,9,83,Monday,20,92
8108,NCON,2016-06-13 21:00:00,7,91,Monday,21,98
8109,NCON,2016-06-13 22:00:00,9,69,Monday,22,78
8110,NCON,2016-06-13 23:00:00,7,139,Monday,23,146
8111,NCON,2016-06-14 00:00:00,2,53,Tuesday,0,55
8112,NCON,2016-06-14 01:00:00,1,5,Tuesday,1,6
8113,NCON,2016-06-14 04:00:00,18,2,Tuesday,4,20
8114,NCON,2016-06-14 05:00:00,153,15,Tuesday,5,168
8115,NCON,2016-06-14 06:00:00,373,28,Tuesday,6,401
8116,NCON,2016-06-14 07:00:00,637,41,Tuesday,7,678
8117,NCON,2016-06-14 08:00:00,748,26,Tuesday,8,774
8118,NCON,2016-06-14 09:00:00,409,21,Tuesday,9,430
8119,NCON,2016-06-14 10:00:00,160,21,Tuesday,10,181
8120,NCON,2016-06-14 11:00:00,90,28,Tuesday,11,118
8121,NCON,2016-06-14 12:00:00,47,42,Tuesday,12,89
8122,NCON,2016-06-14 13:00:00,61,58,Tuesday,13,119
8123,NCON,2016-06-14 14:00:00,62,94,Tuesday,14,156
8124,NCON,2016-06-14 15:00:00,76,219,Tuesday,15,295
8125,NCON,2016-06-14 16:00:00,42,318,Tuesday,16,360
8126,NCON,2016-06-14 17:00:00,81,638,Tuesday,17,719
8127,NCON,2016-06-14 18:00:00,57,686,Tuesday,18,743
8128,NCON,2016-06-14 19:00:00,43,300,Tuesday,19,343
8129,NCON,2016-06-14 20:00:00,10,107,Tuesday,20,117
8130,NCON,2016-06-14 21:00:00,14,94,Tuesday,21,108
8131,NCON,2016-06-14 22:00:00,13,83,Tuesday,22,96
8132,NCON,2016-06-14 23:00:00,5,99,Tuesday,23,104
8133,OAKL,2016-06-01 05:00:00,2,45,Wednesday,5,47
8134,OAKL,2016-06-01 06:00:00,6,56,Wednesday,6,62
8135,OAKL,2016-06-01 07:00:00,6,101,Wednesday,7,107
8136,OAKL,2016-06-01 08:00:00,126,96,Wednesday,8,222
8137,OAKL,2016-06-01 09:00:00,146,85,Wednesday,9,231
8138,OAKL,2016-06-01 10:00:00,88,87,Wednesday,10,175
8139,OAKL,2016-06-01 11:00:00,96,98,Wednesday,11,194
8140,OAKL,2016-06-01 12:00:00,72,70,Wednesday,12,142
8141,OAKL,2016-06-01 13:00:00,103,34,Wednesday,13,137
8142,OAKL,2016-06-01 14:00:00,104,59,Wednesday,14,163
8143,OAKL,2016-06-01 15:00:00,75,100,Wednesday,15,175
8144,OAKL,2016-06-01 16:00:00,146,104,Wednesday,16,250
8145,OAKL,2016-06-01 17:00:00,98,104,Wednesday,17,202
8146,OAKL,2016-06-01 18:00:00,98,93,Wednesday,18,191
8147,OAKL,2016-06-01 19:00:00,127,46,Wednesday,19,173
8148,OAKL,2016-06-01 20:00:00,89,11,Wednesday,20,100
8149,OAKL,2016-06-01 21:00:00,89,4,Wednesday,21,93
8150,OAKL,2016-06-01 22:00:00,39,7,Wednesday,22,46
8151,OAKL,2016-06-01 23:00:00,43,2,Wednesday,23,45
8152,OAKL,2016-06-02 00:00:00,21,5,Thursday,0,26
8153,OAKL,2016-06-02 05:00:00,1,55,Thursday,5,56
8154,OAKL,2016-06-02 06:00:00,4,80,Thursday,6,84
8155,OAKL,2016-06-02 07:00:00,16,105,Thursday,7,121
8156,OAKL,2016-06-02 08:00:00,90,86,Thursday,8,176
8157,OAKL,2016-06-02 09:00:00,121,128,Thursday,9,249
8158,OAKL,2016-06-02 10:00:00,63,89,Thursday,10,152
8159,OAKL,2016-06-02 11:00:00,123,98,Thursday,11,221
8160,OAKL,2016-06-02 12:00:00,131,86,Thursday,12,217
8161,OAKL,2016-06-02 13:00:00,85,82,Thursday,13,167
8162,OAKL,2016-06-02 14:00:00,111,101,Thursday,14,212
8163,OAKL,2016-06-02 15:00:00,59,117,Thursday,15,176
8164,OAKL,2016-06-02 16:00:00,135,151,Thursday,16,286
8165,OAKL,2016-06-02 17:00:00,112,151,Thursday,17,263
8166,OAKL,2016-06-02 18:00:00,136,170,Thursday,18,306
8167,OAKL,2016-06-02 19:00:00,90,107,Thursday,19,197
8168,OAKL,2016-06-02 20:00:00,74,37,Thursday,20,111
8169,OAKL,2016-06-02 21:00:00,82,16,Thursday,21,98
8170,OAKL,2016-06-02 22:00:00,45,10,Thursday,22,55
8171,OAKL,2016-06-02 23:00:00,56,7,Thursday,23,63
8172,OAKL,2016-06-03 00:00:00,12,3,Friday,0,15
8173,OAKL,2016-06-03 05:00:00,4,59,Friday,5,63
8174,OAKL,2016-06-03 06:00:00,4,64,Friday,6,68
8175,OAKL,2016-06-03 08:00:00,58,64,Friday,8,122
8176,OAKL,2016-06-03 09:00:00,111,117,Friday,9,228
8177,OAKL,2016-06-03 10:00:00,59,95,Friday,10,154
8178,OAKL,2016-06-03 11:00:00,124,82,Friday,11,206
8179,OAKL,2016-06-03 12:00:00,104,118,Friday,12,222
8180,OAKL,2016-06-03 13:00:00,89,103,Friday,13,192
8181,OAKL,2016-06-03 14:00:00,101,177,Friday,14,278
8182,OAKL,2016-06-03 15:00:00,88,154,Friday,15,242
8183,OAKL,2016-06-03 16:00:00,174,229,Friday,16,403
8184,OAKL,2016-06-03 17:00:00,90,187,Friday,17,277
8185,OAKL,2016-06-03 18:00:00,87,161,Friday,18,248
8186,OAKL,2016-06-03 19:00:00,107,109,Friday,19,216
8187,OAKL,2016-06-03 20:00:00,90,19,Friday,20,109
8188,OAKL,2016-06-03 21:00:00,63,11,Friday,21,74
8189,OAKL,2016-06-03 22:00:00,47,9,Friday,22,56
8190,OAKL,2016-06-03 23:00:00,52,10,Friday,23,62
8191,OAKL,2016-06-04 00:00:00,25,5,Saturday,0,30
8192,OAKL,2016-06-04 06:00:00,1,41,Saturday,6,42
8193,OAKL,2016-06-04 07:00:00,10,79,Saturday,7,89
8194,OAKL,2016-06-04 08:00:00,38,46,Saturday,8,84
8195,OAKL,2016-06-04 09:00:00,111,75,Saturday,9,186
8196,OAKL,2016-06-04 10:00:00,35,53,Saturday,10,88
8197,OAKL,2016-06-04 11:00:00,76,63,Saturday,11,139
8198,OAKL,2016-06-04 12:00:00,43,68,Saturday,12,111
8199,OAKL,2016-06-04 13:00:00,61,59,Saturday,13,120
8200,OAKL,2016-06-04 14:00:00,65,32,Saturday,14,97
8201,OAKL,2016-06-04 15:00:00,63,41,Saturday,15,104
8202,OAKL,2016-06-04 16:00:00,39,55,Saturday,16,94
8203,OAKL,2016-06-04 17:00:00,50,50,Saturday,17,100
8204,OAKL,2016-06-04 18:00:00,71,29,Saturday,18,100
8205,OAKL,2016-06-04 19:00:00,99,24,Saturday,19,123
8206,OAKL,2016-06-04 20:00:00,99,10,Saturday,20,109
8207,OAKL,2016-06-04 21:00:00,67,4,Saturday,21,71
8208,OAKL,2016-06-04 22:00:00,45,3,Saturday,22,48
8209,OAKL,2016-06-05 00:00:00,12,3,Sunday,0,15
8210,OAKL,2016-06-05 01:00:00,1,1,Sunday,1,2
8211,OAKL,2016-06-05 08:00:00,22,33,Sunday,8,55
8212,OAKL,2016-06-05 09:00:00,64,57,Sunday,9,121
8213,OAKL,2016-06-05 10:00:00,33,98,Sunday,10,131
8214,OAKL,2016-06-05 11:00:00,67,56,Sunday,11,123
8215,OAKL,2016-06-05 12:00:00,90,37,Sunday,12,127
8216,OAKL,2016-06-05 13:00:00,87,59,Sunday,13,146
8217,OAKL,2016-06-05 14:00:00,82,79,Sunday,14,161
8218,OAKL,2016-06-05 15:00:00,121,85,Sunday,15,206
8219,OAKL,2016-06-05 16:00:00,144,78,Sunday,16,222
8220,OAKL,2016-06-05 17:00:00,175,67,Sunday,17,242
8221,OAKL,2016-06-05 18:00:00,131,31,Sunday,18,162
8222,OAKL,2016-06-05 19:00:00,133,62,Sunday,19,195
8223,OAKL,2016-06-05 20:00:00,104,30,Sunday,20,134
8224,OAKL,2016-06-05 21:00:00,110,7,Sunday,21,117
8225,OAKL,2016-06-05 22:00:00,75,1,Sunday,22,76
8226,OAKL,2016-06-05 23:00:00,69,1,Sunday,23,70
8227,OAKL,2016-06-06 00:00:00,50,1,Monday,0,51
8228,OAKL,2016-06-06 05:00:00,3,38,Monday,5,41
8229,OAKL,2016-06-06 06:00:00,3,106,Monday,6,109
8230,OAKL,2016-06-06 07:00:00,60,100,Monday,7,160
8231,OAKL,2016-06-06 08:00:00,187,102,Monday,8,289
8232,OAKL,2016-06-06 09:00:00,204,101,Monday,9,305
8233,OAKL,2016-06-06 10:00:00,96,77,Monday,10,173
8234,OAKL,2016-06-06 11:00:00,119,87,Monday,11,206
8235,OAKL,2016-06-06 12:00:00,151,53,Monday,12,204
8236,OAKL,2016-06-06 13:00:00,109,60,Monday,13,169
8237,OAKL,2016-06-06 14:00:00,79,75,Monday,14,154
8238,OAKL,2016-06-06 15:00:00,77,64,Monday,15,141
8239,OAKL,2016-06-06 16:00:00,113,112,Monday,16,225
8240,OAKL,2016-06-06 17:00:00,158,95,Monday,17,253
8241,OAKL,2016-06-06 18:00:00,102,52,Monday,18,154
8242,OAKL,2016-06-06 19:00:00,135,38,Monday,19,173
8243,OAKL,2016-06-06 20:00:00,101,17,Monday,20,118
8244,OAKL,2016-06-06 21:00:00,82,9,Monday,21,91
8245,OAKL,2016-06-06 22:00:00,48,5,Monday,22,53
8246,OAKL,2016-06-06 23:00:00,68,2,Monday,23,70
8247,OAKL,2016-06-07 00:00:00,37,7,Tuesday,0,44
8248,OAKL,2016-06-07 05:00:00,3,48,Tuesday,5,51
8249,OAKL,2016-06-07 06:00:00,4,78,Tuesday,6,82
8250,OAKL,2016-06-07 07:00:00,14,83,Tuesday,7,97
8251,OAKL,2016-06-07 08:00:00,92,70,Tuesday,8,162
8252,OAKL,2016-06-07 09:00:00,184,115,Tuesday,9,299
8253,OAKL,2016-06-07 10:00:00,75,105,Tuesday,10,180
8254,OAKL,2016-06-07 11:00:00,66,59,Tuesday,11,125
8255,OAKL,2016-06-07 12:00:00,93,71,Tuesday,12,164
8256,OAKL,2016-06-07 13:00:00,83,65,Tuesday,13,148
8257,OAKL,2016-06-07 14:00:00,56,99,Tuesday,14,155
8258,OAKL,2016-06-07 15:00:00,63,102,Tuesday,15,165
8259,OAKL,2016-06-07 16:00:00,107,139,Tuesday,16,246
8260,OAKL,2016-06-07 17:00:00,81,112,Tuesday,17,193
8261,OAKL,2016-06-07 18:00:00,79,65,Tuesday,18,144
8262,OAKL,2016-06-07 19:00:00,109,42,Tuesday,19,151
8263,OAKL,2016-06-07 20:00:00,68,19,Tuesday,20,87
8264,OAKL,2016-06-07 21:00:00,92,4,Tuesday,21,96
8265,OAKL,2016-06-07 22:00:00,53,1,Tuesday,22,54
8266,OAKL,2016-06-07 23:00:00,60,1,Tuesday,23,61
8267,OAKL,2016-06-08 00:00:00,15,3,Wednesday,0,18
8268,OAKL,2016-06-08 05:00:00,4,46,Wednesday,5,50
8269,OAKL,2016-06-08 06:00:00,6,83,Wednesday,6,89
8270,OAKL,2016-06-08 07:00:00,12,103,Wednesday,7,115
8271,OAKL,2016-06-08 08:00:00,44,65,Wednesday,8,109
8272,OAKL,2016-06-08 09:00:00,142,87,Wednesday,9,229
8273,OAKL,2016-06-08 10:00:00,105,96,Wednesday,10,201
8274,OAKL,2016-06-08 11:00:00,97,75,Wednesday,11,172
8275,OAKL,2016-06-08 12:00:00,83,62,Wednesday,12,145
8276,OAKL,2016-06-08 13:00:00,101,48,Wednesday,13,149
8277,OAKL,2016-06-08 14:00:00,61,77,Wednesday,14,138
8278,OAKL,2016-06-08 15:00:00,76,80,Wednesday,15,156
8279,OAKL,2016-06-08 16:00:00,99,152,Wednesday,16,251
8280,OAKL,2016-06-08 17:00:00,97,171,Wednesday,17,268
8281,OAKL,2016-06-08 18:00:00,68,125,Wednesday,18,193
8282,OAKL,2016-06-08 19:00:00,116,71,Wednesday,19,187
8283,OAKL,2016-06-08 20:00:00,105,15,Wednesday,20,120
8284,OAKL,2016-06-08 21:00:00,78,11,Wednesday,21,89
8285,OAKL,2016-06-08 22:00:00,40,8,Wednesday,22,48
8286,OAKL,2016-06-08 23:00:00,47,1,Wednesday,23,48
8287,OAKL,2016-06-09 00:00:00,19,2,Thursday,0,21
8288,OAKL,2016-06-09 01:00:00,4,1,Thursday,1,5
8289,OAKL,2016-06-09 06:00:00,3,106,Thursday,6,109
8290,OAKL,2016-06-09 07:00:00,18,118,Thursday,7,136
8291,OAKL,2016-06-09 08:00:00,95,122,Thursday,8,217
8292,OAKL,2016-06-09 09:00:00,135,128,Thursday,9,263
8293,OAKL,2016-06-09 10:00:00,73,101,Thursday,10,174
8294,OAKL,2016-06-09 11:00:00,66,105,Thursday,11,171
8295,OAKL,2016-06-09 12:00:00,138,86,Thursday,12,224
8296,OAKL,2016-06-09 13:00:00,121,99,Thursday,13,220
8297,OAKL,2016-06-09 14:00:00,68,108,Thursday,14,176
8298,OAKL,2016-06-09 15:00:00,86,110,Thursday,15,196
8299,OAKL,2016-06-09 16:00:00,130,234,Thursday,16,364
8300,OAKL,2016-06-09 17:00:00,147,247,Thursday,17,394
8301,OAKL,2016-06-09 18:00:00,137,155,Thursday,18,292
8302,OAKL,2016-06-09 19:00:00,145,102,Thursday,19,247
8303,OAKL,2016-06-09 20:00:00,72,49,Thursday,20,121
8304,OAKL,2016-06-09 21:00:00,39,22,Thursday,21,61
8305,OAKL,2016-06-09 22:00:00,62,7,Thursday,22,69
8306,OAKL,2016-06-09 23:00:00,67,3,Thursday,23,70
8307,OAKL,2016-06-10 00:00:00,32,6,Friday,0,38
8308,OAKL,2016-06-10 05:00:00,5,74,Friday,5,79
8309,OAKL,2016-06-10 06:00:00,3,125,Friday,6,128
8310,OAKL,2016-06-10 07:00:00,9,140,Friday,7,149
8311,OAKL,2016-06-10 08:00:00,113,85,Friday,8,198
8312,OAKL,2016-06-10 09:00:00,143,115,Friday,9,258
8313,OAKL,2016-06-10 10:00:00,74,97,Friday,10,171
8314,OAKL,2016-06-10 11:00:00,83,87,Friday,11,170
8315,OAKL,2016-06-10 12:00:00,137,129,Friday,12,266
8316,OAKL,2016-06-10 13:00:00,123,116,Friday,13,239
8317,OAKL,2016-06-10 14:00:00,101,145,Friday,14,246
8318,OAKL,2016-06-10 15:00:00,100,183,Friday,15,283
8319,OAKL,2016-06-10 16:00:00,135,207,Friday,16,342
8320,OAKL,2016-06-10 17:00:00,135,257,Friday,17,392
8321,OAKL,2016-06-10 18:00:00,153,189,Friday,18,342
8322,OAKL,2016-06-10 19:00:00,121,97,Friday,19,218
8323,OAKL,2016-06-10 20:00:00,84,44,Friday,20,128
8324,OAKL,2016-06-10 21:00:00,54,23,Friday,21,77
8325,OAKL,2016-06-10 22:00:00,73,12,Friday,22,85
8326,OAKL,2016-06-10 23:00:00,38,4,Friday,23,42
8327,OAKL,2016-06-11 00:00:00,30,1,Saturday,0,31
8328,OAKL,2016-06-11 06:00:00,4,54,Saturday,6,58
8329,OAKL,2016-06-11 07:00:00,2,73,Saturday,7,75
8330,OAKL,2016-06-11 08:00:00,30,48,Saturday,8,78
8331,OAKL,2016-06-11 09:00:00,118,86,Saturday,9,204
8332,OAKL,2016-06-11 10:00:00,53,72,Saturday,10,125
8333,OAKL,2016-06-11 11:00:00,67,58,Saturday,11,125
8334,OAKL,2016-06-11 12:00:00,70,40,Saturday,12,110
8335,OAKL,2016-06-11 13:00:00,101,45,Saturday,13,146
8336,OAKL,2016-06-11 14:00:00,53,46,Saturday,14,99
8337,OAKL,2016-06-11 15:00:00,37,68,Saturday,15,105
8338,OAKL,2016-06-11 16:00:00,48,61,Saturday,16,109
8339,OAKL,2016-06-11 17:00:00,48,51,Saturday,17,99
8340,OAKL,2016-06-11 18:00:00,72,24,Saturday,18,96
8341,OAKL,2016-06-11 19:00:00,106,50,Saturday,19,156
8342,OAKL,2016-06-11 20:00:00,71,14,Saturday,20,85
8343,OAKL,2016-06-11 21:00:00,58,10,Saturday,21,68
8344,OAKL,2016-06-11 22:00:00,76,4,Saturday,22,80
8345,OAKL,2016-06-11 23:00:00,40,1,Saturday,23,41
8346,OAKL,2016-06-12 00:00:00,33,7,Sunday,0,40
8347,OAKL,2016-06-12 08:00:00,45,41,Sunday,8,86
8348,OAKL,2016-06-12 09:00:00,82,53,Sunday,9,135
8349,OAKL,2016-06-12 10:00:00,48,73,Sunday,10,121
8350,OAKL,2016-06-12 11:00:00,63,60,Sunday,11,123
8351,OAKL,2016-06-12 12:00:00,103,59,Sunday,12,162
8352,OAKL,2016-06-12 13:00:00,155,73,Sunday,13,228
8353,OAKL,2016-06-12 14:00:00,115,67,Sunday,14,182
8354,OAKL,2016-06-12 15:00:00,92,69,Sunday,15,161
8355,OAKL,2016-06-12 16:00:00,144,66,Sunday,16,210
8356,OAKL,2016-06-12 17:00:00,127,69,Sunday,17,196
8357,OAKL,2016-06-12 18:00:00,104,51,Sunday,18,155
8358,OAKL,2016-06-12 19:00:00,175,32,Sunday,19,207
8359,OAKL,2016-06-12 20:00:00,97,20,Sunday,20,117
8360,OAKL,2016-06-12 21:00:00,127,9,Sunday,21,136
8361,OAKL,2016-06-12 22:00:00,74,10,Sunday,22,84
8362,OAKL,2016-06-12 23:00:00,66,4,Sunday,23,70
8363,OAKL,2016-06-13 05:00:00,2,41,Monday,5,43
8364,OAKL,2016-06-13 06:00:00,22,89,Monday,6,111
8365,OAKL,2016-06-13 07:00:00,54,114,Monday,7,168
8366,OAKL,2016-06-13 08:00:00,182,96,Monday,8,278
8367,OAKL,2016-06-13 09:00:00,260,145,Monday,9,405
8368,OAKL,2016-06-13 10:00:00,143,101,Monday,10,244
8369,OAKL,2016-06-13 11:00:00,131,92,Monday,11,223
8370,OAKL,2016-06-13 12:00:00,159,73,Monday,12,232
8371,OAKL,2016-06-13 13:00:00,157,66,Monday,13,223
8372,OAKL,2016-06-13 14:00:00,73,97,Monday,14,170
8373,OAKL,2016-06-13 15:00:00,109,100,Monday,15,209
8374,OAKL,2016-06-13 16:00:00,128,141,Monday,16,269
8375,OAKL,2016-06-13 17:00:00,164,159,Monday,17,323
8376,OAKL,2016-06-13 18:00:00,135,69,Monday,18,204
8377,OAKL,2016-06-13 19:00:00,148,53,Monday,19,201
8378,OAKL,2016-06-13 20:00:00,136,34,Monday,20,170
8379,OAKL,2016-06-13 21:00:00,91,41,Monday,21,132
8380,OAKL,2016-06-13 22:00:00,69,8,Monday,22,77
8381,OAKL,2016-06-13 23:00:00,64,1,Monday,23,65
8382,OAKL,2016-06-14 00:00:00,25,10,Tuesday,0,35
8383,OAKL,2016-06-14 05:00:00,1,43,Tuesday,5,44
8384,OAKL,2016-06-14 06:00:00,8,73,Tuesday,6,81
8385,OAKL,2016-06-14 07:00:00,11,125,Tuesday,7,136
8386,OAKL,2016-06-14 08:00:00,88,90,Tuesday,8,178
8387,OAKL,2016-06-14 09:00:00,184,101,Tuesday,9,285
8388,OAKL,2016-06-14 10:00:00,99,96,Tuesday,10,195
8389,OAKL,2016-06-14 11:00:00,106,78,Tuesday,11,184
8390,OAKL,2016-06-14 12:00:00,101,65,Tuesday,12,166
8391,OAKL,2016-06-14 13:00:00,116,56,Tuesday,13,172
8392,OAKL,2016-06-14 14:00:00,65,60,Tuesday,14,125
8393,OAKL,2016-06-14 15:00:00,68,100,Tuesday,15,168
8394,OAKL,2016-06-14 16:00:00,68,161,Tuesday,16,229
8395,OAKL,2016-06-14 17:00:00,105,129,Tuesday,17,234
8396,OAKL,2016-06-14 18:00:00,142,65,Tuesday,18,207
8397,OAKL,2016-06-14 19:00:00,124,58,Tuesday,19,182
8398,OAKL,2016-06-14 20:00:00,66,18,Tuesday,20,84
8399,OAKL,2016-06-14 21:00:00,67,9,Tuesday,21,76
8400,OAKL,2016-06-14 22:00:00,26,5,Tuesday,22,31
8401,OAKL,2016-06-14 23:00:00,36,1,Tuesday,23,37
8402,ORIN,2016-06-01 01:00:00,1,2,Wednesday,1,3
8403,ORIN,2016-06-01 04:00:00,1,3,Wednesday,4,4
8404,ORIN,2016-06-01 05:00:00,114,11,Wednesday,5,125
8405,ORIN,2016-06-01 06:00:00,227,37,Wednesday,6,264
8406,ORIN,2016-06-01 07:00:00,673,84,Wednesday,7,757
8407,ORIN,2016-06-01 08:00:00,735,116,Wednesday,8,851
8408,ORIN,2016-06-01 09:00:00,306,214,Wednesday,9,520
8409,ORIN,2016-06-01 10:00:00,205,39,Wednesday,10,244
8410,ORIN,2016-06-01 11:00:00,83,39,Wednesday,11,122
8411,ORIN,2016-06-01 12:00:00,88,59,Wednesday,12,147
8412,ORIN,2016-06-01 13:00:00,177,75,Wednesday,13,252
8413,ORIN,2016-06-01 14:00:00,121,115,Wednesday,14,236
8414,ORIN,2016-06-01 15:00:00,59,204,Wednesday,15,263
8415,ORIN,2016-06-01 16:00:00,105,431,Wednesday,16,536
8416,ORIN,2016-06-01 17:00:00,127,728,Wednesday,17,855
8417,ORIN,2016-06-01 18:00:00,88,603,Wednesday,18,691
8418,ORIN,2016-06-01 19:00:00,61,309,Wednesday,19,370
8419,ORIN,2016-06-01 20:00:00,38,124,Wednesday,20,162
8420,ORIN,2016-06-01 21:00:00,38,110,Wednesday,21,148
8421,ORIN,2016-06-01 22:00:00,26,73,Wednesday,22,99
8422,ORIN,2016-06-01 23:00:00,18,39,Wednesday,23,57
8423,ORIN,2016-06-02 05:00:00,92,13,Thursday,5,105
8424,ORIN,2016-06-02 06:00:00,239,41,Thursday,6,280
8425,ORIN,2016-06-02 07:00:00,635,89,Thursday,7,724
8426,ORIN,2016-06-02 08:00:00,708,78,Thursday,8,786
8427,ORIN,2016-06-02 09:00:00,366,58,Thursday,9,424
8428,ORIN,2016-06-02 10:00:00,210,43,Thursday,10,253
8429,ORIN,2016-06-02 11:00:00,116,36,Thursday,11,152
8430,ORIN,2016-06-02 12:00:00,50,72,Thursday,12,122
8431,ORIN,2016-06-02 13:00:00,71,77,Thursday,13,148
8432,ORIN,2016-06-02 14:00:00,68,120,Thursday,14,188
8433,ORIN,2016-06-02 15:00:00,78,213,Thursday,15,291
8434,ORIN,2016-06-02 16:00:00,88,371,Thursday,16,459
8435,ORIN,2016-06-02 17:00:00,157,867,Thursday,17,1024
8436,ORIN,2016-06-02 18:00:00,100,575,Thursday,18,675
8437,ORIN,2016-06-02 19:00:00,62,223,Thursday,19,285
8438,ORIN,2016-06-02 20:00:00,45,158,Thursday,20,203
8439,ORIN,2016-06-02 21:00:00,26,128,Thursday,21,154
8440,ORIN,2016-06-02 22:00:00,40,100,Thursday,22,140
8441,ORIN,2016-06-02 23:00:00,9,39,Thursday,23,48
8442,ORIN,2016-06-03 00:00:00,3,18,Friday,0,21
8443,ORIN,2016-06-03 04:00:00,1,1,Friday,4,2
8444,ORIN,2016-06-03 05:00:00,106,7,Friday,5,113
8445,ORIN,2016-06-03 06:00:00,197,29,Friday,6,226
8446,ORIN,2016-06-03 07:00:00,516,76,Friday,7,592
8447,ORIN,2016-06-03 08:00:00,626,77,Friday,8,703
8448,ORIN,2016-06-03 09:00:00,312,220,Friday,9,532
8449,ORIN,2016-06-03 10:00:00,192,47,Friday,10,239
8450,ORIN,2016-06-03 11:00:00,102,40,Friday,11,142
8451,ORIN,2016-06-03 12:00:00,84,65,Friday,12,149
8452,ORIN,2016-06-03 13:00:00,196,96,Friday,13,292
8453,ORIN,2016-06-03 14:00:00,79,169,Friday,14,248
8454,ORIN,2016-06-03 15:00:00,99,245,Friday,15,344
8455,ORIN,2016-06-03 16:00:00,93,451,Friday,16,544
8456,ORIN,2016-06-03 17:00:00,140,557,Friday,17,697
8457,ORIN,2016-06-03 18:00:00,138,427,Friday,18,565
8458,ORIN,2016-06-03 19:00:00,98,175,Friday,19,273
8459,ORIN,2016-06-03 20:00:00,34,84,Friday,20,118
8460,ORIN,2016-06-03 21:00:00,30,101,Friday,21,131
8461,ORIN,2016-06-03 22:00:00,33,113,Friday,22,146
8462,ORIN,2016-06-03 23:00:00,18,50,Friday,23,68
8463,ORIN,2016-06-04 00:00:00,2,43,Saturday,0,45
8464,ORIN,2016-06-04 06:00:00,8,8,Saturday,6,16
8465,ORIN,2016-06-04 07:00:00,21,19,Saturday,7,40
8466,ORIN,2016-06-04 08:00:00,39,33,Saturday,8,72
8467,ORIN,2016-06-04 09:00:00,76,41,Saturday,9,117
8468,ORIN,2016-06-04 10:00:00,82,54,Saturday,10,136
8469,ORIN,2016-06-04 11:00:00,102,37,Saturday,11,139
8470,ORIN,2016-06-04 12:00:00,86,50,Saturday,12,136
8471,ORIN,2016-06-04 13:00:00,84,73,Saturday,13,157
8472,ORIN,2016-06-04 14:00:00,89,65,Saturday,14,154
8473,ORIN,2016-06-04 15:00:00,68,87,Saturday,15,155
8474,ORIN,2016-06-04 16:00:00,68,93,Saturday,16,161
8475,ORIN,2016-06-04 17:00:00,107,118,Saturday,17,225
8476,ORIN,2016-06-04 18:00:00,77,81,Saturday,18,158
8477,ORIN,2016-06-04 19:00:00,70,81,Saturday,19,151
8478,ORIN,2016-06-04 20:00:00,32,53,Saturday,20,85
8479,ORIN,2016-06-04 21:00:00,31,70,Saturday,21,101
8480,ORIN,2016-06-04 22:00:00,46,76,Saturday,22,122
8481,ORIN,2016-06-04 23:00:00,22,67,Saturday,23,89
8482,ORIN,2016-06-05 00:00:00,9,41,Sunday,0,50
8483,ORIN,2016-06-05 08:00:00,20,16,Sunday,8,36
8484,ORIN,2016-06-05 09:00:00,44,39,Sunday,9,83
8485,ORIN,2016-06-05 10:00:00,61,40,Sunday,10,101
8486,ORIN,2016-06-05 11:00:00,102,48,Sunday,11,150
8487,ORIN,2016-06-05 12:00:00,78,67,Sunday,12,145
8488,ORIN,2016-06-05 13:00:00,77,67,Sunday,13,144
8489,ORIN,2016-06-05 14:00:00,78,58,Sunday,14,136
8490,ORIN,2016-06-05 15:00:00,79,56,Sunday,15,135
8491,ORIN,2016-06-05 16:00:00,66,103,Sunday,16,169
8492,ORIN,2016-06-05 17:00:00,37,82,Sunday,17,119
8493,ORIN,2016-06-05 18:00:00,50,59,Sunday,18,109
8494,ORIN,2016-06-05 19:00:00,29,54,Sunday,19,83
8495,ORIN,2016-06-05 20:00:00,35,84,Sunday,20,119
8496,ORIN,2016-06-05 21:00:00,34,45,Sunday,21,79
8497,ORIN,2016-06-05 22:00:00,16,29,Sunday,22,45
8498,ORIN,2016-06-05 23:00:00,4,20,Sunday,23,24
8499,ORIN,2016-06-06 00:00:00,1,13,Monday,0,14
8500,ORIN,2016-06-06 04:00:00,13,1,Monday,4,14
8501,ORIN,2016-06-06 05:00:00,88,4,Monday,5,92
8502,ORIN,2016-06-06 06:00:00,211,35,Monday,6,246
8503,ORIN,2016-06-06 07:00:00,652,72,Monday,7,724
8504,ORIN,2016-06-06 08:00:00,735,70,Monday,8,805
8505,ORIN,2016-06-06 09:00:00,358,63,Monday,9,421
8506,ORIN,2016-06-06 10:00:00,187,54,Monday,10,241
8507,ORIN,2016-06-06 11:00:00,76,43,Monday,11,119
8508,ORIN,2016-06-06 12:00:00,63,54,Monday,12,117
8509,ORIN,2016-06-06 13:00:00,67,77,Monday,13,144
8510,ORIN,2016-06-06 14:00:00,66,122,Monday,14,188
8511,ORIN,2016-06-06 15:00:00,72,186,Monday,15,258
8512,ORIN,2016-06-06 16:00:00,100,371,Monday,16,471
8513,ORIN,2016-06-06 17:00:00,110,724,Monday,17,834
8514,ORIN,2016-06-06 18:00:00,81,642,Monday,18,723
8515,ORIN,2016-06-06 19:00:00,33,274,Monday,19,307
8516,ORIN,2016-06-06 20:00:00,28,134,Monday,20,162
8517,ORIN,2016-06-06 21:00:00,19,95,Monday,21,114
8518,ORIN,2016-06-06 22:00:00,19,58,Monday,22,77
8519,ORIN,2016-06-06 23:00:00,7,19,Monday,23,26
8520,ORIN,2016-06-07 00:00:00,1,17,Tuesday,0,18
8521,ORIN,2016-06-07 04:00:00,13,4,Tuesday,4,17
8522,ORIN,2016-06-07 05:00:00,98,6,Tuesday,5,104
8523,ORIN,2016-06-07 06:00:00,231,31,Tuesday,6,262
8524,ORIN,2016-06-07 07:00:00,606,70,Tuesday,7,676
8525,ORIN,2016-06-07 08:00:00,748,77,Tuesday,8,825
8526,ORIN,2016-06-07 09:00:00,343,43,Tuesday,9,386
8527,ORIN,2016-06-07 10:00:00,192,50,Tuesday,10,242
8528,ORIN,2016-06-07 11:00:00,98,44,Tuesday,11,142
8529,ORIN,2016-06-07 12:00:00,65,44,Tuesday,12,109
8530,ORIN,2016-06-07 13:00:00,77,82,Tuesday,13,159
8531,ORIN,2016-06-07 14:00:00,52,121,Tuesday,14,173
8532,ORIN,2016-06-07 15:00:00,66,217,Tuesday,15,283
8533,ORIN,2016-06-07 16:00:00,100,445,Tuesday,16,545
8534,ORIN,2016-06-07 17:00:00,183,682,Tuesday,17,865
8535,ORIN,2016-06-07 18:00:00,142,632,Tuesday,18,774
8536,ORIN,2016-06-07 19:00:00,58,291,Tuesday,19,349
8537,ORIN,2016-06-07 20:00:00,20,112,Tuesday,20,132
8538,ORIN,2016-06-07 21:00:00,13,105,Tuesday,21,118
8539,ORIN,2016-06-07 22:00:00,39,98,Tuesday,22,137
8540,ORIN,2016-06-07 23:00:00,13,126,Tuesday,23,139
8541,ORIN,2016-06-08 00:00:00,2,33,Wednesday,0,35
8542,ORIN,2016-06-08 01:00:00,3,2,Wednesday,1,5
8543,ORIN,2016-06-08 04:00:00,10,1,Wednesday,4,11
8544,ORIN,2016-06-08 05:00:00,90,7,Wednesday,5,97
8545,ORIN,2016-06-08 06:00:00,233,36,Wednesday,6,269
8546,ORIN,2016-06-08 07:00:00,628,68,Wednesday,7,696
8547,ORIN,2016-06-08 08:00:00,695,85,Wednesday,8,780
8548,ORIN,2016-06-08 09:00:00,354,39,Wednesday,9,393
8549,ORIN,2016-06-08 10:00:00,189,52,Wednesday,10,241
8550,ORIN,2016-06-08 11:00:00,116,41,Wednesday,11,157
8551,ORIN,2016-06-08 12:00:00,100,54,Wednesday,12,154
8552,ORIN,2016-06-08 13:00:00,60,83,Wednesday,13,143
8553,ORIN,2016-06-08 14:00:00,72,122,Wednesday,14,194
8554,ORIN,2016-06-08 15:00:00,86,200,Wednesday,15,286
8555,ORIN,2016-06-08 16:00:00,104,440,Wednesday,16,544
8556,ORIN,2016-06-08 17:00:00,203,789,Wednesday,17,992
8557,ORIN,2016-06-08 18:00:00,159,609,Wednesday,18,768
8558,ORIN,2016-06-08 19:00:00,52,232,Wednesday,19,284
8559,ORIN,2016-06-08 20:00:00,19,112,Wednesday,20,131
8560,ORIN,2016-06-08 21:00:00,39,166,Wednesday,21,205
8561,ORIN,2016-06-08 22:00:00,20,106,Wednesday,22,126
8562,ORIN,2016-06-08 23:00:00,16,123,Wednesday,23,139
8563,ORIN,2016-06-09 00:00:00,3,22,Thursday,0,25
8564,ORIN,2016-06-09 04:00:00,1,1,Thursday,4,2
8565,ORIN,2016-06-09 05:00:00,102,7,Thursday,5,109
8566,ORIN,2016-06-09 06:00:00,220,37,Thursday,6,257
8567,ORIN,2016-06-09 07:00:00,560,84,Thursday,7,644
8568,ORIN,2016-06-09 08:00:00,678,78,Thursday,8,756
8569,ORIN,2016-06-09 09:00:00,339,48,Thursday,9,387
8570,ORIN,2016-06-09 10:00:00,199,60,Thursday,10,259
8571,ORIN,2016-06-09 11:00:00,95,45,Thursday,11,140
8572,ORIN,2016-06-09 12:00:00,89,61,Thursday,12,150
8573,ORIN,2016-06-09 13:00:00,94,76,Thursday,13,170
8574,ORIN,2016-06-09 14:00:00,74,106,Thursday,14,180
8575,ORIN,2016-06-09 15:00:00,67,238,Thursday,15,305
8576,ORIN,2016-06-09 16:00:00,81,446,Thursday,16,527
8577,ORIN,2016-06-09 17:00:00,118,672,Thursday,17,790
8578,ORIN,2016-06-09 18:00:00,98,561,Thursday,18,659
8579,ORIN,2016-06-09 19:00:00,48,295,Thursday,19,343
8580,ORIN,2016-06-09 20:00:00,30,99,Thursday,20,129
8581,ORIN,2016-06-09 21:00:00,57,98,Thursday,21,155
8582,ORIN,2016-06-09 22:00:00,60,88,Thursday,22,148
8583,ORIN,2016-06-09 23:00:00,16,50,Thursday,23,66
8584,ORIN,2016-06-10 00:00:00,7,27,Friday,0,34
8585,ORIN,2016-06-10 04:00:00,1,2,Friday,4,3
8586,ORIN,2016-06-10 05:00:00,82,5,Friday,5,87
8587,ORIN,2016-06-10 06:00:00,196,32,Friday,6,228
8588,ORIN,2016-06-10 07:00:00,465,67,Friday,7,532
8589,ORIN,2016-06-10 08:00:00,583,59,Friday,8,642
8590,ORIN,2016-06-10 09:00:00,280,39,Friday,9,319
8591,ORIN,2016-06-10 10:00:00,181,61,Friday,10,242
8592,ORIN,2016-06-10 11:00:00,120,52,Friday,11,172
8593,ORIN,2016-06-10 12:00:00,97,69,Friday,12,166
8594,ORIN,2016-06-10 13:00:00,115,105,Friday,13,220
8595,ORIN,2016-06-10 14:00:00,90,178,Friday,14,268
8596,ORIN,2016-06-10 15:00:00,76,268,Friday,15,344
8597,ORIN,2016-06-10 16:00:00,115,446,Friday,16,561
8598,ORIN,2016-06-10 17:00:00,176,564,Friday,17,740
8599,ORIN,2016-06-10 18:00:00,134,402,Friday,18,536
8600,ORIN,2016-06-10 19:00:00,66,148,Friday,19,214
8601,ORIN,2016-06-10 20:00:00,33,88,Friday,20,121
8602,ORIN,2016-06-10 21:00:00,45,51,Friday,21,96
8603,ORIN,2016-06-10 22:00:00,65,145,Friday,22,210
8604,ORIN,2016-06-10 23:00:00,27,93,Friday,23,120
8605,ORIN,2016-06-11 00:00:00,3,57,Saturday,0,60
8606,ORIN,2016-06-11 06:00:00,7,10,Saturday,6,17
8607,ORIN,2016-06-11 07:00:00,35,18,Saturday,7,53
8608,ORIN,2016-06-11 08:00:00,60,25,Saturday,8,85
8609,ORIN,2016-06-11 09:00:00,65,48,Saturday,9,113
8610,ORIN,2016-06-11 10:00:00,102,40,Saturday,10,142
8611,ORIN,2016-06-11 11:00:00,92,40,Saturday,11,132
8612,ORIN,2016-06-11 12:00:00,144,41,Saturday,12,185
8613,ORIN,2016-06-11 13:00:00,116,74,Saturday,13,190
8614,ORIN,2016-06-11 14:00:00,132,56,Saturday,14,188
8615,ORIN,2016-06-11 15:00:00,100,91,Saturday,15,191
8616,ORIN,2016-06-11 16:00:00,80,105,Saturday,16,185
8617,ORIN,2016-06-11 17:00:00,94,87,Saturday,17,181
8618,ORIN,2016-06-11 18:00:00,63,81,Saturday,18,144
8619,ORIN,2016-06-11 19:00:00,55,74,Saturday,19,129
8620,ORIN,2016-06-11 20:00:00,39,63,Saturday,20,102
8621,ORIN,2016-06-11 21:00:00,35,139,Saturday,21,174
8622,ORIN,2016-06-11 22:00:00,39,75,Saturday,22,114
8623,ORIN,2016-06-11 23:00:00,31,70,Saturday,23,101
8624,ORIN,2016-06-12 00:00:00,2,32,Sunday,0,34
8625,ORIN,2016-06-12 01:00:00,3,4,Sunday,1,7
8626,ORIN,2016-06-12 08:00:00,32,22,Sunday,8,54
8627,ORIN,2016-06-12 09:00:00,68,43,Sunday,9,111
8628,ORIN,2016-06-12 10:00:00,82,39,Sunday,10,121
8629,ORIN,2016-06-12 11:00:00,113,62,Sunday,11,175
8630,ORIN,2016-06-12 12:00:00,114,51,Sunday,12,165
8631,ORIN,2016-06-12 13:00:00,99,64,Sunday,13,163
8632,ORIN,2016-06-12 14:00:00,99,73,Sunday,14,172
8633,ORIN,2016-06-12 15:00:00,93,106,Sunday,15,199
8634,ORIN,2016-06-12 16:00:00,101,88,Sunday,16,189
8635,ORIN,2016-06-12 17:00:00,90,112,Sunday,17,202
8636,ORIN,2016-06-12 18:00:00,42,90,Sunday,18,132
8637,ORIN,2016-06-12 19:00:00,39,47,Sunday,19,86
8638,ORIN,2016-06-12 20:00:00,46,88,Sunday,20,134
8639,ORIN,2016-06-12 21:00:00,24,105,Sunday,21,129
8640,ORIN,2016-06-12 22:00:00,27,100,Sunday,22,127
8641,ORIN,2016-06-12 23:00:00,7,35,Sunday,23,42
8642,ORIN,2016-06-13 00:00:00,1,20,Monday,0,21
8643,ORIN,2016-06-13 01:00:00,1,1,Monday,1,2
8644,ORIN,2016-06-13 04:00:00,14,2,Monday,4,16
8645,ORIN,2016-06-13 05:00:00,90,8,Monday,5,98
8646,ORIN,2016-06-13 06:00:00,218,37,Monday,6,255
8647,ORIN,2016-06-13 07:00:00,641,52,Monday,7,693
8648,ORIN,2016-06-13 08:00:00,717,62,Monday,8,779
8649,ORIN,2016-06-13 09:00:00,340,53,Monday,9,393
8650,ORIN,2016-06-13 10:00:00,195,39,Monday,10,234
8651,ORIN,2016-06-13 11:00:00,87,38,Monday,11,125
8652,ORIN,2016-06-13 12:00:00,69,53,Monday,12,122
8653,ORIN,2016-06-13 13:00:00,58,74,Monday,13,132
8654,ORIN,2016-06-13 14:00:00,63,110,Monday,14,173
8655,ORIN,2016-06-13 15:00:00,77,198,Monday,15,275
8656,ORIN,2016-06-13 16:00:00,144,474,Monday,16,618
8657,ORIN,2016-06-13 17:00:00,193,772,Monday,17,965
8658,ORIN,2016-06-13 18:00:00,113,614,Monday,18,727
8659,ORIN,2016-06-13 19:00:00,58,203,Monday,19,261
8660,ORIN,2016-06-13 20:00:00,25,83,Monday,20,108
8661,ORIN,2016-06-13 21:00:00,27,130,Monday,21,157
8662,ORIN,2016-06-13 22:00:00,27,125,Monday,22,152
8663,ORIN,2016-06-13 23:00:00,7,86,Monday,23,93
8664,ORIN,2016-06-14 00:00:00,3,33,Tuesday,0,36
8665,ORIN,2016-06-14 04:00:00,14,2,Tuesday,4,16
8666,ORIN,2016-06-14 05:00:00,87,6,Tuesday,5,93
8667,ORIN,2016-06-14 06:00:00,222,34,Tuesday,6,256
8668,ORIN,2016-06-14 07:00:00,601,77,Tuesday,7,678
8669,ORIN,2016-06-14 08:00:00,762,68,Tuesday,8,830
8670,ORIN,2016-06-14 09:00:00,339,53,Tuesday,9,392
8671,ORIN,2016-06-14 10:00:00,188,44,Tuesday,10,232
8672,ORIN,2016-06-14 11:00:00,99,48,Tuesday,11,147
8673,ORIN,2016-06-14 12:00:00,90,51,Tuesday,12,141
8674,ORIN,2016-06-14 13:00:00,74,58,Tuesday,13,132
8675,ORIN,2016-06-14 14:00:00,66,107,Tuesday,14,173
8676,ORIN,2016-06-14 15:00:00,74,207,Tuesday,15,281
8677,ORIN,2016-06-14 16:00:00,92,430,Tuesday,16,522
8678,ORIN,2016-06-14 17:00:00,159,792,Tuesday,17,951
8679,ORIN,2016-06-14 18:00:00,134,556,Tuesday,18,690
8680,ORIN,2016-06-14 19:00:00,64,292,Tuesday,19,356
8681,ORIN,2016-06-14 20:00:00,27,104,Tuesday,20,131
8682,ORIN,2016-06-14 21:00:00,36,102,Tuesday,21,138
8683,ORIN,2016-06-14 22:00:00,54,82,Tuesday,22,136
8684,ORIN,2016-06-14 23:00:00,14,132,Tuesday,23,146
8685,PHIL,2016-06-01 04:00:00,7,2,Wednesday,4,9
8686,PHIL,2016-06-01 05:00:00,219,33,Wednesday,5,252
8687,PHIL,2016-06-01 06:00:00,641,114,Wednesday,6,755
8688,PHIL,2016-06-01 07:00:00,1629,180,Wednesday,7,1809
8689,PHIL,2016-06-01 08:00:00,2488,211,Wednesday,8,2699
8690,PHIL,2016-06-01 09:00:00,994,113,Wednesday,9,1107
8691,PHIL,2016-06-01 10:00:00,470,78,Wednesday,10,548
8692,PHIL,2016-06-01 11:00:00,238,75,Wednesday,11,313
8693,PHIL,2016-06-01 12:00:00,161,93,Wednesday,12,254
8694,PHIL,2016-06-01 13:00:00,129,164,Wednesday,13,293
8695,PHIL,2016-06-01 14:00:00,88,191,Wednesday,14,279
8696,PHIL,2016-06-01 15:00:00,123,377,Wednesday,15,500
8697,PHIL,2016-06-01 16:00:00,151,954,Wednesday,16,1105
8698,PHIL,2016-06-01 17:00:00,262,1650,Wednesday,17,1912
8699,PHIL,2016-06-01 18:00:00,182,1978,Wednesday,18,2160
8700,PHIL,2016-06-01 19:00:00,120,782,Wednesday,19,902
8701,PHIL,2016-06-01 20:00:00,55,422,Wednesday,20,477
8702,PHIL,2016-06-01 21:00:00,46,195,Wednesday,21,241
8703,PHIL,2016-06-01 22:00:00,40,218,Wednesday,22,258
8704,PHIL,2016-06-01 23:00:00,30,84,Wednesday,23,114
8705,PHIL,2016-06-02 00:00:00,10,57,Thursday,0,67
8706,PHIL,2016-06-02 01:00:00,1,12,Thursday,1,13
8707,PHIL,2016-06-02 04:00:00,2,2,Thursday,4,4
8708,PHIL,2016-06-02 05:00:00,206,32,Thursday,5,238
8709,PHIL,2016-06-02 06:00:00,619,105,Thursday,6,724
8710,PHIL,2016-06-02 07:00:00,1600,169,Thursday,7,1769
8711,PHIL,2016-06-02 08:00:00,2374,197,Thursday,8,2571
8712,PHIL,2016-06-02 09:00:00,981,98,Thursday,9,1079
8713,PHIL,2016-06-02 10:00:00,455,63,Thursday,10,518
8714,PHIL,2016-06-02 11:00:00,274,69,Thursday,11,343
8715,PHIL,2016-06-02 12:00:00,167,100,Thursday,12,267
8716,PHIL,2016-06-02 13:00:00,135,126,Thursday,13,261
8717,PHIL,2016-06-02 14:00:00,139,190,Thursday,14,329
8718,PHIL,2016-06-02 15:00:00,138,400,Thursday,15,538
8719,PHIL,2016-06-02 16:00:00,198,673,Thursday,16,871
8720,PHIL,2016-06-02 17:00:00,275,2229,Thursday,17,2504
8721,PHIL,2016-06-02 18:00:00,216,1516,Thursday,18,1732
8722,PHIL,2016-06-02 19:00:00,114,648,Thursday,19,762
8723,PHIL,2016-06-02 20:00:00,54,475,Thursday,20,529
8724,PHIL,2016-06-02 21:00:00,48,377,Thursday,21,425
8725,PHIL,2016-06-02 22:00:00,41,140,Thursday,22,181
8726,PHIL,2016-06-02 23:00:00,19,113,Thursday,23,132
8727,PHIL,2016-06-03 00:00:00,13,82,Friday,0,95
8728,PHIL,2016-06-03 01:00:00,2,7,Friday,1,9
8729,PHIL,2016-06-03 04:00:00,3,1,Friday,4,4
8730,PHIL,2016-06-03 05:00:00,187,30,Friday,5,217
8731,PHIL,2016-06-03 06:00:00,503,84,Friday,6,587
8732,PHIL,2016-06-03 07:00:00,1308,156,Friday,7,1464
8733,PHIL,2016-06-03 08:00:00,1858,164,Friday,8,2022
8734,PHIL,2016-06-03 09:00:00,891,106,Friday,9,997
8735,PHIL,2016-06-03 10:00:00,391,84,Friday,10,475
8736,PHIL,2016-06-03 11:00:00,218,62,Friday,11,280
8737,PHIL,2016-06-03 12:00:00,156,135,Friday,12,291
8738,PHIL,2016-06-03 13:00:00,117,178,Friday,13,295
8739,PHIL,2016-06-03 14:00:00,129,225,Friday,14,354
8740,PHIL,2016-06-03 15:00:00,141,433,Friday,15,574
8741,PHIL,2016-06-03 16:00:00,204,906,Friday,16,1110
8742,PHIL,2016-06-03 17:00:00,259,1252,Friday,17,1511
8743,PHIL,2016-06-03 18:00:00,253,1238,Friday,18,1491
8744,PHIL,2016-06-03 19:00:00,134,628,Friday,19,762
8745,PHIL,2016-06-03 20:00:00,78,263,Friday,20,341
8746,PHIL,2016-06-03 21:00:00,58,235,Friday,21,293
8747,PHIL,2016-06-03 22:00:00,52,199,Friday,22,251
8748,PHIL,2016-06-03 23:00:00,31,194,Friday,23,225
8749,PHIL,2016-06-04 00:00:00,12,88,Saturday,0,100
8750,PHIL,2016-06-04 06:00:00,35,19,Saturday,6,54
8751,PHIL,2016-06-04 07:00:00,89,20,Saturday,7,109
8752,PHIL,2016-06-04 08:00:00,132,81,Saturday,8,213
8753,PHIL,2016-06-04 09:00:00,153,65,Saturday,9,218
8754,PHIL,2016-06-04 10:00:00,184,66,Saturday,10,250
8755,PHIL,2016-06-04 11:00:00,186,72,Saturday,11,258
8756,PHIL,2016-06-04 12:00:00,184,49,Saturday,12,233
8757,PHIL,2016-06-04 13:00:00,167,106,Saturday,13,273
8758,PHIL,2016-06-04 14:00:00,115,67,Saturday,14,182
8759,PHIL,2016-06-04 15:00:00,106,168,Saturday,15,274
8760,PHIL,2016-06-04 16:00:00,139,177,Saturday,16,316
8761,PHIL,2016-06-04 17:00:00,113,166,Saturday,17,279
8762,PHIL,2016-06-04 18:00:00,125,175,Saturday,18,300
8763,PHIL,2016-06-04 19:00:00,91,165,Saturday,19,256
8764,PHIL,2016-06-04 20:00:00,47,127,Saturday,20,174
8765,PHIL,2016-06-04 21:00:00,45,138,Saturday,21,183
8766,PHIL,2016-06-04 22:00:00,46,134,Saturday,22,180
8767,PHIL,2016-06-04 23:00:00,20,110,Saturday,23,130
8768,PHIL,2016-06-05 00:00:00,15,64,Sunday,0,79
8769,PHIL,2016-06-05 01:00:00,4,16,Sunday,1,20
8770,PHIL,2016-06-05 08:00:00,59,57,Sunday,8,116
8771,PHIL,2016-06-05 09:00:00,124,47,Sunday,9,171
8772,PHIL,2016-06-05 10:00:00,150,67,Sunday,10,217
8773,PHIL,2016-06-05 11:00:00,144,54,Sunday,11,198
8774,PHIL,2016-06-05 12:00:00,155,85,Sunday,12,240
8775,PHIL,2016-06-05 13:00:00,135,68,Sunday,13,203
8776,PHIL,2016-06-05 14:00:00,111,96,Sunday,14,207
8777,PHIL,2016-06-05 15:00:00,99,97,Sunday,15,196
8778,PHIL,2016-06-05 16:00:00,92,128,Sunday,16,220
8779,PHIL,2016-06-05 17:00:00,72,149,Sunday,17,221
8780,PHIL,2016-06-05 18:00:00,67,161,Sunday,18,228
8781,PHIL,2016-06-05 19:00:00,55,120,Sunday,19,175
8782,PHIL,2016-06-05 20:00:00,73,115,Sunday,20,188
8783,PHIL,2016-06-05 21:00:00,54,134,Sunday,21,188
8784,PHIL,2016-06-05 22:00:00,32,70,Sunday,22,102
8785,PHIL,2016-06-05 23:00:00,21,50,Sunday,23,71
8786,PHIL,2016-06-06 00:00:00,7,32,Monday,0,39
8787,PHIL,2016-06-06 01:00:00,2,8,Monday,1,10
8788,PHIL,2016-06-06 04:00:00,18,2,Monday,4,20
8789,PHIL,2016-06-06 05:00:00,164,33,Monday,5,197
8790,PHIL,2016-06-06 06:00:00,590,89,Monday,6,679
8791,PHIL,2016-06-06 07:00:00,1606,182,Monday,7,1788
8792,PHIL,2016-06-06 08:00:00,2361,182,Monday,8,2543
8793,PHIL,2016-06-06 09:00:00,1061,100,Monday,9,1161
8794,PHIL,2016-06-06 10:00:00,385,66,Monday,10,451
8795,PHIL,2016-06-06 11:00:00,203,82,Monday,11,285
8796,PHIL,2016-06-06 12:00:00,156,93,Monday,12,249
8797,PHIL,2016-06-06 13:00:00,123,136,Monday,13,259
8798,PHIL,2016-06-06 14:00:00,116,196,Monday,14,312
8799,PHIL,2016-06-06 15:00:00,117,355,Monday,15,472
8800,PHIL,2016-06-06 16:00:00,164,973,Monday,16,1137
8801,PHIL,2016-06-06 17:00:00,240,1788,Monday,17,2028
8802,PHIL,2016-06-06 18:00:00,188,1716,Monday,18,1904
8803,PHIL,2016-06-06 19:00:00,114,747,Monday,19,861
8804,PHIL,2016-06-06 20:00:00,66,398,Monday,20,464
8805,PHIL,2016-06-06 21:00:00,41,228,Monday,21,269
8806,PHIL,2016-06-06 22:00:00,36,145,Monday,22,181
8807,PHIL,2016-06-06 23:00:00,20,89,Monday,23,109
8808,PHIL,2016-06-07 00:00:00,3,55,Tuesday,0,58
8809,PHIL,2016-06-07 01:00:00,1,6,Tuesday,1,7
8810,PHIL,2016-06-07 04:00:00,22,1,Tuesday,4,23
8811,PHIL,2016-06-07 05:00:00,187,31,Tuesday,5,218
8812,PHIL,2016-06-07 06:00:00,620,95,Tuesday,6,715
8813,PHIL,2016-06-07 07:00:00,1524,168,Tuesday,7,1692
8814,PHIL,2016-06-07 08:00:00,2455,198,Tuesday,8,2653
8815,PHIL,2016-06-07 09:00:00,1144,113,Tuesday,9,1257
8816,PHIL,2016-06-07 10:00:00,434,81,Tuesday,10,515
8817,PHIL,2016-06-07 11:00:00,199,83,Tuesday,11,282
8818,PHIL,2016-06-07 12:00:00,181,110,Tuesday,12,291
8819,PHIL,2016-06-07 13:00:00,115,129,Tuesday,13,244
8820,PHIL,2016-06-07 14:00:00,107,208,Tuesday,14,315
8821,PHIL,2016-06-07 15:00:00,144,391,Tuesday,15,535
8822,PHIL,2016-06-07 16:00:00,199,965,Tuesday,16,1164
8823,PHIL,2016-06-07 17:00:00,299,1803,Tuesday,17,2102
8824,PHIL,2016-06-07 18:00:00,260,1614,Tuesday,18,1874
8825,PHIL,2016-06-07 19:00:00,132,875,Tuesday,19,1007
8826,PHIL,2016-06-07 20:00:00,59,422,Tuesday,20,481
8827,PHIL,2016-06-07 21:00:00,57,176,Tuesday,21,233
8828,PHIL,2016-06-07 22:00:00,42,236,Tuesday,22,278
8829,PHIL,2016-06-07 23:00:00,30,270,Tuesday,23,300
8830,PHIL,2016-06-08 00:00:00,12,63,Wednesday,0,75
8831,PHIL,2016-06-08 01:00:00,2,16,Wednesday,1,18
8832,PHIL,2016-06-08 04:00:00,21,1,Wednesday,4,22
8833,PHIL,2016-06-08 05:00:00,187,33,Wednesday,5,220
8834,PHIL,2016-06-08 06:00:00,626,100,Wednesday,6,726
8835,PHIL,2016-06-08 07:00:00,1615,166,Wednesday,7,1781
8836,PHIL,2016-06-08 08:00:00,2292,170,Wednesday,8,2462
8837,PHIL,2016-06-08 09:00:00,1079,112,Wednesday,9,1191
8838,PHIL,2016-06-08 10:00:00,454,75,Wednesday,10,529
8839,PHIL,2016-06-08 11:00:00,218,61,Wednesday,11,279
8840,PHIL,2016-06-08 12:00:00,184,105,Wednesday,12,289
8841,PHIL,2016-06-08 13:00:00,156,150,Wednesday,13,306
8842,PHIL,2016-06-08 14:00:00,122,188,Wednesday,14,310
8843,PHIL,2016-06-08 15:00:00,144,403,Wednesday,15,547
8844,PHIL,2016-06-08 16:00:00,173,924,Wednesday,16,1097
8845,PHIL,2016-06-08 17:00:00,378,1887,Wednesday,17,2265
8846,PHIL,2016-06-08 18:00:00,250,1638,Wednesday,18,1888
8847,PHIL,2016-06-08 19:00:00,110,697,Wednesday,19,807
8848,PHIL,2016-06-08 20:00:00,56,402,Wednesday,20,458
8849,PHIL,2016-06-08 21:00:00,58,218,Wednesday,21,276
8850,PHIL,2016-06-08 22:00:00,38,263,Wednesday,22,301
8851,PHIL,2016-06-08 23:00:00,27,284,Wednesday,23,311
8852,PHIL,2016-06-09 00:00:00,11,50,Thursday,0,61
8853,PHIL,2016-06-09 04:00:00,1,2,Thursday,4,3
8854,PHIL,2016-06-09 05:00:00,223,35,Thursday,5,258
8855,PHIL,2016-06-09 06:00:00,620,97,Thursday,6,717
8856,PHIL,2016-06-09 07:00:00,1475,177,Thursday,7,1652
8857,PHIL,2016-06-09 08:00:00,2287,176,Thursday,8,2463
8858,PHIL,2016-06-09 09:00:00,1043,110,Thursday,9,1153
8859,PHIL,2016-06-09 10:00:00,520,85,Thursday,10,605
8860,PHIL,2016-06-09 11:00:00,258,87,Thursday,11,345
8861,PHIL,2016-06-09 12:00:00,210,130,Thursday,12,340
8862,PHIL,2016-06-09 13:00:00,123,177,Thursday,13,300
8863,PHIL,2016-06-09 14:00:00,132,209,Thursday,14,341
8864,PHIL,2016-06-09 15:00:00,109,425,Thursday,15,534
8865,PHIL,2016-06-09 16:00:00,184,1002,Thursday,16,1186
8866,PHIL,2016-06-09 17:00:00,290,1701,Thursday,17,1991
8867,PHIL,2016-06-09 18:00:00,225,1411,Thursday,18,1636
8868,PHIL,2016-06-09 19:00:00,96,844,Thursday,19,940
8869,PHIL,2016-06-09 20:00:00,75,399,Thursday,20,474
8870,PHIL,2016-06-09 21:00:00,55,292,Thursday,21,347
8871,PHIL,2016-06-09 22:00:00,51,243,Thursday,22,294
8872,PHIL,2016-06-09 23:00:00,21,110,Thursday,23,131
8873,PHIL,2016-06-10 00:00:00,10,61,Friday,0,71
8874,PHIL,2016-06-10 01:00:00,1,11,Friday,1,12
8875,PHIL,2016-06-10 04:00:00,1,4,Friday,4,5
8876,PHIL,2016-06-10 05:00:00,180,35,Friday,5,215
8877,PHIL,2016-06-10 06:00:00,507,97,Friday,6,604
8878,PHIL,2016-06-10 07:00:00,1286,171,Friday,7,1457
8879,PHIL,2016-06-10 08:00:00,1902,175,Friday,8,2077
8880,PHIL,2016-06-10 09:00:00,701,104,Friday,9,805
8881,PHIL,2016-06-10 10:00:00,456,84,Friday,10,540
8882,PHIL,2016-06-10 11:00:00,302,87,Friday,11,389
8883,PHIL,2016-06-10 12:00:00,194,119,Friday,12,313
8884,PHIL,2016-06-10 13:00:00,174,177,Friday,13,351
8885,PHIL,2016-06-10 14:00:00,164,264,Friday,14,428
8886,PHIL,2016-06-10 15:00:00,170,399,Friday,15,569
8887,PHIL,2016-06-10 16:00:00,251,974,Friday,16,1225
8888,PHIL,2016-06-10 17:00:00,390,1393,Friday,17,1783
8889,PHIL,2016-06-10 18:00:00,274,1121,Friday,18,1395
8890,PHIL,2016-06-10 19:00:00,166,491,Friday,19,657
8891,PHIL,2016-06-10 20:00:00,73,322,Friday,20,395
8892,PHIL,2016-06-10 21:00:00,42,209,Friday,21,251
8893,PHIL,2016-06-10 22:00:00,48,248,Friday,22,296
8894,PHIL,2016-06-10 23:00:00,21,304,Friday,23,325
8895,PHIL,2016-06-11 00:00:00,20,185,Saturday,0,205
8896,PHIL,2016-06-11 01:00:00,3,30,Saturday,1,33
8897,PHIL,2016-06-11 06:00:00,10,14,Saturday,6,24
8898,PHIL,2016-06-11 07:00:00,98,27,Saturday,7,125
8899,PHIL,2016-06-11 08:00:00,120,57,Saturday,8,177
8900,PHIL,2016-06-11 09:00:00,162,57,Saturday,9,219
8901,PHIL,2016-06-11 10:00:00,202,50,Saturday,10,252
8902,PHIL,2016-06-11 11:00:00,192,93,Saturday,11,285
8903,PHIL,2016-06-11 12:00:00,161,73,Saturday,12,234
8904,PHIL,2016-06-11 13:00:00,237,105,Saturday,13,342
8905,PHIL,2016-06-11 14:00:00,250,76,Saturday,14,326
8906,PHIL,2016-06-11 15:00:00,154,126,Saturday,15,280
8907,PHIL,2016-06-11 16:00:00,138,133,Saturday,16,271
8908,PHIL,2016-06-11 17:00:00,156,166,Saturday,17,322
8909,PHIL,2016-06-11 18:00:00,93,177,Saturday,18,270
8910,PHIL,2016-06-11 19:00:00,97,127,Saturday,19,224
8911,PHIL,2016-06-11 20:00:00,82,159,Saturday,20,241
8912,PHIL,2016-06-11 21:00:00,74,198,Saturday,21,272
8913,PHIL,2016-06-11 22:00:00,31,199,Saturday,22,230
8914,PHIL,2016-06-11 23:00:00,33,151,Saturday,23,184
8915,PHIL,2016-06-12 00:00:00,14,76,Sunday,0,90
8916,PHIL,2016-06-12 01:00:00,1,30,Sunday,1,31
8917,PHIL,2016-06-12 08:00:00,55,48,Sunday,8,103
8918,PHIL,2016-06-12 09:00:00,126,68,Sunday,9,194
8919,PHIL,2016-06-12 10:00:00,143,52,Sunday,10,195
8920,PHIL,2016-06-12 11:00:00,195,54,Sunday,11,249
8921,PHIL,2016-06-12 12:00:00,138,94,Sunday,12,232
8922,PHIL,2016-06-12 13:00:00,159,69,Sunday,13,228
8923,PHIL,2016-06-12 14:00:00,113,112,Sunday,14,225
8924,PHIL,2016-06-12 15:00:00,108,95,Sunday,15,203
8925,PHIL,2016-06-12 16:00:00,163,169,Sunday,16,332
8926,PHIL,2016-06-12 17:00:00,80,126,Sunday,17,206
8927,PHIL,2016-06-12 18:00:00,84,100,Sunday,18,184
8928,PHIL,2016-06-12 19:00:00,72,148,Sunday,19,220
8929,PHIL,2016-06-12 20:00:00,59,106,Sunday,20,165
8930,PHIL,2016-06-12 21:00:00,38,149,Sunday,21,187
8931,PHIL,2016-06-12 22:00:00,43,196,Sunday,22,239
8932,PHIL,2016-06-12 23:00:00,17,41,Sunday,23,58
8933,PHIL,2016-06-13 00:00:00,9,78,Monday,0,87
8934,PHIL,2016-06-13 04:00:00,24,1,Monday,4,25
8935,PHIL,2016-06-13 05:00:00,177,26,Monday,5,203
8936,PHIL,2016-06-13 06:00:00,598,81,Monday,6,679
8937,PHIL,2016-06-13 07:00:00,1542,139,Monday,7,1681
8938,PHIL,2016-06-13 08:00:00,2243,202,Monday,8,2445
8939,PHIL,2016-06-13 09:00:00,1083,112,Monday,9,1195
8940,PHIL,2016-06-13 10:00:00,425,77,Monday,10,502
8941,PHIL,2016-06-13 11:00:00,254,67,Monday,11,321
8942,PHIL,2016-06-13 12:00:00,172,90,Monday,12,262
8943,PHIL,2016-06-13 13:00:00,164,121,Monday,13,285
8944,PHIL,2016-06-13 14:00:00,114,215,Monday,14,329
8945,PHIL,2016-06-13 15:00:00,121,376,Monday,15,497
8946,PHIL,2016-06-13 16:00:00,207,940,Monday,16,1147
8947,PHIL,2016-06-13 17:00:00,347,1916,Monday,17,2263
8948,PHIL,2016-06-13 18:00:00,278,1594,Monday,18,1872
8949,PHIL,2016-06-13 19:00:00,143,678,Monday,19,821
8950,PHIL,2016-06-13 20:00:00,58,299,Monday,20,357
8951,PHIL,2016-06-13 21:00:00,32,291,Monday,21,323
8952,PHIL,2016-06-13 22:00:00,51,269,Monday,22,320
8953,PHIL,2016-06-13 23:00:00,26,240,Monday,23,266
8954,PHIL,2016-06-14 00:00:00,2,51,Tuesday,0,53
8955,PHIL,2016-06-14 01:00:00,5,12,Tuesday,1,17
8956,PHIL,2016-06-14 04:00:00,23,1,Tuesday,4,24
8957,PHIL,2016-06-14 05:00:00,172,33,Tuesday,5,205
8958,PHIL,2016-06-14 06:00:00,655,86,Tuesday,6,741
8959,PHIL,2016-06-14 07:00:00,1483,175,Tuesday,7,1658
8960,PHIL,2016-06-14 08:00:00,2450,196,Tuesday,8,2646
8961,PHIL,2016-06-14 09:00:00,1004,102,Tuesday,9,1106
8962,PHIL,2016-06-14 10:00:00,468,81,Tuesday,10,549
8963,PHIL,2016-06-14 11:00:00,252,71,Tuesday,11,323
8964,PHIL,2016-06-14 12:00:00,188,90,Tuesday,12,278
8965,PHIL,2016-06-14 13:00:00,129,126,Tuesday,13,255
8966,PHIL,2016-06-14 14:00:00,110,214,Tuesday,14,324
8967,PHIL,2016-06-14 15:00:00,132,372,Tuesday,15,504
8968,PHIL,2016-06-14 16:00:00,210,930,Tuesday,16,1140
8969,PHIL,2016-06-14 17:00:00,336,1765,Tuesday,17,2101
8970,PHIL,2016-06-14 18:00:00,304,1604,Tuesday,18,1908
8971,PHIL,2016-06-14 19:00:00,135,867,Tuesday,19,1002
8972,PHIL,2016-06-14 20:00:00,66,455,Tuesday,20,521
8973,PHIL,2016-06-14 21:00:00,55,184,Tuesday,21,239
8974,PHIL,2016-06-14 22:00:00,42,325,Tuesday,22,367
8975,PHIL,2016-06-14 23:00:00,28,160,Tuesday,23,188
8976,PITT,2016-06-01 01:00:00,4,59,Wednesday,1,63
8977,PITT,2016-06-01 04:00:00,12,5,Wednesday,4,17
8978,PITT,2016-06-01 05:00:00,528,15,Wednesday,5,543
8979,PITT,2016-06-01 06:00:00,1110,51,Wednesday,6,1161
8980,PITT,2016-06-01 07:00:00,1583,56,Wednesday,7,1639
8981,PITT,2016-06-01 08:00:00,1017,89,Wednesday,8,1106
8982,PITT,2016-06-01 09:00:00,529,90,Wednesday,9,619
8983,PITT,2016-06-01 10:00:00,319,106,Wednesday,10,425
8984,PITT,2016-06-01 11:00:00,186,81,Wednesday,11,267
8985,PITT,2016-06-01 12:00:00,161,137,Wednesday,12,298
8986,PITT,2016-06-01 13:00:00,134,146,Wednesday,13,280
8987,PITT,2016-06-01 14:00:00,136,185,Wednesday,14,321
8988,PITT,2016-06-01 15:00:00,142,486,Wednesday,15,628
8989,PITT,2016-06-01 16:00:00,104,849,Wednesday,16,953
8990,PITT,2016-06-01 17:00:00,93,1252,Wednesday,17,1345
8991,PITT,2016-06-01 18:00:00,82,1164,Wednesday,18,1246
8992,PITT,2016-06-01 19:00:00,62,778,Wednesday,19,840
8993,PITT,2016-06-01 20:00:00,41,358,Wednesday,20,399
8994,PITT,2016-06-01 21:00:00,66,240,Wednesday,21,306
8995,PITT,2016-06-01 22:00:00,60,176,Wednesday,22,236
8996,PITT,2016-06-01 23:00:00,28,143,Wednesday,23,171
8997,PITT,2016-06-02 00:00:00,21,96,Thursday,0,117
8998,PITT,2016-06-02 01:00:00,5,30,Thursday,1,35
8999,PITT,2016-06-02 04:00:00,16,6,Thursday,4,22
9000,PITT,2016-06-02 05:00:00,513,19,Thursday,5,532
9001,PITT,2016-06-02 06:00:00,1085,37,Thursday,6,1122
9002,PITT,2016-06-02 07:00:00,1589,63,Thursday,7,1652
9003,PITT,2016-06-02 08:00:00,962,78,Thursday,8,1040
9004,PITT,2016-06-02 09:00:00,562,47,Thursday,9,609
9005,PITT,2016-06-02 10:00:00,308,70,Thursday,10,378
9006,PITT,2016-06-02 11:00:00,235,81,Thursday,11,316
9007,PITT,2016-06-02 12:00:00,187,106,Thursday,12,293
9008,PITT,2016-06-02 13:00:00,143,163,Thursday,13,306
9009,PITT,2016-06-02 14:00:00,141,212,Thursday,14,353
9010,PITT,2016-06-02 15:00:00,126,447,Thursday,15,573
9011,PITT,2016-06-02 16:00:00,138,866,Thursday,16,1004
9012,PITT,2016-06-02 17:00:00,112,1255,Thursday,17,1367
9013,PITT,2016-06-02 18:00:00,86,1379,Thursday,18,1465
9014,PITT,2016-06-02 19:00:00,72,650,Thursday,19,722
9015,PITT,2016-06-02 20:00:00,43,273,Thursday,20,316
9016,PITT,2016-06-02 21:00:00,59,291,Thursday,21,350
9017,PITT,2016-06-02 22:00:00,62,201,Thursday,22,263
9018,PITT,2016-06-02 23:00:00,38,138,Thursday,23,176
9019,PITT,2016-06-03 00:00:00,18,79,Friday,0,97
9020,PITT,2016-06-03 01:00:00,9,66,Friday,1,75
9021,PITT,2016-06-03 04:00:00,12,3,Friday,4,15
9022,PITT,2016-06-03 05:00:00,469,24,Friday,5,493
9023,PITT,2016-06-03 06:00:00,982,44,Friday,6,1026
9024,PITT,2016-06-03 07:00:00,1430,57,Friday,7,1487
9025,PITT,2016-06-03 08:00:00,987,82,Friday,8,1069
9026,PITT,2016-06-03 09:00:00,482,68,Friday,9,550
9027,PITT,2016-06-03 10:00:00,271,63,Friday,10,334
9028,PITT,2016-06-03 11:00:00,218,101,Friday,11,319
9029,PITT,2016-06-03 12:00:00,183,138,Friday,12,321
9030,PITT,2016-06-03 13:00:00,158,199,Friday,13,357
9031,PITT,2016-06-03 14:00:00,198,239,Friday,14,437
9032,PITT,2016-06-03 15:00:00,156,501,Friday,15,657
9033,PITT,2016-06-03 16:00:00,154,788,Friday,16,942
9034,PITT,2016-06-03 17:00:00,110,809,Friday,17,919
9035,PITT,2016-06-03 18:00:00,103,1403,Friday,18,1506
9036,PITT,2016-06-03 19:00:00,102,536,Friday,19,638
9037,PITT,2016-06-03 20:00:00,83,373,Friday,20,456
9038,PITT,2016-06-03 21:00:00,75,249,Friday,21,324
9039,PITT,2016-06-03 22:00:00,62,180,Friday,22,242
9040,PITT,2016-06-03 23:00:00,39,148,Friday,23,187
9041,PITT,2016-06-04 00:00:00,18,133,Saturday,0,151
9042,PITT,2016-06-04 01:00:00,15,99,Saturday,1,114
9043,PITT,2016-06-04 06:00:00,75,1,Saturday,6,76
9044,PITT,2016-06-04 07:00:00,175,83,Saturday,7,258
9045,PITT,2016-06-04 08:00:00,213,69,Saturday,8,282
9046,PITT,2016-06-04 09:00:00,210,72,Saturday,9,282
9047,PITT,2016-06-04 10:00:00,226,88,Saturday,10,314
9048,PITT,2016-06-04 11:00:00,204,94,Saturday,11,298
9049,PITT,2016-06-04 12:00:00,198,99,Saturday,12,297
9050,PITT,2016-06-04 13:00:00,184,117,Saturday,13,301
9051,PITT,2016-06-04 14:00:00,175,169,Saturday,14,344
9052,PITT,2016-06-04 15:00:00,157,181,Saturday,15,338
9053,PITT,2016-06-04 16:00:00,125,220,Saturday,16,345
9054,PITT,2016-06-04 17:00:00,102,238,Saturday,17,340
9055,PITT,2016-06-04 18:00:00,61,270,Saturday,18,331
9056,PITT,2016-06-04 19:00:00,53,229,Saturday,19,282
9057,PITT,2016-06-04 20:00:00,57,174,Saturday,20,231
9058,PITT,2016-06-04 21:00:00,64,144,Saturday,21,208
9059,PITT,2016-06-04 22:00:00,54,172,Saturday,22,226
9060,PITT,2016-06-04 23:00:00,51,152,Saturday,23,203
9061,PITT,2016-06-05 00:00:00,29,88,Sunday,0,117
9062,PITT,2016-06-05 01:00:00,4,52,Sunday,1,56
9063,PITT,2016-06-05 08:00:00,146,49,Sunday,8,195
9064,PITT,2016-06-05 09:00:00,222,86,Sunday,9,308
9065,PITT,2016-06-05 10:00:00,178,64,Sunday,10,242
9066,PITT,2016-06-05 11:00:00,157,74,Sunday,11,231
9067,PITT,2016-06-05 12:00:00,151,82,Sunday,12,233
9068,PITT,2016-06-05 13:00:00,142,74,Sunday,13,216
9069,PITT,2016-06-05 14:00:00,138,100,Sunday,14,238
9070,PITT,2016-06-05 15:00:00,103,126,Sunday,15,229
9071,PITT,2016-06-05 16:00:00,105,121,Sunday,16,226
9072,PITT,2016-06-05 17:00:00,83,165,Sunday,17,248
9073,PITT,2016-06-05 18:00:00,66,174,Sunday,18,240
9074,PITT,2016-06-05 19:00:00,62,183,Sunday,19,245
9075,PITT,2016-06-05 20:00:00,66,189,Sunday,20,255
9076,PITT,2016-06-05 21:00:00,69,146,Sunday,21,215
9077,PITT,2016-06-05 22:00:00,63,113,Sunday,22,176
9078,PITT,2016-06-05 23:00:00,38,94,Sunday,23,132
9079,PITT,2016-06-06 00:00:00,14,92,Monday,0,106
9080,PITT,2016-06-06 01:00:00,6,30,Monday,1,36
9081,PITT,2016-06-06 04:00:00,59,1,Monday,4,60
9082,PITT,2016-06-06 05:00:00,445,17,Monday,5,462
9083,PITT,2016-06-06 06:00:00,1097,27,Monday,6,1124
9084,PITT,2016-06-06 07:00:00,1541,52,Monday,7,1593
9085,PITT,2016-06-06 08:00:00,1003,81,Monday,8,1084
9086,PITT,2016-06-06 09:00:00,561,85,Monday,9,646
9087,PITT,2016-06-06 10:00:00,287,55,Monday,10,342
9088,PITT,2016-06-06 11:00:00,212,105,Monday,11,317
9089,PITT,2016-06-06 12:00:00,151,130,Monday,12,281
9090,PITT,2016-06-06 13:00:00,169,136,Monday,13,305
9091,PITT,2016-06-06 14:00:00,164,203,Monday,14,367
9092,PITT,2016-06-06 15:00:00,98,437,Monday,15,535
9093,PITT,2016-06-06 16:00:00,115,864,Monday,16,979
9094,PITT,2016-06-06 17:00:00,113,1211,Monday,17,1324
9095,PITT,2016-06-06 18:00:00,80,1286,Monday,18,1366
9096,PITT,2016-06-06 19:00:00,57,668,Monday,19,725
9097,PITT,2016-06-06 20:00:00,49,406,Monday,20,455
9098,PITT,2016-06-06 21:00:00,43,182,Monday,21,225
9099,PITT,2016-06-06 22:00:00,63,154,Monday,22,217
9100,PITT,2016-06-06 23:00:00,32,146,Monday,23,178
9101,PITT,2016-06-07 00:00:00,8,70,Tuesday,0,78
9102,PITT,2016-06-07 01:00:00,5,49,Tuesday,1,54
9103,PITT,2016-06-07 04:00:00,52,2,Tuesday,4,54
9104,PITT,2016-06-07 05:00:00,470,19,Tuesday,5,489
9105,PITT,2016-06-07 06:00:00,1149,37,Tuesday,6,1186
9106,PITT,2016-06-07 07:00:00,1528,48,Tuesday,7,1576
9107,PITT,2016-06-07 08:00:00,1022,92,Tuesday,8,1114
9108,PITT,2016-06-07 09:00:00,543,75,Tuesday,9,618
9109,PITT,2016-06-07 10:00:00,264,62,Tuesday,10,326
9110,PITT,2016-06-07 11:00:00,223,75,Tuesday,11,298
9111,PITT,2016-06-07 12:00:00,163,130,Tuesday,12,293
9112,PITT,2016-06-07 13:00:00,163,151,Tuesday,13,314
9113,PITT,2016-06-07 14:00:00,176,237,Tuesday,14,413
9114,PITT,2016-06-07 15:00:00,144,467,Tuesday,15,611
9115,PITT,2016-06-07 16:00:00,152,913,Tuesday,16,1065
9116,PITT,2016-06-07 17:00:00,130,1174,Tuesday,17,1304
9117,PITT,2016-06-07 18:00:00,138,1356,Tuesday,18,1494
9118,PITT,2016-06-07 19:00:00,84,662,Tuesday,19,746
9119,PITT,2016-06-07 20:00:00,46,350,Tuesday,20,396
9120,PITT,2016-06-07 21:00:00,56,241,Tuesday,21,297
9121,PITT,2016-06-07 22:00:00,63,173,Tuesday,22,236
9122,PITT,2016-06-07 23:00:00,21,173,Tuesday,23,194
9123,PITT,2016-06-08 00:00:00,13,127,Wednesday,0,140
9124,PITT,2016-06-08 01:00:00,6,58,Wednesday,1,64
9125,PITT,2016-06-08 04:00:00,57,3,Wednesday,4,60
9126,PITT,2016-06-08 05:00:00,474,21,Wednesday,5,495
9127,PITT,2016-06-08 06:00:00,1103,28,Wednesday,6,1131
9128,PITT,2016-06-08 07:00:00,1588,50,Wednesday,7,1638
9129,PITT,2016-06-08 08:00:00,994,101,Wednesday,8,1095
9130,PITT,2016-06-08 09:00:00,520,69,Wednesday,9,589
9131,PITT,2016-06-08 10:00:00,274,68,Wednesday,10,342
9132,PITT,2016-06-08 11:00:00,191,78,Wednesday,11,269
9133,PITT,2016-06-08 12:00:00,174,121,Wednesday,12,295
9134,PITT,2016-06-08 13:00:00,151,160,Wednesday,13,311
9135,PITT,2016-06-08 14:00:00,148,232,Wednesday,14,380
9136,PITT,2016-06-08 15:00:00,139,465,Wednesday,15,604
9137,PITT,2016-06-08 16:00:00,157,901,Wednesday,16,1058
9138,PITT,2016-06-08 17:00:00,130,1276,Wednesday,17,1406
9139,PITT,2016-06-08 18:00:00,132,1214,Wednesday,18,1346
9140,PITT,2016-06-08 19:00:00,67,619,Wednesday,19,686
9141,PITT,2016-06-08 20:00:00,33,351,Wednesday,20,384
9142,PITT,2016-06-08 21:00:00,48,273,Wednesday,21,321
9143,PITT,2016-06-08 22:00:00,77,198,Wednesday,22,275
9144,PITT,2016-06-08 23:00:00,27,222,Wednesday,23,249
9145,PITT,2016-06-09 00:00:00,20,97,Thursday,0,117
9146,PITT,2016-06-09 01:00:00,4,47,Thursday,1,51
9147,PITT,2016-06-09 04:00:00,17,3,Thursday,4,20
9148,PITT,2016-06-09 05:00:00,547,26,Thursday,5,573
9149,PITT,2016-06-09 06:00:00,1085,41,Thursday,6,1126
9150,PITT,2016-06-09 07:00:00,1502,61,Thursday,7,1563
9151,PITT,2016-06-09 08:00:00,1025,72,Thursday,8,1097
9152,PITT,2016-06-09 09:00:00,544,62,Thursday,9,606
9153,PITT,2016-06-09 10:00:00,307,72,Thursday,10,379
9154,PITT,2016-06-09 11:00:00,212,86,Thursday,11,298
9155,PITT,2016-06-09 12:00:00,204,97,Thursday,12,301
9156,PITT,2016-06-09 13:00:00,176,152,Thursday,13,328
9157,PITT,2016-06-09 14:00:00,185,210,Thursday,14,395
9158,PITT,2016-06-09 15:00:00,138,457,Thursday,15,595
9159,PITT,2016-06-09 16:00:00,134,850,Thursday,16,984
9160,PITT,2016-06-09 17:00:00,100,1152,Thursday,17,1252
9161,PITT,2016-06-09 18:00:00,78,1428,Thursday,18,1506
9162,PITT,2016-06-09 19:00:00,63,596,Thursday,19,659
9163,PITT,2016-06-09 20:00:00,48,357,Thursday,20,405
9164,PITT,2016-06-09 21:00:00,67,253,Thursday,21,320
9165,PITT,2016-06-09 22:00:00,49,196,Thursday,22,245
9166,PITT,2016-06-09 23:00:00,24,154,Thursday,23,178
9167,PITT,2016-06-10 00:00:00,5,103,Friday,0,108
9168,PITT,2016-06-10 01:00:00,8,44,Friday,1,52
9169,PITT,2016-06-10 04:00:00,9,3,Friday,4,12
9170,PITT,2016-06-10 05:00:00,483,26,Friday,5,509
9171,PITT,2016-06-10 06:00:00,1007,45,Friday,6,1052
9172,PITT,2016-06-10 07:00:00,1352,70,Friday,7,1422
9173,PITT,2016-06-10 08:00:00,869,92,Friday,8,961
9174,PITT,2016-06-10 09:00:00,456,69,Friday,9,525
9175,PITT,2016-06-10 10:00:00,271,64,Friday,10,335
9176,PITT,2016-06-10 11:00:00,238,99,Friday,11,337
9177,PITT,2016-06-10 12:00:00,221,119,Friday,12,340
9178,PITT,2016-06-10 13:00:00,163,195,Friday,13,358
9179,PITT,2016-06-10 14:00:00,193,250,Friday,14,443
9180,PITT,2016-06-10 15:00:00,179,462,Friday,15,641
9181,PITT,2016-06-10 16:00:00,175,797,Friday,16,972
9182,PITT,2016-06-10 17:00:00,162,1136,Friday,17,1298
9183,PITT,2016-06-10 18:00:00,163,1052,Friday,18,1215
9184,PITT,2016-06-10 19:00:00,86,555,Friday,19,641
9185,PITT,2016-06-10 20:00:00,70,272,Friday,20,342
9186,PITT,2016-06-10 21:00:00,73,236,Friday,21,309
9187,PITT,2016-06-10 22:00:00,99,267,Friday,22,366
9188,PITT,2016-06-10 23:00:00,27,205,Friday,23,232
9189,PITT,2016-06-11 00:00:00,10,221,Saturday,0,231
9190,PITT,2016-06-11 01:00:00,2,55,Saturday,1,57
9191,PITT,2016-06-11 06:00:00,31,23,Saturday,6,54
9192,PITT,2016-06-11 07:00:00,194,48,Saturday,7,242
9193,PITT,2016-06-11 08:00:00,220,76,Saturday,8,296
9194,PITT,2016-06-11 09:00:00,214,72,Saturday,9,286
9195,PITT,2016-06-11 10:00:00,209,82,Saturday,10,291
9196,PITT,2016-06-11 11:00:00,183,84,Saturday,11,267
9197,PITT,2016-06-11 12:00:00,206,95,Saturday,12,301
9198,PITT,2016-06-11 13:00:00,193,115,Saturday,13,308
9199,PITT,2016-06-11 14:00:00,223,131,Saturday,14,354
9200,PITT,2016-06-11 15:00:00,159,120,Saturday,15,279
9201,PITT,2016-06-11 16:00:00,125,268,Saturday,16,393
9202,PITT,2016-06-11 17:00:00,93,229,Saturday,17,322
9203,PITT,2016-06-11 18:00:00,82,175,Saturday,18,257
9204,PITT,2016-06-11 19:00:00,84,297,Saturday,19,381
9205,PITT,2016-06-11 20:00:00,67,193,Saturday,20,260
9206,PITT,2016-06-11 21:00:00,68,143,Saturday,21,211
9207,PITT,2016-06-11 22:00:00,76,231,Saturday,22,307
9208,PITT,2016-06-11 23:00:00,39,196,Saturday,23,235
9209,PITT,2016-06-12 00:00:00,21,107,Sunday,0,128
9210,PITT,2016-06-12 01:00:00,5,71,Sunday,1,76
9211,PITT,2016-06-12 08:00:00,149,1,Sunday,8,150
9212,PITT,2016-06-12 09:00:00,165,140,Sunday,9,305
9213,PITT,2016-06-12 10:00:00,156,55,Sunday,10,211
9214,PITT,2016-06-12 11:00:00,166,78,Sunday,11,244
9215,PITT,2016-06-12 12:00:00,187,89,Sunday,12,276
9216,PITT,2016-06-12 13:00:00,162,91,Sunday,13,253
9217,PITT,2016-06-12 14:00:00,175,108,Sunday,14,283
9218,PITT,2016-06-12 15:00:00,123,72,Sunday,15,195
9219,PITT,2016-06-12 16:00:00,130,195,Sunday,16,325
9220,PITT,2016-06-12 17:00:00,119,170,Sunday,17,289
9221,PITT,2016-06-12 18:00:00,124,216,Sunday,18,340
9222,PITT,2016-06-12 19:00:00,108,175,Sunday,19,283
9223,PITT,2016-06-12 20:00:00,91,183,Sunday,20,274
9224,PITT,2016-06-12 21:00:00,66,160,Sunday,21,226
9225,PITT,2016-06-12 22:00:00,77,236,Sunday,22,313
9226,PITT,2016-06-12 23:00:00,34,111,Sunday,23,145
9227,PITT,2016-06-13 00:00:00,8,110,Monday,0,118
9228,PITT,2016-06-13 01:00:00,3,57,Monday,1,60
9229,PITT,2016-06-13 04:00:00,65,1,Monday,4,66
9230,PITT,2016-06-13 05:00:00,438,21,Monday,5,459
9231,PITT,2016-06-13 06:00:00,1020,38,Monday,6,1058
9232,PITT,2016-06-13 07:00:00,1510,55,Monday,7,1565
9233,PITT,2016-06-13 08:00:00,1031,79,Monday,8,1110
9234,PITT,2016-06-13 09:00:00,564,83,Monday,9,647
9235,PITT,2016-06-13 10:00:00,267,81,Monday,10,348
9236,PITT,2016-06-13 11:00:00,226,86,Monday,11,312
9237,PITT,2016-06-13 12:00:00,173,115,Monday,12,288
9238,PITT,2016-06-13 13:00:00,166,144,Monday,13,310
9239,PITT,2016-06-13 14:00:00,181,206,Monday,14,387
9240,PITT,2016-06-13 15:00:00,155,435,Monday,15,590
9241,PITT,2016-06-13 16:00:00,160,877,Monday,16,1037
9242,PITT,2016-06-13 17:00:00,164,1300,Monday,17,1464
9243,PITT,2016-06-13 18:00:00,122,1290,Monday,18,1412
9244,PITT,2016-06-13 19:00:00,76,503,Monday,19,579
9245,PITT,2016-06-13 20:00:00,56,286,Monday,20,342
9246,PITT,2016-06-13 21:00:00,45,160,Monday,21,205
9247,PITT,2016-06-13 22:00:00,68,288,Monday,22,356
9248,PITT,2016-06-13 23:00:00,33,294,Monday,23,327
9249,PITT,2016-06-14 00:00:00,7,142,Tuesday,0,149
9250,PITT,2016-06-14 01:00:00,9,23,Tuesday,1,32
9251,PITT,2016-06-14 04:00:00,53,1,Tuesday,4,54
9252,PITT,2016-06-14 05:00:00,443,28,Tuesday,5,471
9253,PITT,2016-06-14 06:00:00,1155,39,Tuesday,6,1194
9254,PITT,2016-06-14 07:00:00,1464,63,Tuesday,7,1527
9255,PITT,2016-06-14 08:00:00,1027,83,Tuesday,8,1110
9256,PITT,2016-06-14 09:00:00,619,71,Tuesday,9,690
9257,PITT,2016-06-14 10:00:00,269,65,Tuesday,10,334
9258,PITT,2016-06-14 11:00:00,208,85,Tuesday,11,293
9259,PITT,2016-06-14 12:00:00,192,129,Tuesday,12,321
9260,PITT,2016-06-14 13:00:00,161,121,Tuesday,13,282
9261,PITT,2016-06-14 14:00:00,153,189,Tuesday,14,342
9262,PITT,2016-06-14 15:00:00,137,452,Tuesday,15,589
9263,PITT,2016-06-14 16:00:00,165,860,Tuesday,16,1025
9264,PITT,2016-06-14 17:00:00,149,1287,Tuesday,17,1436
9265,PITT,2016-06-14 18:00:00,137,1284,Tuesday,18,1421
9266,PITT,2016-06-14 19:00:00,94,680,Tuesday,19,774
9267,PITT,2016-06-14 20:00:00,66,373,Tuesday,20,439
9268,PITT,2016-06-14 21:00:00,57,257,Tuesday,21,314
9269,PITT,2016-06-14 22:00:00,76,178,Tuesday,22,254
9270,PITT,2016-06-14 23:00:00,23,185,Tuesday,23,208
9271,PLZA,2016-06-01 01:00:00,2,9,Wednesday,1,11
9272,PLZA,2016-06-01 04:00:00,9,1,Wednesday,4,10
9273,PLZA,2016-06-01 05:00:00,84,17,Wednesday,5,101
9274,PLZA,2016-06-01 06:00:00,273,34,Wednesday,6,307
9275,PLZA,2016-06-01 07:00:00,686,113,Wednesday,7,799
9276,PLZA,2016-06-01 08:00:00,1054,105,Wednesday,8,1159
9277,PLZA,2016-06-01 09:00:00,756,89,Wednesday,9,845
9278,PLZA,2016-06-01 10:00:00,404,85,Wednesday,10,489
9279,PLZA,2016-06-01 11:00:00,203,103,Wednesday,11,306
9280,PLZA,2016-06-01 12:00:00,224,116,Wednesday,12,340
9281,PLZA,2016-06-01 13:00:00,148,150,Wednesday,13,298
9282,PLZA,2016-06-01 14:00:00,153,229,Wednesday,14,382
9283,PLZA,2016-06-01 15:00:00,180,347,Wednesday,15,527
9284,PLZA,2016-06-01 16:00:00,186,600,Wednesday,16,786
9285,PLZA,2016-06-01 17:00:00,203,953,Wednesday,17,1156
9286,PLZA,2016-06-01 18:00:00,178,911,Wednesday,18,1089
9287,PLZA,2016-06-01 19:00:00,102,484,Wednesday,19,586
9288,PLZA,2016-06-01 20:00:00,53,242,Wednesday,20,295
9289,PLZA,2016-06-01 21:00:00,64,236,Wednesday,21,300
9290,PLZA,2016-06-01 22:00:00,52,168,Wednesday,22,220
9291,PLZA,2016-06-01 23:00:00,26,89,Wednesday,23,115
9292,PLZA,2016-06-02 00:00:00,9,58,Thursday,0,67
9293,PLZA,2016-06-02 04:00:00,10,1,Thursday,4,11
9294,PLZA,2016-06-02 05:00:00,76,16,Thursday,5,92
9295,PLZA,2016-06-02 06:00:00,284,35,Thursday,6,319
9296,PLZA,2016-06-02 07:00:00,680,99,Thursday,7,779
9297,PLZA,2016-06-02 08:00:00,1010,91,Thursday,8,1101
9298,PLZA,2016-06-02 09:00:00,790,107,Thursday,9,897
9299,PLZA,2016-06-02 10:00:00,376,115,Thursday,10,491
9300,PLZA,2016-06-02 11:00:00,228,90,Thursday,11,318
9301,PLZA,2016-06-02 12:00:00,211,107,Thursday,12,318
9302,PLZA,2016-06-02 13:00:00,196,160,Thursday,13,356
9303,PLZA,2016-06-02 14:00:00,163,248,Thursday,14,411
9304,PLZA,2016-06-02 15:00:00,172,365,Thursday,15,537
9305,PLZA,2016-06-02 16:00:00,207,507,Thursday,16,714
9306,PLZA,2016-06-02 17:00:00,224,1080,Thursday,17,1304
9307,PLZA,2016-06-02 18:00:00,198,878,Thursday,18,1076
9308,PLZA,2016-06-02 19:00:00,110,430,Thursday,19,540
9309,PLZA,2016-06-02 20:00:00,52,287,Thursday,20,339
9310,PLZA,2016-06-02 21:00:00,84,268,Thursday,21,352
9311,PLZA,2016-06-02 22:00:00,59,183,Thursday,22,242
9312,PLZA,2016-06-02 23:00:00,28,80,Thursday,23,108
9313,PLZA,2016-06-03 00:00:00,8,42,Friday,0,50
9314,PLZA,2016-06-03 01:00:00,3,13,Friday,1,16
9315,PLZA,2016-06-03 04:00:00,8,1,Friday,4,9
9316,PLZA,2016-06-03 05:00:00,73,8,Friday,5,81
9317,PLZA,2016-06-03 06:00:00,237,35,Friday,6,272
9318,PLZA,2016-06-03 07:00:00,623,94,Friday,7,717
9319,PLZA,2016-06-03 08:00:00,973,113,Friday,8,1086
9320,PLZA,2016-06-03 09:00:00,648,118,Friday,9,766
9321,PLZA,2016-06-03 10:00:00,356,107,Friday,10,463
9322,PLZA,2016-06-03 11:00:00,244,114,Friday,11,358
9323,PLZA,2016-06-03 12:00:00,200,139,Friday,12,339
9324,PLZA,2016-06-03 13:00:00,196,174,Friday,13,370
9325,PLZA,2016-06-03 14:00:00,169,241,Friday,14,410
9326,PLZA,2016-06-03 15:00:00,199,369,Friday,15,568
9327,PLZA,2016-06-03 16:00:00,241,566,Friday,16,807
9328,PLZA,2016-06-03 17:00:00,216,898,Friday,17,1114
9329,PLZA,2016-06-03 18:00:00,241,698,Friday,18,939
9330,PLZA,2016-06-03 19:00:00,195,410,Friday,19,605
9331,PLZA,2016-06-03 20:00:00,92,241,Friday,20,333
9332,PLZA,2016-06-03 21:00:00,72,247,Friday,21,319
9333,PLZA,2016-06-03 22:00:00,45,203,Friday,22,248
9334,PLZA,2016-06-03 23:00:00,36,187,Friday,23,223
9335,PLZA,2016-06-04 00:00:00,17,58,Saturday,0,75
9336,PLZA,2016-06-04 01:00:00,3,19,Saturday,1,22
9337,PLZA,2016-06-04 06:00:00,35,10,Saturday,6,45
9338,PLZA,2016-06-04 07:00:00,84,24,Saturday,7,108
9339,PLZA,2016-06-04 08:00:00,145,55,Saturday,8,200
9340,PLZA,2016-06-04 09:00:00,209,71,Saturday,9,280
9341,PLZA,2016-06-04 10:00:00,202,73,Saturday,10,275
9342,PLZA,2016-06-04 11:00:00,243,95,Saturday,11,338
9343,PLZA,2016-06-04 12:00:00,183,120,Saturday,12,303
9344,PLZA,2016-06-04 13:00:00,214,146,Saturday,13,360
9345,PLZA,2016-06-04 14:00:00,184,193,Saturday,14,377
9346,PLZA,2016-06-04 15:00:00,189,195,Saturday,15,384
9347,PLZA,2016-06-04 16:00:00,169,232,Saturday,16,401
9348,PLZA,2016-06-04 17:00:00,142,229,Saturday,17,371
9349,PLZA,2016-06-04 18:00:00,112,227,Saturday,18,339
9350,PLZA,2016-06-04 19:00:00,122,160,Saturday,19,282
9351,PLZA,2016-06-04 20:00:00,74,133,Saturday,20,207
9352,PLZA,2016-06-04 21:00:00,48,121,Saturday,21,169
9353,PLZA,2016-06-04 22:00:00,53,152,Saturday,22,205
9354,PLZA,2016-06-04 23:00:00,24,115,Saturday,23,139
9355,PLZA,2016-06-05 00:00:00,13,51,Sunday,0,64
9356,PLZA,2016-06-05 01:00:00,2,15,Sunday,1,17
9357,PLZA,2016-06-05 08:00:00,67,34,Sunday,8,101
9358,PLZA,2016-06-05 09:00:00,156,59,Sunday,9,215
9359,PLZA,2016-06-05 10:00:00,150,64,Sunday,10,214
9360,PLZA,2016-06-05 11:00:00,179,78,Sunday,11,257
9361,PLZA,2016-06-05 12:00:00,160,86,Sunday,12,246
9362,PLZA,2016-06-05 13:00:00,197,124,Sunday,13,321
9363,PLZA,2016-06-05 14:00:00,182,108,Sunday,14,290
9364,PLZA,2016-06-05 15:00:00,117,165,Sunday,15,282
9365,PLZA,2016-06-05 16:00:00,110,213,Sunday,16,323
9366,PLZA,2016-06-05 17:00:00,108,211,Sunday,17,319
9367,PLZA,2016-06-05 18:00:00,86,168,Sunday,18,254
9368,PLZA,2016-06-05 19:00:00,61,122,Sunday,19,183
9369,PLZA,2016-06-05 20:00:00,54,102,Sunday,20,156
9370,PLZA,2016-06-05 21:00:00,48,159,Sunday,21,207
9371,PLZA,2016-06-05 22:00:00,42,68,Sunday,22,110
9372,PLZA,2016-06-05 23:00:00,19,67,Sunday,23,86
9373,PLZA,2016-06-06 00:00:00,8,23,Monday,0,31
9374,PLZA,2016-06-06 01:00:00,4,6,Monday,1,10
9375,PLZA,2016-06-06 04:00:00,7,1,Monday,4,8
9376,PLZA,2016-06-06 05:00:00,76,9,Monday,5,85
9377,PLZA,2016-06-06 06:00:00,241,38,Monday,6,279
9378,PLZA,2016-06-06 07:00:00,637,108,Monday,7,745
9379,PLZA,2016-06-06 08:00:00,1019,116,Monday,8,1135
9380,PLZA,2016-06-06 09:00:00,765,80,Monday,9,845
9381,PLZA,2016-06-06 10:00:00,331,79,Monday,10,410
9382,PLZA,2016-06-06 11:00:00,200,97,Monday,11,297
9383,PLZA,2016-06-06 12:00:00,201,117,Monday,12,318
9384,PLZA,2016-06-06 13:00:00,169,147,Monday,13,316
9385,PLZA,2016-06-06 14:00:00,178,246,Monday,14,424
9386,PLZA,2016-06-06 15:00:00,174,296,Monday,15,470
9387,PLZA,2016-06-06 16:00:00,176,543,Monday,16,719
9388,PLZA,2016-06-06 17:00:00,205,913,Monday,17,1118
9389,PLZA,2016-06-06 18:00:00,129,864,Monday,18,993
9390,PLZA,2016-06-06 19:00:00,91,481,Monday,19,572
9391,PLZA,2016-06-06 20:00:00,51,245,Monday,20,296
9392,PLZA,2016-06-06 21:00:00,56,184,Monday,21,240
9393,PLZA,2016-06-06 22:00:00,33,153,Monday,22,186
9394,PLZA,2016-06-06 23:00:00,18,79,Monday,23,97
9395,PLZA,2016-06-07 00:00:00,8,32,Tuesday,0,40
9396,PLZA,2016-06-07 01:00:00,3,8,Tuesday,1,11
9397,PLZA,2016-06-07 04:00:00,6,1,Tuesday,4,7
9398,PLZA,2016-06-07 05:00:00,79,14,Tuesday,5,93
9399,PLZA,2016-06-07 06:00:00,237,27,Tuesday,6,264
9400,PLZA,2016-06-07 07:00:00,643,101,Tuesday,7,744
9401,PLZA,2016-06-07 08:00:00,1017,110,Tuesday,8,1127
9402,PLZA,2016-06-07 09:00:00,803,94,Tuesday,9,897
9403,PLZA,2016-06-07 10:00:00,434,90,Tuesday,10,524
9404,PLZA,2016-06-07 11:00:00,238,100,Tuesday,11,338
9405,PLZA,2016-06-07 12:00:00,193,111,Tuesday,12,304
9406,PLZA,2016-06-07 13:00:00,147,161,Tuesday,13,308
9407,PLZA,2016-06-07 14:00:00,171,215,Tuesday,14,386
9408,PLZA,2016-06-07 15:00:00,126,291,Tuesday,15,417
9409,PLZA,2016-06-07 16:00:00,151,554,Tuesday,16,705
9410,PLZA,2016-06-07 17:00:00,183,998,Tuesday,17,1181
9411,PLZA,2016-06-07 18:00:00,176,833,Tuesday,18,1009
9412,PLZA,2016-06-07 19:00:00,94,451,Tuesday,19,545
9413,PLZA,2016-06-07 20:00:00,64,251,Tuesday,20,315
9414,PLZA,2016-06-07 21:00:00,59,228,Tuesday,21,287
9415,PLZA,2016-06-07 22:00:00,47,179,Tuesday,22,226
9416,PLZA,2016-06-07 23:00:00,24,91,Tuesday,23,115
9417,PLZA,2016-06-08 00:00:00,13,68,Wednesday,0,81
9418,PLZA,2016-06-08 01:00:00,5,6,Wednesday,1,11
9419,PLZA,2016-06-08 05:00:00,78,12,Wednesday,5,90
9420,PLZA,2016-06-08 06:00:00,279,30,Wednesday,6,309
9421,PLZA,2016-06-08 07:00:00,665,89,Wednesday,7,754
9422,PLZA,2016-06-08 08:00:00,981,97,Wednesday,8,1078
9423,PLZA,2016-06-08 09:00:00,749,78,Wednesday,9,827
9424,PLZA,2016-06-08 10:00:00,398,88,Wednesday,10,486
9425,PLZA,2016-06-08 11:00:00,282,107,Wednesday,11,389
9426,PLZA,2016-06-08 12:00:00,269,138,Wednesday,12,407
9427,PLZA,2016-06-08 13:00:00,223,157,Wednesday,13,380
9428,PLZA,2016-06-08 14:00:00,182,216,Wednesday,14,398
9429,PLZA,2016-06-08 15:00:00,164,324,Wednesday,15,488
9430,PLZA,2016-06-08 16:00:00,159,597,Wednesday,16,756
9431,PLZA,2016-06-08 17:00:00,240,981,Wednesday,17,1221
9432,PLZA,2016-06-08 18:00:00,204,854,Wednesday,18,1058
9433,PLZA,2016-06-08 19:00:00,86,456,Wednesday,19,542
9434,PLZA,2016-06-08 20:00:00,65,266,Wednesday,20,331
9435,PLZA,2016-06-08 21:00:00,60,303,Wednesday,21,363
9436,PLZA,2016-06-08 22:00:00,57,183,Wednesday,22,240
9437,PLZA,2016-06-08 23:00:00,24,130,Wednesday,23,154
9438,PLZA,2016-06-09 00:00:00,10,58,Thursday,0,68
9439,PLZA,2016-06-09 01:00:00,2,1,Thursday,1,3
9440,PLZA,2016-06-09 04:00:00,11,3,Thursday,4,14
9441,PLZA,2016-06-09 05:00:00,76,14,Thursday,5,90
9442,PLZA,2016-06-09 06:00:00,260,22,Thursday,6,282
9443,PLZA,2016-06-09 07:00:00,599,88,Thursday,7,687
9444,PLZA,2016-06-09 08:00:00,1004,86,Thursday,8,1090
9445,PLZA,2016-06-09 09:00:00,738,108,Thursday,9,846
9446,PLZA,2016-06-09 10:00:00,424,85,Thursday,10,509
9447,PLZA,2016-06-09 11:00:00,284,101,Thursday,11,385
9448,PLZA,2016-06-09 12:00:00,252,124,Thursday,12,376
9449,PLZA,2016-06-09 13:00:00,203,190,Thursday,13,393
9450,PLZA,2016-06-09 14:00:00,178,200,Thursday,14,378
9451,PLZA,2016-06-09 15:00:00,161,366,Thursday,15,527
9452,PLZA,2016-06-09 16:00:00,170,597,Thursday,16,767
9453,PLZA,2016-06-09 17:00:00,179,919,Thursday,17,1098
9454,PLZA,2016-06-09 18:00:00,180,818,Thursday,18,998
9455,PLZA,2016-06-09 19:00:00,98,472,Thursday,19,570
9456,PLZA,2016-06-09 20:00:00,81,293,Thursday,20,374
9457,PLZA,2016-06-09 21:00:00,78,229,Thursday,21,307
9458,PLZA,2016-06-09 22:00:00,53,154,Thursday,22,207
9459,PLZA,2016-06-09 23:00:00,25,164,Thursday,23,189
9460,PLZA,2016-06-10 00:00:00,6,44,Friday,0,50
9461,PLZA,2016-06-10 04:00:00,7,1,Friday,4,8
9462,PLZA,2016-06-10 05:00:00,66,10,Friday,5,76
9463,PLZA,2016-06-10 06:00:00,233,35,Friday,6,268
9464,PLZA,2016-06-10 07:00:00,547,72,Friday,7,619
9465,PLZA,2016-06-10 08:00:00,899,97,Friday,8,996
9466,PLZA,2016-06-10 09:00:00,608,83,Friday,9,691
9467,PLZA,2016-06-10 10:00:00,385,89,Friday,10,474
9468,PLZA,2016-06-10 11:00:00,233,101,Friday,11,334
9469,PLZA,2016-06-10 12:00:00,229,162,Friday,12,391
9470,PLZA,2016-06-10 13:00:00,198,163,Friday,13,361
9471,PLZA,2016-06-10 14:00:00,173,236,Friday,14,409
9472,PLZA,2016-06-10 15:00:00,176,341,Friday,15,517
9473,PLZA,2016-06-10 16:00:00,199,564,Friday,16,763
9474,PLZA,2016-06-10 17:00:00,223,753,Friday,17,976
9475,PLZA,2016-06-10 18:00:00,240,756,Friday,18,996
9476,PLZA,2016-06-10 19:00:00,125,340,Friday,19,465
9477,PLZA,2016-06-10 20:00:00,92,223,Friday,20,315
9478,PLZA,2016-06-10 21:00:00,68,226,Friday,21,294
9479,PLZA,2016-06-10 22:00:00,51,223,Friday,22,274
9480,PLZA,2016-06-10 23:00:00,50,181,Friday,23,231
9481,PLZA,2016-06-11 00:00:00,28,90,Saturday,0,118
9482,PLZA,2016-06-11 01:00:00,5,3,Saturday,1,8
9483,PLZA,2016-06-11 06:00:00,27,17,Saturday,6,44
9484,PLZA,2016-06-11 07:00:00,92,20,Saturday,7,112
9485,PLZA,2016-06-11 08:00:00,128,60,Saturday,8,188
9486,PLZA,2016-06-11 09:00:00,180,65,Saturday,9,245
9487,PLZA,2016-06-11 10:00:00,182,86,Saturday,10,268
9488,PLZA,2016-06-11 11:00:00,203,74,Saturday,11,277
9489,PLZA,2016-06-11 12:00:00,185,107,Saturday,12,292
9490,PLZA,2016-06-11 13:00:00,214,120,Saturday,13,334
9491,PLZA,2016-06-11 14:00:00,186,142,Saturday,14,328
9492,PLZA,2016-06-11 15:00:00,186,168,Saturday,15,354
9493,PLZA,2016-06-11 16:00:00,157,146,Saturday,16,303
9494,PLZA,2016-06-11 17:00:00,146,231,Saturday,17,377
9495,PLZA,2016-06-11 18:00:00,154,202,Saturday,18,356
9496,PLZA,2016-06-11 19:00:00,141,158,Saturday,19,299
9497,PLZA,2016-06-11 20:00:00,65,129,Saturday,20,194
9498,PLZA,2016-06-11 21:00:00,68,127,Saturday,21,195
9499,PLZA,2016-06-11 22:00:00,37,217,Saturday,22,254
9500,PLZA,2016-06-11 23:00:00,23,110,Saturday,23,133
9501,PLZA,2016-06-12 00:00:00,25,70,Sunday,0,95
9502,PLZA,2016-06-12 01:00:00,2,11,Sunday,1,13
9503,PLZA,2016-06-12 08:00:00,67,43,Sunday,8,110
9504,PLZA,2016-06-12 09:00:00,122,66,Sunday,9,188
9505,PLZA,2016-06-12 10:00:00,126,61,Sunday,10,187
9506,PLZA,2016-06-12 11:00:00,167,73,Sunday,11,240
9507,PLZA,2016-06-12 12:00:00,175,71,Sunday,12,246
9508,PLZA,2016-06-12 13:00:00,133,99,Sunday,13,232
9509,PLZA,2016-06-12 14:00:00,140,118,Sunday,14,258
9510,PLZA,2016-06-12 15:00:00,156,116,Sunday,15,272
9511,PLZA,2016-06-12 16:00:00,133,115,Sunday,16,248
9512,PLZA,2016-06-12 17:00:00,97,178,Sunday,17,275
9513,PLZA,2016-06-12 18:00:00,108,121,Sunday,18,229
9514,PLZA,2016-06-12 19:00:00,95,204,Sunday,19,299
9515,PLZA,2016-06-12 20:00:00,58,121,Sunday,20,179
9516,PLZA,2016-06-12 21:00:00,60,152,Sunday,21,212
9517,PLZA,2016-06-12 22:00:00,43,125,Sunday,22,168
9518,PLZA,2016-06-12 23:00:00,20,62,Sunday,23,82
9519,PLZA,2016-06-13 00:00:00,11,31,Monday,0,42
9520,PLZA,2016-06-13 01:00:00,2,5,Monday,1,7
9521,PLZA,2016-06-13 04:00:00,14,3,Monday,4,17
9522,PLZA,2016-06-13 05:00:00,75,10,Monday,5,85
9523,PLZA,2016-06-13 06:00:00,246,33,Monday,6,279
9524,PLZA,2016-06-13 07:00:00,641,80,Monday,7,721
9525,PLZA,2016-06-13 08:00:00,1016,97,Monday,8,1113
9526,PLZA,2016-06-13 09:00:00,723,83,Monday,9,806
9527,PLZA,2016-06-13 10:00:00,413,94,Monday,10,507
9528,PLZA,2016-06-13 11:00:00,204,85,Monday,11,289
9529,PLZA,2016-06-13 12:00:00,206,122,Monday,12,328
9530,PLZA,2016-06-13 13:00:00,170,139,Monday,13,309
9531,PLZA,2016-06-13 14:00:00,146,174,Monday,14,320
9532,PLZA,2016-06-13 15:00:00,153,309,Monday,15,462
9533,PLZA,2016-06-13 16:00:00,175,588,Monday,16,763
9534,PLZA,2016-06-13 17:00:00,221,1066,Monday,17,1287
9535,PLZA,2016-06-13 18:00:00,204,823,Monday,18,1027
9536,PLZA,2016-06-13 19:00:00,102,441,Monday,19,543
9537,PLZA,2016-06-13 20:00:00,46,201,Monday,20,247
9538,PLZA,2016-06-13 21:00:00,59,272,Monday,21,331
9539,PLZA,2016-06-13 22:00:00,40,182,Monday,22,222
9540,PLZA,2016-06-13 23:00:00,34,147,Monday,23,181
9541,PLZA,2016-06-14 00:00:00,11,38,Tuesday,0,49
9542,PLZA,2016-06-14 01:00:00,2,11,Tuesday,1,13
9543,PLZA,2016-06-14 04:00:00,6,1,Tuesday,4,7
9544,PLZA,2016-06-14 05:00:00,73,12,Tuesday,5,85
9545,PLZA,2016-06-14 06:00:00,276,28,Tuesday,6,304
9546,PLZA,2016-06-14 07:00:00,657,67,Tuesday,7,724
9547,PLZA,2016-06-14 08:00:00,1028,81,Tuesday,8,1109
9548,PLZA,2016-06-14 09:00:00,778,83,Tuesday,9,861
9549,PLZA,2016-06-14 10:00:00,366,92,Tuesday,10,458
9550,PLZA,2016-06-14 11:00:00,253,98,Tuesday,11,351
9551,PLZA,2016-06-14 12:00:00,186,131,Tuesday,12,317
9552,PLZA,2016-06-14 13:00:00,194,165,Tuesday,13,359
9553,PLZA,2016-06-14 14:00:00,139,215,Tuesday,14,354
9554,PLZA,2016-06-14 15:00:00,139,308,Tuesday,15,447
9555,PLZA,2016-06-14 16:00:00,195,603,Tuesday,16,798
9556,PLZA,2016-06-14 17:00:00,189,874,Tuesday,17,1063
9557,PLZA,2016-06-14 18:00:00,183,926,Tuesday,18,1109
9558,PLZA,2016-06-14 19:00:00,80,488,Tuesday,19,568
9559,PLZA,2016-06-14 20:00:00,69,267,Tuesday,20,336
9560,PLZA,2016-06-14 21:00:00,64,217,Tuesday,21,281
9561,PLZA,2016-06-14 22:00:00,46,164,Tuesday,22,210
9562,PLZA,2016-06-14 23:00:00,22,194,Tuesday,23,216
9563,POWL,2016-06-01 01:00:00,46,3,Wednesday,1,49
9564,POWL,2016-06-01 04:00:00,15,80,Wednesday,4,95
9565,POWL,2016-06-01 05:00:00,95,653,Wednesday,5,748
9566,POWL,2016-06-01 06:00:00,198,1444,Wednesday,6,1642
9567,POWL,2016-06-01 07:00:00,436,2631,Wednesday,7,3067
9568,POWL,2016-06-01 08:00:00,660,4168,Wednesday,8,4828
9569,POWL,2016-06-01 09:00:00,609,3406,Wednesday,9,4015
9570,POWL,2016-06-01 10:00:00,543,2049,Wednesday,10,2592
9571,POWL,2016-06-01 11:00:00,726,1661,Wednesday,11,2387
9572,POWL,2016-06-01 12:00:00,912,1625,Wednesday,12,2537
9573,POWL,2016-06-01 13:00:00,1173,1431,Wednesday,13,2604
9574,POWL,2016-06-01 14:00:00,1455,1304,Wednesday,14,2759
9575,POWL,2016-06-01 15:00:00,2091,1304,Wednesday,15,3395
9576,POWL,2016-06-01 16:00:00,3123,1288,Wednesday,16,4411
9577,POWL,2016-06-01 17:00:00,4549,1563,Wednesday,17,6112
9578,POWL,2016-06-01 18:00:00,5248,1334,Wednesday,18,6582
9579,POWL,2016-06-01 19:00:00,3382,805,Wednesday,19,4187
9580,POWL,2016-06-01 20:00:00,2140,465,Wednesday,20,2605
9581,POWL,2016-06-01 21:00:00,1921,443,Wednesday,21,2364
9582,POWL,2016-06-01 22:00:00,1456,328,Wednesday,22,1784
9583,POWL,2016-06-01 23:00:00,873,181,Wednesday,23,1054
9584,POWL,2016-06-02 00:00:00,460,86,Thursday,0,546
9585,POWL,2016-06-02 01:00:00,53,4,Thursday,1,57
9586,POWL,2016-06-02 04:00:00,20,88,Thursday,4,108
9587,POWL,2016-06-02 05:00:00,81,604,Thursday,5,685
9588,POWL,2016-06-02 06:00:00,220,1387,Thursday,6,1607
9589,POWL,2016-06-02 07:00:00,421,2726,Thursday,7,3147
9590,POWL,2016-06-02 08:00:00,659,3672,Thursday,8,4331
9591,POWL,2016-06-02 09:00:00,589,3605,Thursday,9,4194
9592,POWL,2016-06-02 10:00:00,579,2105,Thursday,10,2684
9593,POWL,2016-06-02 11:00:00,744,1736,Thursday,11,2480
9594,POWL,2016-06-02 12:00:00,859,1565,Thursday,12,2424
9595,POWL,2016-06-02 13:00:00,1087,1357,Thursday,13,2444
9596,POWL,2016-06-02 14:00:00,1417,1495,Thursday,14,2912
9597,POWL,2016-06-02 15:00:00,2038,1299,Thursday,15,3337
9598,POWL,2016-06-02 16:00:00,3000,1333,Thursday,16,4333
9599,POWL,2016-06-02 17:00:00,5377,1544,Thursday,17,6921
9600,POWL,2016-06-02 18:00:00,5009,1366,Thursday,18,6375
9601,POWL,2016-06-02 19:00:00,3078,704,Thursday,19,3782
9602,POWL,2016-06-02 20:00:00,2074,445,Thursday,20,2519
9603,POWL,2016-06-02 21:00:00,2297,696,Thursday,21,2993
9604,POWL,2016-06-02 22:00:00,1576,420,Thursday,22,1996
9605,POWL,2016-06-02 23:00:00,917,222,Thursday,23,1139
9606,POWL,2016-06-03 00:00:00,553,82,Friday,0,635
9607,POWL,2016-06-03 01:00:00,79,7,Friday,1,86
9608,POWL,2016-06-03 04:00:00,10,88,Friday,4,98
9609,POWL,2016-06-03 05:00:00,82,558,Friday,5,640
9610,POWL,2016-06-03 06:00:00,205,1297,Friday,6,1502
9611,POWL,2016-06-03 07:00:00,442,2411,Friday,7,2853
9612,POWL,2016-06-03 08:00:00,617,3601,Friday,8,4218
9613,POWL,2016-06-03 09:00:00,593,3043,Friday,9,3636
9614,POWL,2016-06-03 10:00:00,567,2415,Friday,10,2982
9615,POWL,2016-06-03 11:00:00,835,1962,Friday,11,2797
9616,POWL,2016-06-03 12:00:00,1029,1631,Friday,12,2660
9617,POWL,2016-06-03 13:00:00,1284,1609,Friday,13,2893
9618,POWL,2016-06-03 14:00:00,1759,1583,Friday,14,3342
9619,POWL,2016-06-03 15:00:00,2143,1484,Friday,15,3627
9620,POWL,2016-06-03 16:00:00,3390,1456,Friday,16,4846
9621,POWL,2016-06-03 17:00:00,4574,1703,Friday,17,6277
9622,POWL,2016-06-03 18:00:00,5069,1414,Friday,18,6483
9623,POWL,2016-06-03 19:00:00,3330,1116,Friday,19,4446
9624,POWL,2016-06-03 20:00:00,2178,698,Friday,20,2876
9625,POWL,2016-06-03 21:00:00,2053,696,Friday,21,2749
9626,POWL,2016-06-03 22:00:00,1526,557,Friday,22,2083
9627,POWL,2016-06-03 23:00:00,1275,380,Friday,23,1655
9628,POWL,2016-06-04 00:00:00,1006,208,Saturday,0,1214
9629,POWL,2016-06-04 01:00:00,138,25,Saturday,1,163
9630,POWL,2016-06-04 05:00:00,1,1,Saturday,5,2
9631,POWL,2016-06-04 06:00:00,76,520,Saturday,6,596
9632,POWL,2016-06-04 07:00:00,273,926,Saturday,7,1199
9633,POWL,2016-06-04 08:00:00,285,1209,Saturday,8,1494
9634,POWL,2016-06-04 09:00:00,515,1483,Saturday,9,1998
9635,POWL,2016-06-04 10:00:00,550,1625,Saturday,10,2175
9636,POWL,2016-06-04 11:00:00,786,1878,Saturday,11,2664
9637,POWL,2016-06-04 12:00:00,950,1857,Saturday,12,2807
9638,POWL,2016-06-04 13:00:00,1167,1931,Saturday,13,3098
9639,POWL,2016-06-04 14:00:00,1350,1630,Saturday,14,2980
9640,POWL,2016-06-04 15:00:00,1798,1612,Saturday,15,3410
9641,POWL,2016-06-04 16:00:00,2061,1241,Saturday,16,3302
9642,POWL,2016-06-04 17:00:00,2479,1244,Saturday,17,3723
9643,POWL,2016-06-04 18:00:00,2445,983,Saturday,18,3428
9644,POWL,2016-06-04 19:00:00,1937,753,Saturday,19,2690
9645,POWL,2016-06-04 20:00:00,1706,748,Saturday,20,2454
9646,POWL,2016-06-04 21:00:00,1639,549,Saturday,21,2188
9647,POWL,2016-06-04 22:00:00,1260,445,Saturday,22,1705
9648,POWL,2016-06-04 23:00:00,928,291,Saturday,23,1219
9649,POWL,2016-06-05 00:00:00,856,120,Sunday,0,976
9650,POWL,2016-06-05 01:00:00,109,30,Sunday,1,139
9651,POWL,2016-06-05 08:00:00,207,955,Sunday,8,1162
9652,POWL,2016-06-05 09:00:00,419,970,Sunday,9,1389
9653,POWL,2016-06-05 10:00:00,513,1390,Sunday,10,1903
9654,POWL,2016-06-05 11:00:00,625,1638,Sunday,11,2263
9655,POWL,2016-06-05 12:00:00,731,1447,Sunday,12,2178
9656,POWL,2016-06-05 13:00:00,999,1700,Sunday,13,2699
9657,POWL,2016-06-05 14:00:00,1132,1314,Sunday,14,2446
9658,POWL,2016-06-05 15:00:00,1490,1313,Sunday,15,2803
9659,POWL,2016-06-05 16:00:00,1754,1079,Sunday,16,2833
9660,POWL,2016-06-05 17:00:00,1980,801,Sunday,17,2781
9661,POWL,2016-06-05 18:00:00,1806,627,Sunday,18,2433
9662,POWL,2016-06-05 19:00:00,1572,497,Sunday,19,2069
9663,POWL,2016-06-05 20:00:00,1441,709,Sunday,20,2150
9664,POWL,2016-06-05 21:00:00,984,414,Sunday,21,1398
9665,POWL,2016-06-05 22:00:00,704,288,Sunday,22,992
9666,POWL,2016-06-05 23:00:00,683,149,Sunday,23,832
9667,POWL,2016-06-06 00:00:00,347,69,Monday,0,416
9668,POWL,2016-06-06 01:00:00,52,3,Monday,1,55
9669,POWL,2016-06-06 04:00:00,10,93,Monday,4,103
9670,POWL,2016-06-06 05:00:00,68,568,Monday,5,636
9671,POWL,2016-06-06 06:00:00,211,1345,Monday,6,1556
9672,POWL,2016-06-06 07:00:00,374,2617,Monday,7,2991
9673,POWL,2016-06-06 08:00:00,705,3889,Monday,8,4594
9674,POWL,2016-06-06 09:00:00,633,3537,Monday,9,4170
9675,POWL,2016-06-06 10:00:00,536,1928,Monday,10,2464
9676,POWL,2016-06-06 11:00:00,723,1662,Monday,11,2385
9677,POWL,2016-06-06 12:00:00,813,1405,Monday,12,2218
9678,POWL,2016-06-06 13:00:00,1108,1323,Monday,13,2431
9679,POWL,2016-06-06 14:00:00,1368,1396,Monday,14,2764
9680,POWL,2016-06-06 15:00:00,1807,1233,Monday,15,3040
9681,POWL,2016-06-06 16:00:00,3062,1179,Monday,16,4241
9682,POWL,2016-06-06 17:00:00,4568,1324,Monday,17,5892
9683,POWL,2016-06-06 18:00:00,5097,1218,Monday,18,6315
9684,POWL,2016-06-06 19:00:00,3214,659,Monday,19,3873
9685,POWL,2016-06-06 20:00:00,2026,359,Monday,20,2385
9686,POWL,2016-06-06 21:00:00,1907,339,Monday,21,2246
9687,POWL,2016-06-06 22:00:00,1324,328,Monday,22,1652
9688,POWL,2016-06-06 23:00:00,862,190,Monday,23,1052
9689,POWL,2016-06-07 00:00:00,418,67,Tuesday,0,485
9690,POWL,2016-06-07 01:00:00,38,2,Tuesday,1,40
9691,POWL,2016-06-07 04:00:00,16,74,Tuesday,4,90
9692,POWL,2016-06-07 05:00:00,86,652,Tuesday,5,738
9693,POWL,2016-06-07 06:00:00,211,1406,Tuesday,6,1617
9694,POWL,2016-06-07 07:00:00,438,2666,Tuesday,7,3104
9695,POWL,2016-06-07 08:00:00,658,4462,Tuesday,8,5120
9696,POWL,2016-06-07 09:00:00,623,3767,Tuesday,9,4390
9697,POWL,2016-06-07 10:00:00,520,2212,Tuesday,10,2732
9698,POWL,2016-06-07 11:00:00,632,1642,Tuesday,11,2274
9699,POWL,2016-06-07 12:00:00,858,1468,Tuesday,12,2326
9700,POWL,2016-06-07 13:00:00,1050,1423,Tuesday,13,2473
9701,POWL,2016-06-07 14:00:00,1440,1389,Tuesday,14,2829
9702,POWL,2016-06-07 15:00:00,2220,1364,Tuesday,15,3584
9703,POWL,2016-06-07 16:00:00,3223,1260,Tuesday,16,4483
9704,POWL,2016-06-07 17:00:00,4772,1568,Tuesday,17,6340
9705,POWL,2016-06-07 18:00:00,5313,1310,Tuesday,18,6623
9706,POWL,2016-06-07 19:00:00,3488,692,Tuesday,19,4180
9707,POWL,2016-06-07 20:00:00,2211,408,Tuesday,20,2619
9708,POWL,2016-06-07 21:00:00,2006,310,Tuesday,21,2316
9709,POWL,2016-06-07 22:00:00,1500,298,Tuesday,22,1798
9710,POWL,2016-06-07 23:00:00,1051,160,Tuesday,23,1211
9711,POWL,2016-06-08 00:00:00,528,85,Wednesday,0,613
9712,POWL,2016-06-08 01:00:00,75,16,Wednesday,1,91
9713,POWL,2016-06-08 04:00:00,9,98,Wednesday,4,107
9714,POWL,2016-06-08 05:00:00,77,607,Wednesday,5,684
9715,POWL,2016-06-08 06:00:00,193,1476,Wednesday,6,1669
9716,POWL,2016-06-08 07:00:00,432,2696,Wednesday,7,3128
9717,POWL,2016-06-08 08:00:00,649,4065,Wednesday,8,4714
9718,POWL,2016-06-08 09:00:00,596,3831,Wednesday,9,4427
9719,POWL,2016-06-08 10:00:00,548,2348,Wednesday,10,2896
9720,POWL,2016-06-08 11:00:00,676,1966,Wednesday,11,2642
9721,POWL,2016-06-08 12:00:00,856,1553,Wednesday,12,2409
9722,POWL,2016-06-08 13:00:00,1263,1543,Wednesday,13,2806
9723,POWL,2016-06-08 14:00:00,1579,1410,Wednesday,14,2989
9724,POWL,2016-06-08 15:00:00,2115,1325,Wednesday,15,3440
9725,POWL,2016-06-08 16:00:00,3479,1136,Wednesday,16,4615
9726,POWL,2016-06-08 17:00:00,4855,1540,Wednesday,17,6395
9727,POWL,2016-06-08 18:00:00,5501,1324,Wednesday,18,6825
9728,POWL,2016-06-08 19:00:00,3159,636,Wednesday,19,3795
9729,POWL,2016-06-08 20:00:00,1979,439,Wednesday,20,2418
9730,POWL,2016-06-08 21:00:00,2095,541,Wednesday,21,2636
9731,POWL,2016-06-08 22:00:00,1461,315,Wednesday,22,1776
9732,POWL,2016-06-08 23:00:00,1123,210,Wednesday,23,1333
9733,POWL,2016-06-09 00:00:00,520,64,Thursday,0,584
9734,POWL,2016-06-09 01:00:00,74,6,Thursday,1,80
9735,POWL,2016-06-09 04:00:00,14,88,Thursday,4,102
9736,POWL,2016-06-09 05:00:00,89,657,Thursday,5,746
9737,POWL,2016-06-09 06:00:00,209,1350,Thursday,6,1559
9738,POWL,2016-06-09 07:00:00,439,2485,Thursday,7,2924
9739,POWL,2016-06-09 08:00:00,689,4089,Thursday,8,4778
9740,POWL,2016-06-09 09:00:00,672,3372,Thursday,9,4044
9741,POWL,2016-06-09 10:00:00,592,2275,Thursday,10,2867
9742,POWL,2016-06-09 11:00:00,678,1730,Thursday,11,2408
9743,POWL,2016-06-09 12:00:00,873,1555,Thursday,12,2428
9744,POWL,2016-06-09 13:00:00,1129,1490,Thursday,13,2619
9745,POWL,2016-06-09 14:00:00,1469,1552,Thursday,14,3021
9746,POWL,2016-06-09 15:00:00,2136,1403,Thursday,15,3539
9747,POWL,2016-06-09 16:00:00,3351,1374,Thursday,16,4725
9748,POWL,2016-06-09 17:00:00,4654,1772,Thursday,17,6426
9749,POWL,2016-06-09 18:00:00,5364,1445,Thursday,18,6809
9750,POWL,2016-06-09 19:00:00,3368,805,Thursday,19,4173
9751,POWL,2016-06-09 20:00:00,2320,455,Thursday,20,2775
9752,POWL,2016-06-09 21:00:00,2267,393,Thursday,21,2660
9753,POWL,2016-06-09 22:00:00,1543,416,Thursday,22,1959
9754,POWL,2016-06-09 23:00:00,1045,243,Thursday,23,1288
9755,POWL,2016-06-10 00:00:00,569,70,Friday,0,639
9756,POWL,2016-06-10 01:00:00,53,9,Friday,1,62
9757,POWL,2016-06-10 04:00:00,17,79,Friday,4,96
9758,POWL,2016-06-10 05:00:00,75,550,Friday,5,625
9759,POWL,2016-06-10 06:00:00,208,1274,Friday,6,1482
9760,POWL,2016-06-10 07:00:00,419,2352,Friday,7,2771
9761,POWL,2016-06-10 08:00:00,664,3617,Friday,8,4281
9762,POWL,2016-06-10 09:00:00,564,3183,Friday,9,3747
9763,POWL,2016-06-10 10:00:00,611,2220,Friday,10,2831
9764,POWL,2016-06-10 11:00:00,696,1913,Friday,11,2609
9765,POWL,2016-06-10 12:00:00,1029,1800,Friday,12,2829
9766,POWL,2016-06-10 13:00:00,1231,1647,Friday,13,2878
9767,POWL,2016-06-10 14:00:00,1697,1635,Friday,14,3332
9768,POWL,2016-06-10 15:00:00,2374,1567,Friday,15,3941
9769,POWL,2016-06-10 16:00:00,3620,1617,Friday,16,5237
9770,POWL,2016-06-10 17:00:00,4802,1834,Friday,17,6636
9771,POWL,2016-06-10 18:00:00,4723,1412,Friday,18,6135
9772,POWL,2016-06-10 19:00:00,2799,806,Friday,19,3605
9773,POWL,2016-06-10 20:00:00,1805,517,Friday,20,2322
9774,POWL,2016-06-10 21:00:00,1891,552,Friday,21,2443
9775,POWL,2016-06-10 22:00:00,1563,605,Friday,22,2168
9776,POWL,2016-06-10 23:00:00,1331,288,Friday,23,1619
9777,POWL,2016-06-11 00:00:00,763,148,Saturday,0,911
9778,POWL,2016-06-11 01:00:00,116,17,Saturday,1,133
9779,POWL,2016-06-11 05:00:00,1,2,Saturday,5,3
9780,POWL,2016-06-11 06:00:00,65,400,Saturday,6,465
9781,POWL,2016-06-11 07:00:00,239,931,Saturday,7,1170
9782,POWL,2016-06-11 08:00:00,312,1207,Saturday,8,1519
9783,POWL,2016-06-11 09:00:00,377,1460,Saturday,9,1837
9784,POWL,2016-06-11 10:00:00,542,1682,Saturday,10,2224
9785,POWL,2016-06-11 11:00:00,700,2037,Saturday,11,2737
9786,POWL,2016-06-11 12:00:00,838,2090,Saturday,12,2928
9787,POWL,2016-06-11 13:00:00,1125,2077,Saturday,13,3202
9788,POWL,2016-06-11 14:00:00,1170,2134,Saturday,14,3304
9789,POWL,2016-06-11 15:00:00,1758,1659,Saturday,15,3417
9790,POWL,2016-06-11 16:00:00,2099,1371,Saturday,16,3470
9791,POWL,2016-06-11 17:00:00,2426,1150,Saturday,17,3576
9792,POWL,2016-06-11 18:00:00,2525,1098,Saturday,18,3623
9793,POWL,2016-06-11 19:00:00,2204,905,Saturday,19,3109
9794,POWL,2016-06-11 20:00:00,1681,574,Saturday,20,2255
9795,POWL,2016-06-11 21:00:00,1552,475,Saturday,21,2027
9796,POWL,2016-06-11 22:00:00,1588,430,Saturday,22,2018
9797,POWL,2016-06-11 23:00:00,1126,325,Saturday,23,1451
9798,POWL,2016-06-12 00:00:00,901,141,Sunday,0,1042
9799,POWL,2016-06-12 01:00:00,132,14,Sunday,1,146
9800,POWL,2016-06-12 07:00:00,5,7,Sunday,7,12
9801,POWL,2016-06-12 08:00:00,198,919,Sunday,8,1117
9802,POWL,2016-06-12 09:00:00,432,1062,Sunday,9,1494
9803,POWL,2016-06-12 10:00:00,525,1378,Sunday,10,1903
9804,POWL,2016-06-12 11:00:00,646,1835,Sunday,11,2481
9805,POWL,2016-06-12 12:00:00,643,1842,Sunday,12,2485
9806,POWL,2016-06-12 13:00:00,857,1800,Sunday,13,2657
9807,POWL,2016-06-12 14:00:00,1042,1556,Sunday,14,2598
9808,POWL,2016-06-12 15:00:00,1231,1408,Sunday,15,2639
9809,POWL,2016-06-12 16:00:00,1648,1124,Sunday,16,2772
9810,POWL,2016-06-12 17:00:00,2110,990,Sunday,17,3100
9811,POWL,2016-06-12 18:00:00,2043,659,Sunday,18,2702
9812,POWL,2016-06-12 19:00:00,1986,487,Sunday,19,2473
9813,POWL,2016-06-12 20:00:00,1884,384,Sunday,20,2268
9814,POWL,2016-06-12 21:00:00,1162,391,Sunday,21,1553
9815,POWL,2016-06-12 22:00:00,885,319,Sunday,22,1204
9816,POWL,2016-06-12 23:00:00,616,145,Sunday,23,761
9817,POWL,2016-06-13 00:00:00,390,116,Monday,0,506
9818,POWL,2016-06-13 01:00:00,50,10,Monday,1,60
9819,POWL,2016-06-13 04:00:00,12,97,Monday,4,109
9820,POWL,2016-06-13 05:00:00,76,618,Monday,5,694
9821,POWL,2016-06-13 06:00:00,207,1208,Monday,6,1415
9822,POWL,2016-06-13 07:00:00,465,2606,Monday,7,3071
9823,POWL,2016-06-13 08:00:00,819,3817,Monday,8,4636
9824,POWL,2016-06-13 09:00:00,662,3432,Monday,9,4094
9825,POWL,2016-06-13 10:00:00,572,1836,Monday,10,2408
9826,POWL,2016-06-13 11:00:00,678,1741,Monday,11,2419
9827,POWL,2016-06-13 12:00:00,880,1553,Monday,12,2433
9828,POWL,2016-06-13 13:00:00,1068,1467,Monday,13,2535
9829,POWL,2016-06-13 14:00:00,1410,1322,Monday,14,2732
9830,POWL,2016-06-13 15:00:00,1984,1229,Monday,15,3213
9831,POWL,2016-06-13 16:00:00,3361,1402,Monday,16,4763
9832,POWL,2016-06-13 17:00:00,5233,1573,Monday,17,6806
9833,POWL,2016-06-13 18:00:00,5148,1236,Monday,18,6384
9834,POWL,2016-06-13 19:00:00,2805,577,Monday,19,3382
9835,POWL,2016-06-13 20:00:00,1597,320,Monday,20,1917
9836,POWL,2016-06-13 21:00:00,1969,782,Monday,21,2751
9837,POWL,2016-06-13 22:00:00,1438,426,Monday,22,1864
9838,POWL,2016-06-13 23:00:00,982,199,Monday,23,1181
9839,POWL,2016-06-14 00:00:00,441,75,Tuesday,0,516
9840,POWL,2016-06-14 01:00:00,39,10,Tuesday,1,49
9841,POWL,2016-06-14 04:00:00,17,105,Tuesday,4,122
9842,POWL,2016-06-14 05:00:00,78,615,Tuesday,5,693
9843,POWL,2016-06-14 06:00:00,222,1387,Tuesday,6,1609
9844,POWL,2016-06-14 07:00:00,437,2640,Tuesday,7,3077
9845,POWL,2016-06-14 08:00:00,754,4340,Tuesday,8,5094
9846,POWL,2016-06-14 09:00:00,622,3588,Tuesday,9,4210
9847,POWL,2016-06-14 10:00:00,538,2210,Tuesday,10,2748
9848,POWL,2016-06-14 11:00:00,681,1805,Tuesday,11,2486
9849,POWL,2016-06-14 12:00:00,856,1578,Tuesday,12,2434
9850,POWL,2016-06-14 13:00:00,1161,1376,Tuesday,13,2537
9851,POWL,2016-06-14 14:00:00,1497,1420,Tuesday,14,2917
9852,POWL,2016-06-14 15:00:00,2038,1365,Tuesday,15,3403
9853,POWL,2016-06-14 16:00:00,3196,1284,Tuesday,16,4480
9854,POWL,2016-06-14 17:00:00,4905,1646,Tuesday,17,6551
9855,POWL,2016-06-14 18:00:00,5410,1270,Tuesday,18,6680
9856,POWL,2016-06-14 19:00:00,3486,681,Tuesday,19,4167
9857,POWL,2016-06-14 20:00:00,2302,377,Tuesday,20,2679
9858,POWL,2016-06-14 21:00:00,1817,432,Tuesday,21,2249
9859,POWL,2016-06-14 22:00:00,1474,397,Tuesday,22,1871
9860,POWL,2016-06-14 23:00:00,1023,156,Tuesday,23,1179
9861,RICH,2016-06-01 01:00:00,3,13,Wednesday,1,16
9862,RICH,2016-06-01 05:00:00,151,37,Wednesday,5,188
9863,RICH,2016-06-01 06:00:00,387,106,Wednesday,6,493
9864,RICH,2016-06-01 07:00:00,784,170,Wednesday,7,954
9865,RICH,2016-06-01 08:00:00,772,151,Wednesday,8,923
9866,RICH,2016-06-01 09:00:00,478,121,Wednesday,9,599
9867,RICH,2016-06-01 10:00:00,254,87,Wednesday,10,341
9868,RICH,2016-06-01 11:00:00,185,66,Wednesday,11,251
9869,RICH,2016-06-01 12:00:00,230,145,Wednesday,12,375
9870,RICH,2016-06-01 13:00:00,149,161,Wednesday,13,310
9871,RICH,2016-06-01 14:00:00,159,212,Wednesday,14,371
9872,RICH,2016-06-01 15:00:00,172,346,Wednesday,15,518
9873,RICH,2016-06-01 16:00:00,189,625,Wednesday,16,814
9874,RICH,2016-06-01 17:00:00,217,604,Wednesday,17,821
9875,RICH,2016-06-01 18:00:00,181,725,Wednesday,18,906
9876,RICH,2016-06-01 19:00:00,98,301,Wednesday,19,399
9877,RICH,2016-06-01 20:00:00,53,189,Wednesday,20,242
9878,RICH,2016-06-01 21:00:00,44,164,Wednesday,21,208
9879,RICH,2016-06-01 22:00:00,54,95,Wednesday,22,149
9880,RICH,2016-06-01 23:00:00,27,110,Wednesday,23,137
9881,RICH,2016-06-02 00:00:00,7,72,Thursday,0,79
9882,RICH,2016-06-02 01:00:00,1,19,Thursday,1,20
9883,RICH,2016-06-02 05:00:00,146,33,Thursday,5,179
9884,RICH,2016-06-02 06:00:00,356,110,Thursday,6,466
9885,RICH,2016-06-02 07:00:00,780,193,Thursday,7,973
9886,RICH,2016-06-02 08:00:00,794,164,Thursday,8,958
9887,RICH,2016-06-02 09:00:00,459,101,Thursday,9,560
9888,RICH,2016-06-02 10:00:00,230,87,Thursday,10,317
9889,RICH,2016-06-02 11:00:00,182,89,Thursday,11,271
9890,RICH,2016-06-02 12:00:00,172,121,Thursday,12,293
9891,RICH,2016-06-02 13:00:00,153,139,Thursday,13,292
9892,RICH,2016-06-02 14:00:00,157,191,Thursday,14,348
9893,RICH,2016-06-02 15:00:00,177,342,Thursday,15,519
9894,RICH,2016-06-02 16:00:00,213,415,Thursday,16,628
9895,RICH,2016-06-02 17:00:00,263,840,Thursday,17,1103
9896,RICH,2016-06-02 18:00:00,190,486,Thursday,18,676
9897,RICH,2016-06-02 19:00:00,105,395,Thursday,19,500
9898,RICH,2016-06-02 20:00:00,65,214,Thursday,20,279
9899,RICH,2016-06-02 21:00:00,55,182,Thursday,21,237
9900,RICH,2016-06-02 22:00:00,31,123,Thursday,22,154
9901,RICH,2016-06-02 23:00:00,32,106,Thursday,23,138
9902,RICH,2016-06-03 00:00:00,21,87,Friday,0,108
9903,RICH,2016-06-03 01:00:00,1,42,Friday,1,43
9904,RICH,2016-06-03 04:00:00,41,1,Friday,4,42
9905,RICH,2016-06-03 05:00:00,133,26,Friday,5,159
9906,RICH,2016-06-03 06:00:00,337,113,Friday,6,450
9907,RICH,2016-06-03 07:00:00,753,174,Friday,7,927
9908,RICH,2016-06-03 08:00:00,719,156,Friday,8,875
9909,RICH,2016-06-03 09:00:00,439,127,Friday,9,566
9910,RICH,2016-06-03 10:00:00,282,73,Friday,10,355
9911,RICH,2016-06-03 11:00:00,181,116,Friday,11,297
9912,RICH,2016-06-03 12:00:00,146,120,Friday,12,266
9913,RICH,2016-06-03 13:00:00,171,170,Friday,13,341
9914,RICH,2016-06-03 14:00:00,172,237,Friday,14,409
9915,RICH,2016-06-03 15:00:00,169,364,Friday,15,533
9916,RICH,2016-06-03 16:00:00,226,526,Friday,16,752
9917,RICH,2016-06-03 17:00:00,254,587,Friday,17,841
9918,RICH,2016-06-03 18:00:00,201,649,Friday,18,850
9919,RICH,2016-06-03 19:00:00,122,294,Friday,19,416
9920,RICH,2016-06-03 20:00:00,74,171,Friday,20,245
9921,RICH,2016-06-03 21:00:00,63,156,Friday,21,219
9922,RICH,2016-06-03 22:00:00,47,144,Friday,22,191
9923,RICH,2016-06-03 23:00:00,31,159,Friday,23,190
9924,RICH,2016-06-04 00:00:00,12,90,Saturday,0,102
9925,RICH,2016-06-04 01:00:00,2,26,Saturday,1,28
9926,RICH,2016-06-04 06:00:00,66,25,Saturday,6,91
9927,RICH,2016-06-04 07:00:00,192,48,Saturday,7,240
9928,RICH,2016-06-04 08:00:00,190,63,Saturday,8,253
9929,RICH,2016-06-04 09:00:00,171,64,Saturday,9,235
9930,RICH,2016-06-04 10:00:00,163,66,Saturday,10,229
9931,RICH,2016-06-04 11:00:00,189,69,Saturday,11,258
9932,RICH,2016-06-04 12:00:00,156,91,Saturday,12,247
9933,RICH,2016-06-04 13:00:00,171,105,Saturday,13,276
9934,RICH,2016-06-04 14:00:00,180,82,Saturday,14,262
9935,RICH,2016-06-04 15:00:00,118,190,Saturday,15,308
9936,RICH,2016-06-04 16:00:00,111,158,Saturday,16,269
9937,RICH,2016-06-04 17:00:00,92,216,Saturday,17,308
9938,RICH,2016-06-04 18:00:00,76,215,Saturday,18,291
9939,RICH,2016-06-04 19:00:00,63,141,Saturday,19,204
9940,RICH,2016-06-04 20:00:00,57,114,Saturday,20,171
9941,RICH,2016-06-04 21:00:00,54,115,Saturday,21,169
9942,RICH,2016-06-04 22:00:00,47,101,Saturday,22,148
9943,RICH,2016-06-04 23:00:00,37,82,Saturday,23,119
9944,RICH,2016-06-05 00:00:00,12,55,Sunday,0,67
9945,RICH,2016-06-05 01:00:00,3,28,Sunday,1,31
9946,RICH,2016-06-05 08:00:00,153,60,Sunday,8,213
9947,RICH,2016-06-05 09:00:00,136,75,Sunday,9,211
9948,RICH,2016-06-05 10:00:00,114,53,Sunday,10,167
9949,RICH,2016-06-05 11:00:00,138,48,Sunday,11,186
9950,RICH,2016-06-05 12:00:00,111,65,Sunday,12,176
9951,RICH,2016-06-05 13:00:00,108,89,Sunday,13,197
9952,RICH,2016-06-05 14:00:00,137,86,Sunday,14,223
9953,RICH,2016-06-05 15:00:00,116,94,Sunday,15,210
9954,RICH,2016-06-05 16:00:00,140,101,Sunday,16,241
9955,RICH,2016-06-05 17:00:00,77,159,Sunday,17,236
9956,RICH,2016-06-05 18:00:00,87,192,Sunday,18,279
9957,RICH,2016-06-05 19:00:00,72,124,Sunday,19,196
9958,RICH,2016-06-05 20:00:00,53,89,Sunday,20,142
9959,RICH,2016-06-05 21:00:00,64,113,Sunday,21,177
9960,RICH,2016-06-05 22:00:00,45,77,Sunday,22,122
9961,RICH,2016-06-05 23:00:00,37,69,Sunday,23,106
9962,RICH,2016-06-06 00:00:00,4,36,Monday,0,40
9963,RICH,2016-06-06 01:00:00,2,14,Monday,1,16
9964,RICH,2016-06-06 05:00:00,144,34,Monday,5,178
9965,RICH,2016-06-06 06:00:00,316,91,Monday,6,407
9966,RICH,2016-06-06 07:00:00,745,168,Monday,7,913
9967,RICH,2016-06-06 08:00:00,710,165,Monday,8,875
9968,RICH,2016-06-06 09:00:00,473,108,Monday,9,581
9969,RICH,2016-06-06 10:00:00,229,67,Monday,10,296
9970,RICH,2016-06-06 11:00:00,172,88,Monday,11,260
9971,RICH,2016-06-06 12:00:00,144,112,Monday,12,256
9972,RICH,2016-06-06 13:00:00,129,143,Monday,13,272
9973,RICH,2016-06-06 14:00:00,149,231,Monday,14,380
9974,RICH,2016-06-06 15:00:00,144,348,Monday,15,492
9975,RICH,2016-06-06 16:00:00,224,509,Monday,16,733
9976,RICH,2016-06-06 17:00:00,205,696,Monday,17,901
9977,RICH,2016-06-06 18:00:00,161,517,Monday,18,678
9978,RICH,2016-06-06 19:00:00,106,265,Monday,19,371
9979,RICH,2016-06-06 20:00:00,61,192,Monday,20,253
9980,RICH,2016-06-06 21:00:00,60,135,Monday,21,195
9981,RICH,2016-06-06 22:00:00,36,122,Monday,22,158
9982,RICH,2016-06-06 23:00:00,26,96,Monday,23,122
9983,RICH,2016-06-07 00:00:00,7,52,Tuesday,0,59
9984,RICH,2016-06-07 04:00:00,40,1,Tuesday,4,41
9985,RICH,2016-06-07 05:00:00,147,48,Tuesday,5,195
9986,RICH,2016-06-07 06:00:00,336,99,Tuesday,6,435
9987,RICH,2016-06-07 07:00:00,751,172,Tuesday,7,923
9988,RICH,2016-06-07 08:00:00,849,160,Tuesday,8,1009
9989,RICH,2016-06-07 09:00:00,535,112,Tuesday,9,647
9990,RICH,2016-06-07 10:00:00,234,72,Tuesday,10,306
9991,RICH,2016-06-07 11:00:00,161,93,Tuesday,11,254
9992,RICH,2016-06-07 12:00:00,157,129,Tuesday,12,286
9993,RICH,2016-06-07 13:00:00,149,143,Tuesday,13,292
9994,RICH,2016-06-07 14:00:00,147,217,Tuesday,14,364
9995,RICH,2016-06-07 15:00:00,167,362,Tuesday,15,529
9996,RICH,2016-06-07 16:00:00,260,569,Tuesday,16,829
9997,RICH,2016-06-07 17:00:00,209,716,Tuesday,17,925
9998,RICH,2016-06-07 18:00:00,192,565,Tuesday,18,757
9999,RICH,2016-06-07 19:00:00,110,280,Tuesday,19,390
10000,RICH,2016-06-07 20:00:00,50,196,Tuesday,20,246
10001,RICH,2016-06-07 21:00:00,32,129,Tuesday,21,161
10002,RICH,2016-06-07 22:00:00,34,131,Tuesday,22,165
10003,RICH,2016-06-07 23:00:00,24,72,Tuesday,23,96
10004,RICH,2016-06-08 00:00:00,16,82,Wednesday,0,98
10005,RICH,2016-06-08 01:00:00,2,40,Wednesday,1,42
10006,RICH,2016-06-08 05:00:00,152,44,Wednesday,5,196
10007,RICH,2016-06-08 06:00:00,338,117,Wednesday,6,455
10008,RICH,2016-06-08 07:00:00,769,183,Wednesday,7,952
10009,RICH,2016-06-08 08:00:00,790,137,Wednesday,8,927
10010,RICH,2016-06-08 09:00:00,430,94,Wednesday,9,524
10011,RICH,2016-06-08 10:00:00,241,58,Wednesday,10,299
10012,RICH,2016-06-08 11:00:00,207,76,Wednesday,11,283
10013,RICH,2016-06-08 12:00:00,158,131,Wednesday,12,289
10014,RICH,2016-06-08 13:00:00,164,184,Wednesday,13,348
10015,RICH,2016-06-08 14:00:00,181,237,Wednesday,14,418
10016,RICH,2016-06-08 15:00:00,196,379,Wednesday,15,575
10017,RICH,2016-06-08 16:00:00,233,521,Wednesday,16,754
10018,RICH,2016-06-08 17:00:00,260,746,Wednesday,17,1006
10019,RICH,2016-06-08 18:00:00,189,610,Wednesday,18,799
10020,RICH,2016-06-08 19:00:00,104,245,Wednesday,19,349
10021,RICH,2016-06-08 20:00:00,42,165,Wednesday,20,207
10022,RICH,2016-06-08 21:00:00,59,162,Wednesday,21,221
10023,RICH,2016-06-08 22:00:00,30,141,Wednesday,22,171
10024,RICH,2016-06-08 23:00:00,17,92,Wednesday,23,109
10025,RICH,2016-06-09 00:00:00,11,95,Thursday,0,106
10026,RICH,2016-06-09 01:00:00,1,24,Thursday,1,25
10027,RICH,2016-06-09 05:00:00,153,35,Thursday,5,188
10028,RICH,2016-06-09 06:00:00,336,112,Thursday,6,448
10029,RICH,2016-06-09 07:00:00,748,185,Thursday,7,933
10030,RICH,2016-06-09 08:00:00,786,164,Thursday,8,950
10031,RICH,2016-06-09 09:00:00,432,101,Thursday,9,533
10032,RICH,2016-06-09 10:00:00,249,88,Thursday,10,337
10033,RICH,2016-06-09 11:00:00,203,82,Thursday,11,285
10034,RICH,2016-06-09 12:00:00,180,105,Thursday,12,285
10035,RICH,2016-06-09 13:00:00,132,144,Thursday,13,276
10036,RICH,2016-06-09 14:00:00,187,170,Thursday,14,357
10037,RICH,2016-06-09 15:00:00,173,372,Thursday,15,545
10038,RICH,2016-06-09 16:00:00,225,518,Thursday,16,743
10039,RICH,2016-06-09 17:00:00,211,590,Thursday,17,801
10040,RICH,2016-06-09 18:00:00,207,632,Thursday,18,839
10041,RICH,2016-06-09 19:00:00,98,383,Thursday,19,481
10042,RICH,2016-06-09 20:00:00,53,189,Thursday,20,242
10043,RICH,2016-06-09 21:00:00,68,141,Thursday,21,209
10044,RICH,2016-06-09 22:00:00,46,91,Thursday,22,137
10045,RICH,2016-06-09 23:00:00,17,146,Thursday,23,163
10046,RICH,2016-06-10 00:00:00,11,71,Friday,0,82
10047,RICH,2016-06-10 01:00:00,2,21,Friday,1,23
10048,RICH,2016-06-10 04:00:00,30,1,Friday,4,31
10049,RICH,2016-06-10 05:00:00,135,32,Friday,5,167
10050,RICH,2016-06-10 06:00:00,348,99,Friday,6,447
10051,RICH,2016-06-10 07:00:00,727,179,Friday,7,906
10052,RICH,2016-06-10 08:00:00,670,146,Friday,8,816
10053,RICH,2016-06-10 09:00:00,429,106,Friday,9,535
10054,RICH,2016-06-10 10:00:00,231,70,Friday,10,301
10055,RICH,2016-06-10 11:00:00,201,92,Friday,11,293
10056,RICH,2016-06-10 12:00:00,165,112,Friday,12,277
10057,RICH,2016-06-10 13:00:00,188,160,Friday,13,348
10058,RICH,2016-06-10 14:00:00,182,188,Friday,14,370
10059,RICH,2016-06-10 15:00:00,204,378,Friday,15,582
10060,RICH,2016-06-10 16:00:00,240,548,Friday,16,788
10061,RICH,2016-06-10 17:00:00,262,648,Friday,17,910
10062,RICH,2016-06-10 18:00:00,213,510,Friday,18,723
10063,RICH,2016-06-10 19:00:00,94,285,Friday,19,379
10064,RICH,2016-06-10 20:00:00,73,161,Friday,20,234
10065,RICH,2016-06-10 21:00:00,52,146,Friday,21,198
10066,RICH,2016-06-10 22:00:00,54,166,Friday,22,220
10067,RICH,2016-06-10 23:00:00,27,90,Friday,23,117
10068,RICH,2016-06-11 00:00:00,12,121,Saturday,0,133
10069,RICH,2016-06-11 01:00:00,1,35,Saturday,1,36
10070,RICH,2016-06-11 05:00:00,1,1,Saturday,5,2
10071,RICH,2016-06-11 06:00:00,47,33,Saturday,6,80
10072,RICH,2016-06-11 07:00:00,193,36,Saturday,7,229
10073,RICH,2016-06-11 08:00:00,190,71,Saturday,8,261
10074,RICH,2016-06-11 09:00:00,180,57,Saturday,9,237
10075,RICH,2016-06-11 10:00:00,155,77,Saturday,10,232
10076,RICH,2016-06-11 11:00:00,153,59,Saturday,11,212
10077,RICH,2016-06-11 12:00:00,138,89,Saturday,12,227
10078,RICH,2016-06-11 13:00:00,163,135,Saturday,13,298
10079,RICH,2016-06-11 14:00:00,163,102,Saturday,14,265
10080,RICH,2016-06-11 15:00:00,144,135,Saturday,15,279
10081,RICH,2016-06-11 16:00:00,130,174,Saturday,16,304
10082,RICH,2016-06-11 17:00:00,105,161,Saturday,17,266
10083,RICH,2016-06-11 18:00:00,87,211,Saturday,18,298
10084,RICH,2016-06-11 19:00:00,62,167,Saturday,19,229
10085,RICH,2016-06-11 20:00:00,64,95,Saturday,20,159
10086,RICH,2016-06-11 21:00:00,57,93,Saturday,21,150
10087,RICH,2016-06-11 22:00:00,54,114,Saturday,22,168
10088,RICH,2016-06-11 23:00:00,22,105,Saturday,23,127
10089,RICH,2016-06-12 00:00:00,10,103,Sunday,0,113
10090,RICH,2016-06-12 08:00:00,141,37,Sunday,8,178
10091,RICH,2016-06-12 09:00:00,126,66,Sunday,9,192
10092,RICH,2016-06-12 10:00:00,120,48,Sunday,10,168
10093,RICH,2016-06-12 11:00:00,135,44,Sunday,11,179
10094,RICH,2016-06-12 12:00:00,123,48,Sunday,12,171
10095,RICH,2016-06-12 13:00:00,146,68,Sunday,13,214
10096,RICH,2016-06-12 14:00:00,129,92,Sunday,14,221
10097,RICH,2016-06-12 15:00:00,109,103,Sunday,15,212
10098,RICH,2016-06-12 16:00:00,122,100,Sunday,16,222
10099,RICH,2016-06-12 17:00:00,89,139,Sunday,17,228
10100,RICH,2016-06-12 18:00:00,91,142,Sunday,18,233
10101,RICH,2016-06-12 19:00:00,90,126,Sunday,19,216
10102,RICH,2016-06-12 20:00:00,56,112,Sunday,20,168
10103,RICH,2016-06-12 21:00:00,63,71,Sunday,21,134
10104,RICH,2016-06-12 22:00:00,50,103,Sunday,22,153
10105,RICH,2016-06-12 23:00:00,28,109,Sunday,23,137
10106,RICH,2016-06-13 00:00:00,5,58,Monday,0,63
10107,RICH,2016-06-13 01:00:00,1,12,Monday,1,13
10108,RICH,2016-06-13 05:00:00,156,37,Monday,5,193
10109,RICH,2016-06-13 06:00:00,324,91,Monday,6,415
10110,RICH,2016-06-13 07:00:00,756,165,Monday,7,921
10111,RICH,2016-06-13 08:00:00,722,160,Monday,8,882
10112,RICH,2016-06-13 09:00:00,456,111,Monday,9,567
10113,RICH,2016-06-13 10:00:00,231,92,Monday,10,323
10114,RICH,2016-06-13 11:00:00,209,86,Monday,11,295
10115,RICH,2016-06-13 12:00:00,161,103,Monday,12,264
10116,RICH,2016-06-13 13:00:00,164,143,Monday,13,307
10117,RICH,2016-06-13 14:00:00,181,206,Monday,14,387
10118,RICH,2016-06-13 15:00:00,181,320,Monday,15,501
10119,RICH,2016-06-13 16:00:00,244,467,Monday,16,711
10120,RICH,2016-06-13 17:00:00,278,627,Monday,17,905
10121,RICH,2016-06-13 18:00:00,212,726,Monday,18,938
10122,RICH,2016-06-13 19:00:00,110,257,Monday,19,367
10123,RICH,2016-06-13 20:00:00,56,151,Monday,20,207
10124,RICH,2016-06-13 21:00:00,44,179,Monday,21,223
10125,RICH,2016-06-13 22:00:00,32,188,Monday,22,220
10126,RICH,2016-06-13 23:00:00,28,126,Monday,23,154
10127,RICH,2016-06-14 00:00:00,5,53,Tuesday,0,58
10128,RICH,2016-06-14 04:00:00,33,1,Tuesday,4,34
10129,RICH,2016-06-14 05:00:00,138,37,Tuesday,5,175
10130,RICH,2016-06-14 06:00:00,374,88,Tuesday,6,462
10131,RICH,2016-06-14 07:00:00,783,174,Tuesday,7,957
10132,RICH,2016-06-14 08:00:00,789,161,Tuesday,8,950
10133,RICH,2016-06-14 09:00:00,456,108,Tuesday,9,564
10134,RICH,2016-06-14 10:00:00,226,60,Tuesday,10,286
10135,RICH,2016-06-14 11:00:00,189,77,Tuesday,11,266
10136,RICH,2016-06-14 12:00:00,150,102,Tuesday,12,252
10137,RICH,2016-06-14 13:00:00,153,151,Tuesday,13,304
10138,RICH,2016-06-14 14:00:00,181,204,Tuesday,14,385
10139,RICH,2016-06-14 15:00:00,193,352,Tuesday,15,545
10140,RICH,2016-06-14 16:00:00,185,523,Tuesday,16,708
10141,RICH,2016-06-14 17:00:00,214,766,Tuesday,17,980
10142,RICH,2016-06-14 18:00:00,199,499,Tuesday,18,698
10143,RICH,2016-06-14 19:00:00,96,370,Tuesday,19,466
10144,RICH,2016-06-14 20:00:00,47,210,Tuesday,20,257
10145,RICH,2016-06-14 21:00:00,40,154,Tuesday,21,194
10146,RICH,2016-06-14 22:00:00,30,112,Tuesday,22,142
10147,RICH,2016-06-14 23:00:00,30,118,Tuesday,23,148
10148,ROCK,2016-06-01 04:00:00,3,4,Wednesday,4,7
10149,ROCK,2016-06-01 05:00:00,89,12,Wednesday,5,101
10150,ROCK,2016-06-01 06:00:00,214,53,Wednesday,6,267
10151,ROCK,2016-06-01 07:00:00,746,198,Wednesday,7,944
10152,ROCK,2016-06-01 08:00:00,1259,185,Wednesday,8,1444
10153,ROCK,2016-06-01 09:00:00,780,124,Wednesday,9,904
10154,ROCK,2016-06-01 10:00:00,435,101,Wednesday,10,536
10155,ROCK,2016-06-01 11:00:00,213,102,Wednesday,11,315
10156,ROCK,2016-06-01 12:00:00,215,164,Wednesday,12,379
10157,ROCK,2016-06-01 13:00:00,186,168,Wednesday,13,354
10158,ROCK,2016-06-01 14:00:00,153,225,Wednesday,14,378
10159,ROCK,2016-06-01 15:00:00,168,323,Wednesday,15,491
10160,ROCK,2016-06-01 16:00:00,209,657,Wednesday,16,866
10161,ROCK,2016-06-01 17:00:00,292,1258,Wednesday,17,1550
10162,ROCK,2016-06-01 18:00:00,297,1041,Wednesday,18,1338
10163,ROCK,2016-06-01 19:00:00,151,659,Wednesday,19,810
10164,ROCK,2016-06-01 20:00:00,121,292,Wednesday,20,413
10165,ROCK,2016-06-01 21:00:00,95,293,Wednesday,21,388
10166,ROCK,2016-06-01 22:00:00,99,186,Wednesday,22,285
10167,ROCK,2016-06-01 23:00:00,28,122,Wednesday,23,150
10168,ROCK,2016-06-02 00:00:00,16,47,Thursday,0,63
10169,ROCK,2016-06-02 05:00:00,83,14,Thursday,5,97
10170,ROCK,2016-06-02 06:00:00,219,51,Thursday,6,270
10171,ROCK,2016-06-02 07:00:00,734,180,Thursday,7,914
10172,ROCK,2016-06-02 08:00:00,1184,222,Thursday,8,1406
10173,ROCK,2016-06-02 09:00:00,860,147,Thursday,9,1007
10174,ROCK,2016-06-02 10:00:00,395,135,Thursday,10,530
10175,ROCK,2016-06-02 11:00:00,275,137,Thursday,11,412
10176,ROCK,2016-06-02 12:00:00,211,159,Thursday,12,370
10177,ROCK,2016-06-02 13:00:00,148,181,Thursday,13,329
10178,ROCK,2016-06-02 14:00:00,167,269,Thursday,14,436
10179,ROCK,2016-06-02 15:00:00,269,355,Thursday,15,624
10180,ROCK,2016-06-02 16:00:00,211,672,Thursday,16,883
10181,ROCK,2016-06-02 17:00:00,394,1378,Thursday,17,1772
10182,ROCK,2016-06-02 18:00:00,309,929,Thursday,18,1238
10183,ROCK,2016-06-02 19:00:00,184,561,Thursday,19,745
10184,ROCK,2016-06-02 20:00:00,117,220,Thursday,20,337
10185,ROCK,2016-06-02 21:00:00,126,368,Thursday,21,494
10186,ROCK,2016-06-02 22:00:00,97,261,Thursday,22,358
10187,ROCK,2016-06-02 23:00:00,35,104,Thursday,23,139
10188,ROCK,2016-06-03 00:00:00,15,81,Friday,0,96
10189,ROCK,2016-06-03 04:00:00,3,9,Friday,4,12
10190,ROCK,2016-06-03 05:00:00,65,18,Friday,5,83
10191,ROCK,2016-06-03 06:00:00,197,51,Friday,6,248
10192,ROCK,2016-06-03 07:00:00,577,155,Friday,7,732
10193,ROCK,2016-06-03 08:00:00,1090,168,Friday,8,1258
10194,ROCK,2016-06-03 09:00:00,715,154,Friday,9,869
10195,ROCK,2016-06-03 10:00:00,381,131,Friday,10,512
10196,ROCK,2016-06-03 11:00:00,241,113,Friday,11,354
10197,ROCK,2016-06-03 12:00:00,199,184,Friday,12,383
10198,ROCK,2016-06-03 13:00:00,138,185,Friday,13,323
10199,ROCK,2016-06-03 14:00:00,192,287,Friday,14,479
10200,ROCK,2016-06-03 15:00:00,197,369,Friday,15,566
10201,ROCK,2016-06-03 16:00:00,249,697,Friday,16,946
10202,ROCK,2016-06-03 17:00:00,341,1060,Friday,17,1401
10203,ROCK,2016-06-03 18:00:00,335,961,Friday,18,1296
10204,ROCK,2016-06-03 19:00:00,289,372,Friday,19,661
10205,ROCK,2016-06-03 20:00:00,144,213,Friday,20,357
10206,ROCK,2016-06-03 21:00:00,118,264,Friday,21,382
10207,ROCK,2016-06-03 22:00:00,84,302,Friday,22,386
10208,ROCK,2016-06-03 23:00:00,101,198,Friday,23,299
10209,ROCK,2016-06-04 00:00:00,37,153,Saturday,0,190
10210,ROCK,2016-06-04 06:00:00,17,16,Saturday,6,33
10211,ROCK,2016-06-04 07:00:00,49,39,Saturday,7,88
10212,ROCK,2016-06-04 08:00:00,104,61,Saturday,8,165
10213,ROCK,2016-06-04 09:00:00,147,105,Saturday,9,252
10214,ROCK,2016-06-04 10:00:00,184,120,Saturday,10,304
10215,ROCK,2016-06-04 11:00:00,196,108,Saturday,11,304
10216,ROCK,2016-06-04 12:00:00,232,142,Saturday,12,374
10217,ROCK,2016-06-04 13:00:00,252,143,Saturday,13,395
10218,ROCK,2016-06-04 14:00:00,185,189,Saturday,14,374
10219,ROCK,2016-06-04 15:00:00,209,202,Saturday,15,411
10220,ROCK,2016-06-04 16:00:00,183,198,Saturday,16,381
10221,ROCK,2016-06-04 17:00:00,228,273,Saturday,17,501
10222,ROCK,2016-06-04 18:00:00,210,277,Saturday,18,487
10223,ROCK,2016-06-04 19:00:00,189,219,Saturday,19,408
10224,ROCK,2016-06-04 20:00:00,163,168,Saturday,20,331
10225,ROCK,2016-06-04 21:00:00,121,177,Saturday,21,298
10226,ROCK,2016-06-04 22:00:00,95,192,Saturday,22,287
10227,ROCK,2016-06-04 23:00:00,63,124,Saturday,23,187
10228,ROCK,2016-06-05 00:00:00,34,116,Sunday,0,150
10229,ROCK,2016-06-05 07:00:00,1,1,Sunday,7,2
10230,ROCK,2016-06-05 08:00:00,58,56,Sunday,8,114
10231,ROCK,2016-06-05 09:00:00,114,77,Sunday,9,191
10232,ROCK,2016-06-05 10:00:00,135,121,Sunday,10,256
10233,ROCK,2016-06-05 11:00:00,216,111,Sunday,11,327
10234,ROCK,2016-06-05 12:00:00,217,101,Sunday,12,318
10235,ROCK,2016-06-05 13:00:00,210,155,Sunday,13,365
10236,ROCK,2016-06-05 14:00:00,162,172,Sunday,14,334
10237,ROCK,2016-06-05 15:00:00,166,194,Sunday,15,360
10238,ROCK,2016-06-05 16:00:00,194,227,Sunday,16,421
10239,ROCK,2016-06-05 17:00:00,153,256,Sunday,17,409
10240,ROCK,2016-06-05 18:00:00,117,180,Sunday,18,297
10241,ROCK,2016-06-05 19:00:00,102,152,Sunday,19,254
10242,ROCK,2016-06-05 20:00:00,108,219,Sunday,20,327
10243,ROCK,2016-06-05 21:00:00,91,135,Sunday,21,226
10244,ROCK,2016-06-05 22:00:00,70,78,Sunday,22,148
10245,ROCK,2016-06-05 23:00:00,31,47,Sunday,23,78
10246,ROCK,2016-06-06 00:00:00,19,37,Monday,0,56
10247,ROCK,2016-06-06 04:00:00,11,3,Monday,4,14
10248,ROCK,2016-06-06 05:00:00,69,9,Monday,5,78
10249,ROCK,2016-06-06 06:00:00,233,47,Monday,6,280
10250,ROCK,2016-06-06 07:00:00,696,151,Monday,7,847
10251,ROCK,2016-06-06 08:00:00,1274,183,Monday,8,1457
10252,ROCK,2016-06-06 09:00:00,854,174,Monday,9,1028
10253,ROCK,2016-06-06 10:00:00,343,98,Monday,10,441
10254,ROCK,2016-06-06 11:00:00,234,132,Monday,11,366
10255,ROCK,2016-06-06 12:00:00,221,128,Monday,12,349
10256,ROCK,2016-06-06 13:00:00,155,196,Monday,13,351
10257,ROCK,2016-06-06 14:00:00,148,215,Monday,14,363
10258,ROCK,2016-06-06 15:00:00,146,346,Monday,15,492
10259,ROCK,2016-06-06 16:00:00,218,587,Monday,16,805
10260,ROCK,2016-06-06 17:00:00,288,1136,Monday,17,1424
10261,ROCK,2016-06-06 18:00:00,237,1210,Monday,18,1447
10262,ROCK,2016-06-06 19:00:00,176,618,Monday,19,794
10263,ROCK,2016-06-06 20:00:00,96,336,Monday,20,432
10264,ROCK,2016-06-06 21:00:00,108,268,Monday,21,376
10265,ROCK,2016-06-06 22:00:00,54,173,Monday,22,227
10266,ROCK,2016-06-06 23:00:00,29,93,Monday,23,122
10267,ROCK,2016-06-07 00:00:00,15,51,Tuesday,0,66
10268,ROCK,2016-06-07 04:00:00,8,4,Tuesday,4,12
10269,ROCK,2016-06-07 05:00:00,67,15,Tuesday,5,82
10270,ROCK,2016-06-07 06:00:00,216,51,Tuesday,6,267
10271,ROCK,2016-06-07 07:00:00,674,169,Tuesday,7,843
10272,ROCK,2016-06-07 08:00:00,1304,189,Tuesday,8,1493
10273,ROCK,2016-06-07 09:00:00,892,130,Tuesday,9,1022
10274,ROCK,2016-06-07 10:00:00,369,163,Tuesday,10,532
10275,ROCK,2016-06-07 11:00:00,209,108,Tuesday,11,317
10276,ROCK,2016-06-07 12:00:00,211,150,Tuesday,12,361
10277,ROCK,2016-06-07 13:00:00,165,196,Tuesday,13,361
10278,ROCK,2016-06-07 14:00:00,170,194,Tuesday,14,364
10279,ROCK,2016-06-07 15:00:00,156,341,Tuesday,15,497
10280,ROCK,2016-06-07 16:00:00,216,648,Tuesday,16,864
10281,ROCK,2016-06-07 17:00:00,368,1120,Tuesday,17,1488
10282,ROCK,2016-06-07 18:00:00,344,1241,Tuesday,18,1585
10283,ROCK,2016-06-07 19:00:00,166,644,Tuesday,19,810
10284,ROCK,2016-06-07 20:00:00,118,288,Tuesday,20,406
10285,ROCK,2016-06-07 21:00:00,111,283,Tuesday,21,394
10286,ROCK,2016-06-07 22:00:00,100,236,Tuesday,22,336
10287,ROCK,2016-06-07 23:00:00,29,199,Tuesday,23,228
10288,ROCK,2016-06-08 00:00:00,17,62,Wednesday,0,79
10289,ROCK,2016-06-08 01:00:00,7,8,Wednesday,1,15
10290,ROCK,2016-06-08 04:00:00,6,4,Wednesday,4,10
10291,ROCK,2016-06-08 05:00:00,75,15,Wednesday,5,90
10292,ROCK,2016-06-08 06:00:00,215,50,Wednesday,6,265
10293,ROCK,2016-06-08 07:00:00,708,159,Wednesday,7,867
10294,ROCK,2016-06-08 08:00:00,1251,196,Wednesday,8,1447
10295,ROCK,2016-06-08 09:00:00,815,138,Wednesday,9,953
10296,ROCK,2016-06-08 10:00:00,404,111,Wednesday,10,515
10297,ROCK,2016-06-08 11:00:00,244,126,Wednesday,11,370
10298,ROCK,2016-06-08 12:00:00,225,175,Wednesday,12,400
10299,ROCK,2016-06-08 13:00:00,201,150,Wednesday,13,351
10300,ROCK,2016-06-08 14:00:00,161,250,Wednesday,14,411
10301,ROCK,2016-06-08 15:00:00,153,334,Wednesday,15,487
10302,ROCK,2016-06-08 16:00:00,250,605,Wednesday,16,855
10303,ROCK,2016-06-08 17:00:00,404,1256,Wednesday,17,1660
10304,ROCK,2016-06-08 18:00:00,330,1134,Wednesday,18,1464
10305,ROCK,2016-06-08 19:00:00,183,428,Wednesday,19,611
10306,ROCK,2016-06-08 20:00:00,100,281,Wednesday,20,381
10307,ROCK,2016-06-08 21:00:00,113,363,Wednesday,21,476
10308,ROCK,2016-06-08 22:00:00,80,261,Wednesday,22,341
10309,ROCK,2016-06-08 23:00:00,33,253,Wednesday,23,286
10310,ROCK,2016-06-09 00:00:00,12,67,Thursday,0,79
10311,ROCK,2016-06-09 04:00:00,1,5,Thursday,4,6
10312,ROCK,2016-06-09 05:00:00,74,10,Thursday,5,84
10313,ROCK,2016-06-09 06:00:00,230,45,Thursday,6,275
10314,ROCK,2016-06-09 07:00:00,643,148,Thursday,7,791
10315,ROCK,2016-06-09 08:00:00,1202,188,Thursday,8,1390
10316,ROCK,2016-06-09 09:00:00,824,133,Thursday,9,957
10317,ROCK,2016-06-09 10:00:00,486,111,Thursday,10,597
10318,ROCK,2016-06-09 11:00:00,268,136,Thursday,11,404
10319,ROCK,2016-06-09 12:00:00,214,140,Thursday,12,354
10320,ROCK,2016-06-09 13:00:00,193,223,Thursday,13,416
10321,ROCK,2016-06-09 14:00:00,187,263,Thursday,14,450
10322,ROCK,2016-06-09 15:00:00,143,364,Thursday,15,507
10323,ROCK,2016-06-09 16:00:00,233,648,Thursday,16,881
10324,ROCK,2016-06-09 17:00:00,293,1237,Thursday,17,1530
10325,ROCK,2016-06-09 18:00:00,305,1046,Thursday,18,1351
10326,ROCK,2016-06-09 19:00:00,180,631,Thursday,19,811
10327,ROCK,2016-06-09 20:00:00,110,315,Thursday,20,425
10328,ROCK,2016-06-09 21:00:00,107,311,Thursday,21,418
10329,ROCK,2016-06-09 22:00:00,84,227,Thursday,22,311
10330,ROCK,2016-06-09 23:00:00,67,148,Thursday,23,215
10331,ROCK,2016-06-10 00:00:00,20,49,Friday,0,69
10332,ROCK,2016-06-10 05:00:00,58,13,Friday,5,71
10333,ROCK,2016-06-10 06:00:00,185,37,Friday,6,222
10334,ROCK,2016-06-10 07:00:00,565,144,Friday,7,709
10335,ROCK,2016-06-10 08:00:00,1139,146,Friday,8,1285
10336,ROCK,2016-06-10 09:00:00,656,137,Friday,9,793
10337,ROCK,2016-06-10 10:00:00,409,114,Friday,10,523
10338,ROCK,2016-06-10 11:00:00,294,132,Friday,11,426
10339,ROCK,2016-06-10 12:00:00,228,166,Friday,12,394
10340,ROCK,2016-06-10 13:00:00,177,249,Friday,13,426
10341,ROCK,2016-06-10 14:00:00,199,292,Friday,14,491
10342,ROCK,2016-06-10 15:00:00,229,404,Friday,15,633
10343,ROCK,2016-06-10 16:00:00,238,658,Friday,16,896
10344,ROCK,2016-06-10 17:00:00,429,1061,Friday,17,1490
10345,ROCK,2016-06-10 18:00:00,416,1052,Friday,18,1468
10346,ROCK,2016-06-10 19:00:00,216,303,Friday,19,519
10347,ROCK,2016-06-10 20:00:00,120,223,Friday,20,343
10348,ROCK,2016-06-10 21:00:00,96,250,Friday,21,346
10349,ROCK,2016-06-10 22:00:00,123,282,Friday,22,405
10350,ROCK,2016-06-10 23:00:00,91,238,Friday,23,329
10351,ROCK,2016-06-11 00:00:00,43,126,Saturday,0,169
10352,ROCK,2016-06-11 06:00:00,20,9,Saturday,6,29
10353,ROCK,2016-06-11 07:00:00,82,34,Saturday,7,116
10354,ROCK,2016-06-11 08:00:00,111,82,Saturday,8,193
10355,ROCK,2016-06-11 09:00:00,190,91,Saturday,9,281
10356,ROCK,2016-06-11 10:00:00,202,106,Saturday,10,308
10357,ROCK,2016-06-11 11:00:00,198,123,Saturday,11,321
10358,ROCK,2016-06-11 12:00:00,250,135,Saturday,12,385
10359,ROCK,2016-06-11 13:00:00,259,148,Saturday,13,407
10360,ROCK,2016-06-11 14:00:00,309,173,Saturday,14,482
10361,ROCK,2016-06-11 15:00:00,196,182,Saturday,15,378
10362,ROCK,2016-06-11 16:00:00,180,208,Saturday,16,388
10363,ROCK,2016-06-11 17:00:00,231,247,Saturday,17,478
10364,ROCK,2016-06-11 18:00:00,210,245,Saturday,18,455
10365,ROCK,2016-06-11 19:00:00,164,215,Saturday,19,379
10366,ROCK,2016-06-11 20:00:00,122,215,Saturday,20,337
10367,ROCK,2016-06-11 21:00:00,112,240,Saturday,21,352
10368,ROCK,2016-06-11 22:00:00,79,180,Saturday,22,259
10369,ROCK,2016-06-11 23:00:00,66,162,Saturday,23,228
10370,ROCK,2016-06-12 00:00:00,35,104,Sunday,0,139
10371,ROCK,2016-06-12 07:00:00,2,2,Sunday,7,4
10372,ROCK,2016-06-12 08:00:00,62,34,Sunday,8,96
10373,ROCK,2016-06-12 09:00:00,112,64,Sunday,9,176
10374,ROCK,2016-06-12 10:00:00,166,108,Sunday,10,274
10375,ROCK,2016-06-12 11:00:00,246,137,Sunday,11,383
10376,ROCK,2016-06-12 12:00:00,241,124,Sunday,12,365
10377,ROCK,2016-06-12 13:00:00,243,145,Sunday,13,388
10378,ROCK,2016-06-12 14:00:00,224,162,Sunday,14,386
10379,ROCK,2016-06-12 15:00:00,178,158,Sunday,15,336
10380,ROCK,2016-06-12 16:00:00,271,189,Sunday,16,460
10381,ROCK,2016-06-12 17:00:00,182,282,Sunday,17,464
10382,ROCK,2016-06-12 18:00:00,139,291,Sunday,18,430
10383,ROCK,2016-06-12 19:00:00,160,176,Sunday,19,336
10384,ROCK,2016-06-12 20:00:00,102,173,Sunday,20,275
10385,ROCK,2016-06-12 21:00:00,85,235,Sunday,21,320
10386,ROCK,2016-06-12 22:00:00,56,179,Sunday,22,235
10387,ROCK,2016-06-12 23:00:00,29,82,Sunday,23,111
10388,ROCK,2016-06-13 00:00:00,19,50,Monday,0,69
10389,ROCK,2016-06-13 04:00:00,11,3,Monday,4,14
10390,ROCK,2016-06-13 05:00:00,79,13,Monday,5,92
10391,ROCK,2016-06-13 06:00:00,198,54,Monday,6,252
10392,ROCK,2016-06-13 07:00:00,741,168,Monday,7,909
10393,ROCK,2016-06-13 08:00:00,1209,160,Monday,8,1369
10394,ROCK,2016-06-13 09:00:00,917,105,Monday,9,1022
10395,ROCK,2016-06-13 10:00:00,363,94,Monday,10,457
10396,ROCK,2016-06-13 11:00:00,193,122,Monday,11,315
10397,ROCK,2016-06-13 12:00:00,180,140,Monday,12,320
10398,ROCK,2016-06-13 13:00:00,160,128,Monday,13,288
10399,ROCK,2016-06-13 14:00:00,130,186,Monday,14,316
10400,ROCK,2016-06-13 15:00:00,148,356,Monday,15,504
10401,ROCK,2016-06-13 16:00:00,254,692,Monday,16,946
10402,ROCK,2016-06-13 17:00:00,321,1222,Monday,17,1543
10403,ROCK,2016-06-13 18:00:00,302,1148,Monday,18,1450
10404,ROCK,2016-06-13 19:00:00,125,495,Monday,19,620
10405,ROCK,2016-06-13 20:00:00,78,232,Monday,20,310
10406,ROCK,2016-06-13 21:00:00,123,289,Monday,21,412
10407,ROCK,2016-06-13 22:00:00,102,243,Monday,22,345
10408,ROCK,2016-06-13 23:00:00,48,127,Monday,23,175
10409,ROCK,2016-06-14 00:00:00,13,67,Tuesday,0,80
10410,ROCK,2016-06-14 04:00:00,10,4,Tuesday,4,14
10411,ROCK,2016-06-14 05:00:00,79,14,Tuesday,5,93
10412,ROCK,2016-06-14 06:00:00,219,53,Tuesday,6,272
10413,ROCK,2016-06-14 07:00:00,703,169,Tuesday,7,872
10414,ROCK,2016-06-14 08:00:00,1317,156,Tuesday,8,1473
10415,ROCK,2016-06-14 09:00:00,804,154,Tuesday,9,958
10416,ROCK,2016-06-14 10:00:00,437,147,Tuesday,10,584
10417,ROCK,2016-06-14 11:00:00,249,103,Tuesday,11,352
10418,ROCK,2016-06-14 12:00:00,195,136,Tuesday,12,331
10419,ROCK,2016-06-14 13:00:00,153,166,Tuesday,13,319
10420,ROCK,2016-06-14 14:00:00,134,223,Tuesday,14,357
10421,ROCK,2016-06-14 15:00:00,183,341,Tuesday,15,524
10422,ROCK,2016-06-14 16:00:00,236,603,Tuesday,16,839
10423,ROCK,2016-06-14 17:00:00,345,1261,Tuesday,17,1606
10424,ROCK,2016-06-14 18:00:00,368,1162,Tuesday,18,1530
10425,ROCK,2016-06-14 19:00:00,171,488,Tuesday,19,659
10426,ROCK,2016-06-14 20:00:00,98,346,Tuesday,20,444
10427,ROCK,2016-06-14 21:00:00,104,308,Tuesday,21,412
10428,ROCK,2016-06-14 22:00:00,73,226,Tuesday,22,299
10429,ROCK,2016-06-14 23:00:00,40,248,Tuesday,23,288
10430,SANL,2016-06-01 01:00:00,2,9,Wednesday,1,11
10431,SANL,2016-06-01 04:00:00,2,4,Wednesday,4,6
10432,SANL,2016-06-01 05:00:00,198,74,Wednesday,5,272
10433,SANL,2016-06-01 06:00:00,453,158,Wednesday,6,611
10434,SANL,2016-06-01 07:00:00,993,274,Wednesday,7,1267
10435,SANL,2016-06-01 08:00:00,1096,230,Wednesday,8,1326
10436,SANL,2016-06-01 09:00:00,644,190,Wednesday,9,834
10437,SANL,2016-06-01 10:00:00,349,156,Wednesday,10,505
10438,SANL,2016-06-01 11:00:00,213,142,Wednesday,11,355
10439,SANL,2016-06-01 12:00:00,199,143,Wednesday,12,342
10440,SANL,2016-06-01 13:00:00,211,209,Wednesday,13,420
10441,SANL,2016-06-01 14:00:00,179,221,Wednesday,14,400
10442,SANL,2016-06-01 15:00:00,202,435,Wednesday,15,637
10443,SANL,2016-06-01 16:00:00,265,669,Wednesday,16,934
10444,SANL,2016-06-01 17:00:00,301,947,Wednesday,17,1248
10445,SANL,2016-06-01 18:00:00,286,1040,Wednesday,18,1326
10446,SANL,2016-06-01 19:00:00,167,409,Wednesday,19,576
10447,SANL,2016-06-01 20:00:00,99,312,Wednesday,20,411
10448,SANL,2016-06-01 21:00:00,76,203,Wednesday,21,279
10449,SANL,2016-06-01 22:00:00,58,161,Wednesday,22,219
10450,SANL,2016-06-01 23:00:00,34,115,Wednesday,23,149
10451,SANL,2016-06-02 00:00:00,13,42,Thursday,0,55
10452,SANL,2016-06-02 01:00:00,2,5,Thursday,1,7
10453,SANL,2016-06-02 04:00:00,3,11,Thursday,4,14
10454,SANL,2016-06-02 05:00:00,200,54,Thursday,5,254
10455,SANL,2016-06-02 06:00:00,456,152,Thursday,6,608
10456,SANL,2016-06-02 07:00:00,1005,256,Thursday,7,1261
10457,SANL,2016-06-02 08:00:00,1123,250,Thursday,8,1373
10458,SANL,2016-06-02 09:00:00,609,195,Thursday,9,804
10459,SANL,2016-06-02 10:00:00,500,125,Thursday,10,625
10460,SANL,2016-06-02 11:00:00,303,114,Thursday,11,417
10461,SANL,2016-06-02 12:00:00,168,168,Thursday,12,336
10462,SANL,2016-06-02 13:00:00,240,163,Thursday,13,403
10463,SANL,2016-06-02 14:00:00,202,317,Thursday,14,519
10464,SANL,2016-06-02 15:00:00,212,504,Thursday,15,716
10465,SANL,2016-06-02 16:00:00,287,668,Thursday,16,955
10466,SANL,2016-06-02 17:00:00,428,1199,Thursday,17,1627
10467,SANL,2016-06-02 18:00:00,227,865,Thursday,18,1092
10468,SANL,2016-06-02 19:00:00,144,407,Thursday,19,551
10469,SANL,2016-06-02 20:00:00,91,284,Thursday,20,375
10470,SANL,2016-06-02 21:00:00,106,354,Thursday,21,460
10471,SANL,2016-06-02 22:00:00,73,152,Thursday,22,225
10472,SANL,2016-06-02 23:00:00,43,149,Thursday,23,192
10473,SANL,2016-06-03 00:00:00,18,67,Friday,0,85
10474,SANL,2016-06-03 01:00:00,5,12,Friday,1,17
10475,SANL,2016-06-03 04:00:00,2,10,Friday,4,12
10476,SANL,2016-06-03 05:00:00,176,54,Friday,5,230
10477,SANL,2016-06-03 06:00:00,440,157,Friday,6,597
10478,SANL,2016-06-03 07:00:00,885,278,Friday,7,1163
10479,SANL,2016-06-03 08:00:00,1090,230,Friday,8,1320
10480,SANL,2016-06-03 09:00:00,552,178,Friday,9,730
10481,SANL,2016-06-03 10:00:00,390,184,Friday,10,574
10482,SANL,2016-06-03 11:00:00,252,164,Friday,11,416
10483,SANL,2016-06-03 12:00:00,229,196,Friday,12,425
10484,SANL,2016-06-03 13:00:00,190,325,Friday,13,515
10485,SANL,2016-06-03 14:00:00,224,259,Friday,14,483
10486,SANL,2016-06-03 15:00:00,216,430,Friday,15,646
10487,SANL,2016-06-03 16:00:00,285,679,Friday,16,964
10488,SANL,2016-06-03 17:00:00,338,909,Friday,17,1247
10489,SANL,2016-06-03 18:00:00,215,765,Friday,18,980
10490,SANL,2016-06-03 19:00:00,210,395,Friday,19,605
10491,SANL,2016-06-03 20:00:00,102,275,Friday,20,377
10492,SANL,2016-06-03 21:00:00,100,196,Friday,21,296
10493,SANL,2016-06-03 22:00:00,74,210,Friday,22,284
10494,SANL,2016-06-03 23:00:00,50,147,Friday,23,197
10495,SANL,2016-06-04 00:00:00,38,101,Saturday,0,139
10496,SANL,2016-06-04 01:00:00,4,12,Saturday,1,16
10497,SANL,2016-06-04 06:00:00,49,44,Saturday,6,93
10498,SANL,2016-06-04 07:00:00,152,61,Saturday,7,213
10499,SANL,2016-06-04 08:00:00,223,78,Saturday,8,301
10500,SANL,2016-06-04 09:00:00,188,108,Saturday,9,296
10501,SANL,2016-06-04 10:00:00,189,146,Saturday,10,335
10502,SANL,2016-06-04 11:00:00,166,190,Saturday,11,356
10503,SANL,2016-06-04 12:00:00,173,183,Saturday,12,356
10504,SANL,2016-06-04 13:00:00,224,227,Saturday,13,451
10505,SANL,2016-06-04 14:00:00,203,221,Saturday,14,424
10506,SANL,2016-06-04 15:00:00,179,220,Saturday,15,399
10507,SANL,2016-06-04 16:00:00,189,251,Saturday,16,440
10508,SANL,2016-06-04 17:00:00,202,228,Saturday,17,430
10509,SANL,2016-06-04 18:00:00,199,203,Saturday,18,402
10510,SANL,2016-06-04 19:00:00,137,180,Saturday,19,317
10511,SANL,2016-06-04 20:00:00,107,120,Saturday,20,227
10512,SANL,2016-06-04 21:00:00,71,122,Saturday,21,193
10513,SANL,2016-06-04 22:00:00,60,166,Saturday,22,226
10514,SANL,2016-06-04 23:00:00,57,120,Saturday,23,177
10515,SANL,2016-06-05 00:00:00,17,59,Sunday,0,76
10516,SANL,2016-06-05 01:00:00,4,10,Sunday,1,14
10517,SANL,2016-06-05 08:00:00,103,50,Sunday,8,153
10518,SANL,2016-06-05 09:00:00,145,59,Sunday,9,204
10519,SANL,2016-06-05 10:00:00,155,81,Sunday,10,236
10520,SANL,2016-06-05 11:00:00,179,82,Sunday,11,261
10521,SANL,2016-06-05 12:00:00,166,103,Sunday,12,269
10522,SANL,2016-06-05 13:00:00,163,107,Sunday,13,270
10523,SANL,2016-06-05 14:00:00,178,128,Sunday,14,306
10524,SANL,2016-06-05 15:00:00,194,142,Sunday,15,336
10525,SANL,2016-06-05 16:00:00,187,207,Sunday,16,394
10526,SANL,2016-06-05 17:00:00,98,185,Sunday,17,283
10527,SANL,2016-06-05 18:00:00,79,189,Sunday,18,268
10528,SANL,2016-06-05 19:00:00,83,166,Sunday,19,249
10529,SANL,2016-06-05 20:00:00,78,253,Sunday,20,331
10530,SANL,2016-06-05 21:00:00,56,113,Sunday,21,169
10531,SANL,2016-06-05 22:00:00,59,73,Sunday,22,132
10532,SANL,2016-06-05 23:00:00,25,78,Sunday,23,103
10533,SANL,2016-06-06 00:00:00,11,34,Monday,0,45
10534,SANL,2016-06-06 01:00:00,1,5,Monday,1,6
10535,SANL,2016-06-06 04:00:00,15,8,Monday,4,23
10536,SANL,2016-06-06 05:00:00,179,43,Monday,5,222
10537,SANL,2016-06-06 06:00:00,430,136,Monday,6,566
10538,SANL,2016-06-06 07:00:00,935,239,Monday,7,1174
10539,SANL,2016-06-06 08:00:00,1110,226,Monday,8,1336
10540,SANL,2016-06-06 09:00:00,650,169,Monday,9,819
10541,SANL,2016-06-06 10:00:00,304,122,Monday,10,426
10542,SANL,2016-06-06 11:00:00,200,161,Monday,11,361
10543,SANL,2016-06-06 12:00:00,196,160,Monday,12,356
10544,SANL,2016-06-06 13:00:00,173,185,Monday,13,358
10545,SANL,2016-06-06 14:00:00,210,253,Monday,14,463
10546,SANL,2016-06-06 15:00:00,184,305,Monday,15,489
10547,SANL,2016-06-06 16:00:00,234,711,Monday,16,945
10548,SANL,2016-06-06 17:00:00,326,1139,Monday,17,1465
10549,SANL,2016-06-06 18:00:00,217,847,Monday,18,1064
10550,SANL,2016-06-06 19:00:00,140,446,Monday,19,586
10551,SANL,2016-06-06 20:00:00,76,231,Monday,20,307
10552,SANL,2016-06-06 21:00:00,69,230,Monday,21,299
10553,SANL,2016-06-06 22:00:00,42,129,Monday,22,171
10554,SANL,2016-06-06 23:00:00,38,96,Monday,23,134
10555,SANL,2016-06-07 00:00:00,17,63,Tuesday,0,80
10556,SANL,2016-06-07 01:00:00,1,5,Tuesday,1,6
10557,SANL,2016-06-07 04:00:00,4,5,Tuesday,4,9
10558,SANL,2016-06-07 05:00:00,211,61,Tuesday,5,272
10559,SANL,2016-06-07 06:00:00,430,149,Tuesday,6,579
10560,SANL,2016-06-07 07:00:00,979,259,Tuesday,7,1238
10561,SANL,2016-06-07 08:00:00,1190,241,Tuesday,8,1431
10562,SANL,2016-06-07 09:00:00,610,156,Tuesday,9,766
10563,SANL,2016-06-07 10:00:00,319,128,Tuesday,10,447
10564,SANL,2016-06-07 11:00:00,175,145,Tuesday,11,320
10565,SANL,2016-06-07 12:00:00,192,150,Tuesday,12,342
10566,SANL,2016-06-07 13:00:00,182,155,Tuesday,13,337
10567,SANL,2016-06-07 14:00:00,196,216,Tuesday,14,412
10568,SANL,2016-06-07 15:00:00,210,436,Tuesday,15,646
10569,SANL,2016-06-07 16:00:00,270,722,Tuesday,16,992
10570,SANL,2016-06-07 17:00:00,386,1139,Tuesday,17,1525
10571,SANL,2016-06-07 18:00:00,276,879,Tuesday,18,1155
10572,SANL,2016-06-07 19:00:00,158,467,Tuesday,19,625
10573,SANL,2016-06-07 20:00:00,68,224,Tuesday,20,292
10574,SANL,2016-06-07 21:00:00,64,198,Tuesday,21,262
10575,SANL,2016-06-07 22:00:00,55,173,Tuesday,22,228
10576,SANL,2016-06-07 23:00:00,36,172,Tuesday,23,208
10577,SANL,2016-06-08 00:00:00,15,55,Wednesday,0,70
10578,SANL,2016-06-08 01:00:00,2,9,Wednesday,1,11
10579,SANL,2016-06-08 04:00:00,9,9,Wednesday,4,18
10580,SANL,2016-06-08 05:00:00,196,59,Wednesday,5,255
10581,SANL,2016-06-08 06:00:00,454,139,Wednesday,6,593
10582,SANL,2016-06-08 07:00:00,967,241,Wednesday,7,1208
10583,SANL,2016-06-08 08:00:00,1051,239,Wednesday,8,1290
10584,SANL,2016-06-08 09:00:00,678,162,Wednesday,9,840
10585,SANL,2016-06-08 10:00:00,309,126,Wednesday,10,435
10586,SANL,2016-06-08 11:00:00,180,137,Wednesday,11,317
10587,SANL,2016-06-08 12:00:00,201,165,Wednesday,12,366
10588,SANL,2016-06-08 13:00:00,166,217,Wednesday,13,383
10589,SANL,2016-06-08 14:00:00,166,226,Wednesday,14,392
10590,SANL,2016-06-08 15:00:00,199,412,Wednesday,15,611
10591,SANL,2016-06-08 16:00:00,302,681,Wednesday,16,983
10592,SANL,2016-06-08 17:00:00,458,1104,Wednesday,17,1562
10593,SANL,2016-06-08 18:00:00,304,846,Wednesday,18,1150
10594,SANL,2016-06-08 19:00:00,133,380,Wednesday,19,513
10595,SANL,2016-06-08 20:00:00,79,325,Wednesday,20,404
10596,SANL,2016-06-08 21:00:00,79,300,Wednesday,21,379
10597,SANL,2016-06-08 22:00:00,74,212,Wednesday,22,286
10598,SANL,2016-06-08 23:00:00,37,146,Wednesday,23,183
10599,SANL,2016-06-09 00:00:00,16,58,Thursday,0,74
10600,SANL,2016-06-09 01:00:00,2,6,Thursday,1,8
10601,SANL,2016-06-09 04:00:00,4,11,Thursday,4,15
10602,SANL,2016-06-09 05:00:00,209,57,Thursday,5,266
10603,SANL,2016-06-09 06:00:00,448,149,Thursday,6,597
10604,SANL,2016-06-09 07:00:00,889,270,Thursday,7,1159
10605,SANL,2016-06-09 08:00:00,1140,239,Thursday,8,1379
10606,SANL,2016-06-09 09:00:00,593,186,Thursday,9,779
10607,SANL,2016-06-09 10:00:00,320,142,Thursday,10,462
10608,SANL,2016-06-09 11:00:00,197,116,Thursday,11,313
10609,SANL,2016-06-09 12:00:00,184,150,Thursday,12,334
10610,SANL,2016-06-09 13:00:00,192,153,Thursday,13,345
10611,SANL,2016-06-09 14:00:00,181,273,Thursday,14,454
10612,SANL,2016-06-09 15:00:00,198,369,Thursday,15,567
10613,SANL,2016-06-09 16:00:00,282,683,Thursday,16,965
10614,SANL,2016-06-09 17:00:00,317,1032,Thursday,17,1349
10615,SANL,2016-06-09 18:00:00,260,893,Thursday,18,1153
10616,SANL,2016-06-09 19:00:00,158,421,Thursday,19,579
10617,SANL,2016-06-09 20:00:00,83,246,Thursday,20,329
10618,SANL,2016-06-09 21:00:00,84,235,Thursday,21,319
10619,SANL,2016-06-09 22:00:00,55,172,Thursday,22,227
10620,SANL,2016-06-09 23:00:00,40,144,Thursday,23,184
10621,SANL,2016-06-10 00:00:00,12,61,Friday,0,73
10622,SANL,2016-06-10 01:00:00,3,12,Friday,1,15
10623,SANL,2016-06-10 04:00:00,6,13,Friday,4,19
10624,SANL,2016-06-10 05:00:00,187,56,Friday,5,243
10625,SANL,2016-06-10 06:00:00,409,158,Friday,6,567
10626,SANL,2016-06-10 07:00:00,877,229,Friday,7,1106
10627,SANL,2016-06-10 08:00:00,1064,222,Friday,8,1286
10628,SANL,2016-06-10 09:00:00,537,195,Friday,9,732
10629,SANL,2016-06-10 10:00:00,328,139,Friday,10,467
10630,SANL,2016-06-10 11:00:00,231,145,Friday,11,376
10631,SANL,2016-06-10 12:00:00,212,176,Friday,12,388
10632,SANL,2016-06-10 13:00:00,190,241,Friday,13,431
10633,SANL,2016-06-10 14:00:00,185,302,Friday,14,487
10634,SANL,2016-06-10 15:00:00,231,414,Friday,15,645
10635,SANL,2016-06-10 16:00:00,303,634,Friday,16,937
10636,SANL,2016-06-10 17:00:00,481,1003,Friday,17,1484
10637,SANL,2016-06-10 18:00:00,354,683,Friday,18,1037
10638,SANL,2016-06-10 19:00:00,147,479,Friday,19,626
10639,SANL,2016-06-10 20:00:00,80,348,Friday,20,428
10640,SANL,2016-06-10 21:00:00,84,441,Friday,21,525
10641,SANL,2016-06-10 22:00:00,78,220,Friday,22,298
10642,SANL,2016-06-10 23:00:00,50,183,Friday,23,233
10643,SANL,2016-06-11 00:00:00,19,134,Saturday,0,153
10644,SANL,2016-06-11 01:00:00,6,9,Saturday,1,15
10645,SANL,2016-06-11 06:00:00,61,33,Saturday,6,94
10646,SANL,2016-06-11 07:00:00,150,71,Saturday,7,221
10647,SANL,2016-06-11 08:00:00,215,90,Saturday,8,305
10648,SANL,2016-06-11 09:00:00,215,86,Saturday,9,301
10649,SANL,2016-06-11 10:00:00,227,78,Saturday,10,305
10650,SANL,2016-06-11 11:00:00,230,113,Saturday,11,343
10651,SANL,2016-06-11 12:00:00,219,122,Saturday,12,341
10652,SANL,2016-06-11 13:00:00,183,143,Saturday,13,326
10653,SANL,2016-06-11 14:00:00,203,191,Saturday,14,394
10654,SANL,2016-06-11 15:00:00,183,159,Saturday,15,342
10655,SANL,2016-06-11 16:00:00,142,230,Saturday,16,372
10656,SANL,2016-06-11 17:00:00,139,223,Saturday,17,362
10657,SANL,2016-06-11 18:00:00,143,244,Saturday,18,387
10658,SANL,2016-06-11 19:00:00,135,164,Saturday,19,299
10659,SANL,2016-06-11 20:00:00,99,179,Saturday,20,278
10660,SANL,2016-06-11 21:00:00,76,188,Saturday,21,264
10661,SANL,2016-06-11 22:00:00,64,179,Saturday,22,243
10662,SANL,2016-06-11 23:00:00,44,151,Saturday,23,195
10663,SANL,2016-06-12 00:00:00,17,74,Sunday,0,91
10664,SANL,2016-06-12 01:00:00,3,11,Sunday,1,14
10665,SANL,2016-06-12 08:00:00,120,48,Sunday,8,168
10666,SANL,2016-06-12 09:00:00,147,57,Sunday,9,204
10667,SANL,2016-06-12 10:00:00,191,68,Sunday,10,259
10668,SANL,2016-06-12 11:00:00,175,101,Sunday,11,276
10669,SANL,2016-06-12 12:00:00,185,108,Sunday,12,293
10670,SANL,2016-06-12 13:00:00,169,82,Sunday,13,251
10671,SANL,2016-06-12 14:00:00,175,108,Sunday,14,283
10672,SANL,2016-06-12 15:00:00,147,128,Sunday,15,275
10673,SANL,2016-06-12 16:00:00,147,149,Sunday,16,296
10674,SANL,2016-06-12 17:00:00,100,217,Sunday,17,317
10675,SANL,2016-06-12 18:00:00,130,172,Sunday,18,302
10676,SANL,2016-06-12 19:00:00,140,158,Sunday,19,298
10677,SANL,2016-06-12 20:00:00,83,156,Sunday,20,239
10678,SANL,2016-06-12 21:00:00,65,227,Sunday,21,292
10679,SANL,2016-06-12 22:00:00,54,131,Sunday,22,185
10680,SANL,2016-06-12 23:00:00,28,202,Sunday,23,230
10681,SANL,2016-06-13 00:00:00,25,45,Monday,0,70
10682,SANL,2016-06-13 01:00:00,2,6,Monday,1,8
10683,SANL,2016-06-13 04:00:00,6,8,Monday,4,14
10684,SANL,2016-06-13 05:00:00,185,63,Monday,5,248
10685,SANL,2016-06-13 06:00:00,402,136,Monday,6,538
10686,SANL,2016-06-13 07:00:00,934,242,Monday,7,1176
10687,SANL,2016-06-13 08:00:00,1153,220,Monday,8,1373
10688,SANL,2016-06-13 09:00:00,568,174,Monday,9,742
10689,SANL,2016-06-13 10:00:00,276,133,Monday,10,409
10690,SANL,2016-06-13 11:00:00,215,116,Monday,11,331
10691,SANL,2016-06-13 12:00:00,165,171,Monday,12,336
10692,SANL,2016-06-13 13:00:00,194,163,Monday,13,357
10693,SANL,2016-06-13 14:00:00,202,276,Monday,14,478
10694,SANL,2016-06-13 15:00:00,197,348,Monday,15,545
10695,SANL,2016-06-13 16:00:00,330,643,Monday,16,973
10696,SANL,2016-06-13 17:00:00,452,1153,Monday,17,1605
10697,SANL,2016-06-13 18:00:00,324,821,Monday,18,1145
10698,SANL,2016-06-13 19:00:00,127,367,Monday,19,494
10699,SANL,2016-06-13 20:00:00,85,190,Monday,20,275
10700,SANL,2016-06-13 21:00:00,71,419,Monday,21,490
10701,SANL,2016-06-13 22:00:00,57,242,Monday,22,299
10702,SANL,2016-06-13 23:00:00,47,137,Monday,23,184
10703,SANL,2016-06-14 00:00:00,27,60,Tuesday,0,87
10704,SANL,2016-06-14 01:00:00,2,3,Tuesday,1,5
10705,SANL,2016-06-14 04:00:00,11,8,Tuesday,4,19
10706,SANL,2016-06-14 05:00:00,181,54,Tuesday,5,235
10707,SANL,2016-06-14 06:00:00,508,170,Tuesday,6,678
10708,SANL,2016-06-14 07:00:00,956,253,Tuesday,7,1209
10709,SANL,2016-06-14 08:00:00,1141,243,Tuesday,8,1384
10710,SANL,2016-06-14 09:00:00,703,196,Tuesday,9,899
10711,SANL,2016-06-14 10:00:00,292,141,Tuesday,10,433
10712,SANL,2016-06-14 11:00:00,203,119,Tuesday,11,322
10713,SANL,2016-06-14 12:00:00,207,154,Tuesday,12,361
10714,SANL,2016-06-14 13:00:00,194,184,Tuesday,13,378
10715,SANL,2016-06-14 14:00:00,185,233,Tuesday,14,418
10716,SANL,2016-06-14 15:00:00,220,375,Tuesday,15,595
10717,SANL,2016-06-14 16:00:00,259,687,Tuesday,16,946
10718,SANL,2016-06-14 17:00:00,361,1122,Tuesday,17,1483
10719,SANL,2016-06-14 18:00:00,269,859,Tuesday,18,1128
10720,SANL,2016-06-14 19:00:00,143,486,Tuesday,19,629
10721,SANL,2016-06-14 20:00:00,82,270,Tuesday,20,352
10722,SANL,2016-06-14 21:00:00,68,175,Tuesday,21,243
10723,SANL,2016-06-14 22:00:00,55,238,Tuesday,22,293
10724,SANL,2016-06-14 23:00:00,46,131,Tuesday,23,177
10725,SBRN,2016-06-01 01:00:00,1,7,Wednesday,1,8
10726,SBRN,2016-06-01 05:00:00,51,35,Wednesday,5,86
10727,SBRN,2016-06-01 06:00:00,167,120,Wednesday,6,287
10728,SBRN,2016-06-01 07:00:00,449,191,Wednesday,7,640
10729,SBRN,2016-06-01 08:00:00,860,265,Wednesday,8,1125
10730,SBRN,2016-06-01 09:00:00,478,132,Wednesday,9,610
10731,SBRN,2016-06-01 10:00:00,213,106,Wednesday,10,319
10732,SBRN,2016-06-01 11:00:00,141,65,Wednesday,11,206
10733,SBRN,2016-06-01 12:00:00,117,116,Wednesday,12,233
10734,SBRN,2016-06-01 13:00:00,101,119,Wednesday,13,220
10735,SBRN,2016-06-01 14:00:00,122,140,Wednesday,14,262
10736,SBRN,2016-06-01 15:00:00,124,225,Wednesday,15,349
10737,SBRN,2016-06-01 16:00:00,149,397,Wednesday,16,546
10738,SBRN,2016-06-01 17:00:00,262,730,Wednesday,17,992
10739,SBRN,2016-06-01 18:00:00,246,649,Wednesday,18,895
10740,SBRN,2016-06-01 19:00:00,179,384,Wednesday,19,563
10741,SBRN,2016-06-01 20:00:00,92,165,Wednesday,20,257
10742,SBRN,2016-06-01 21:00:00,70,113,Wednesday,21,183
10743,SBRN,2016-06-01 22:00:00,67,65,Wednesday,22,132
10744,SBRN,2016-06-01 23:00:00,19,50,Wednesday,23,69
10745,SBRN,2016-06-02 00:00:00,21,39,Thursday,0,60
10746,SBRN,2016-06-02 01:00:00,1,7,Thursday,1,8
10747,SBRN,2016-06-02 05:00:00,59,34,Thursday,5,93
10748,SBRN,2016-06-02 06:00:00,152,109,Thursday,6,261
10749,SBRN,2016-06-02 07:00:00,434,212,Thursday,7,646
10750,SBRN,2016-06-02 08:00:00,725,257,Thursday,8,982
10751,SBRN,2016-06-02 09:00:00,595,142,Thursday,9,737
10752,SBRN,2016-06-02 10:00:00,234,132,Thursday,10,366
10753,SBRN,2016-06-02 11:00:00,134,96,Thursday,11,230
10754,SBRN,2016-06-02 12:00:00,92,111,Thursday,12,203
10755,SBRN,2016-06-02 13:00:00,117,113,Thursday,13,230
10756,SBRN,2016-06-02 14:00:00,133,138,Thursday,14,271
10757,SBRN,2016-06-02 15:00:00,152,219,Thursday,15,371
10758,SBRN,2016-06-02 16:00:00,204,376,Thursday,16,580
10759,SBRN,2016-06-02 17:00:00,318,715,Thursday,17,1033
10760,SBRN,2016-06-02 18:00:00,287,667,Thursday,18,954
10761,SBRN,2016-06-02 19:00:00,137,291,Thursday,19,428
10762,SBRN,2016-06-02 20:00:00,78,154,Thursday,20,232
10763,SBRN,2016-06-02 21:00:00,86,141,Thursday,21,227
10764,SBRN,2016-06-02 22:00:00,57,152,Thursday,22,209
10765,SBRN,2016-06-02 23:00:00,28,73,Thursday,23,101
10766,SBRN,2016-06-03 00:00:00,23,35,Friday,0,58
10767,SBRN,2016-06-03 01:00:00,3,9,Friday,1,12
10768,SBRN,2016-06-03 04:00:00,14,1,Friday,4,15
10769,SBRN,2016-06-03 05:00:00,42,39,Friday,5,81
10770,SBRN,2016-06-03 06:00:00,149,106,Friday,6,255
10771,SBRN,2016-06-03 07:00:00,377,193,Friday,7,570
10772,SBRN,2016-06-03 08:00:00,689,174,Friday,8,863
10773,SBRN,2016-06-03 09:00:00,424,156,Friday,9,580
10774,SBRN,2016-06-03 10:00:00,267,87,Friday,10,354
10775,SBRN,2016-06-03 11:00:00,119,107,Friday,11,226
10776,SBRN,2016-06-03 12:00:00,106,141,Friday,12,247
10777,SBRN,2016-06-03 13:00:00,109,151,Friday,13,260
10778,SBRN,2016-06-03 14:00:00,143,202,Friday,14,345
10779,SBRN,2016-06-03 15:00:00,147,222,Friday,15,369
10780,SBRN,2016-06-03 16:00:00,230,389,Friday,16,619
10781,SBRN,2016-06-03 17:00:00,277,644,Friday,17,921
10782,SBRN,2016-06-03 18:00:00,279,523,Friday,18,802
10783,SBRN,2016-06-03 19:00:00,161,270,Friday,19,431
10784,SBRN,2016-06-03 20:00:00,105,152,Friday,20,257
10785,SBRN,2016-06-03 21:00:00,84,104,Friday,21,188
10786,SBRN,2016-06-03 22:00:00,63,90,Friday,22,153
10787,SBRN,2016-06-03 23:00:00,41,81,Friday,23,122
10788,SBRN,2016-06-04 00:00:00,34,67,Saturday,0,101
10789,SBRN,2016-06-04 01:00:00,3,18,Saturday,1,21
10790,SBRN,2016-06-04 05:00:00,4,4,Saturday,5,8
10791,SBRN,2016-06-04 06:00:00,20,3,Saturday,6,23
10792,SBRN,2016-06-04 07:00:00,40,56,Saturday,7,96
10793,SBRN,2016-06-04 08:00:00,73,65,Saturday,8,138
10794,SBRN,2016-06-04 09:00:00,82,82,Saturday,9,164
10795,SBRN,2016-06-04 10:00:00,91,102,Saturday,10,193
10796,SBRN,2016-06-04 11:00:00,99,84,Saturday,11,183
10797,SBRN,2016-06-04 12:00:00,103,126,Saturday,12,229
10798,SBRN,2016-06-04 13:00:00,99,136,Saturday,13,235
10799,SBRN,2016-06-04 14:00:00,118,124,Saturday,14,242
10800,SBRN,2016-06-04 15:00:00,97,136,Saturday,15,233
10801,SBRN,2016-06-04 16:00:00,107,155,Saturday,16,262
10802,SBRN,2016-06-04 17:00:00,126,123,Saturday,17,249
10803,SBRN,2016-06-04 18:00:00,118,123,Saturday,18,241
10804,SBRN,2016-06-04 19:00:00,109,101,Saturday,19,210
10805,SBRN,2016-06-04 20:00:00,98,66,Saturday,20,164
10806,SBRN,2016-06-04 21:00:00,87,73,Saturday,21,160
10807,SBRN,2016-06-04 22:00:00,72,71,Saturday,22,143
10808,SBRN,2016-06-04 23:00:00,30,59,Saturday,23,89
10809,SBRN,2016-06-05 00:00:00,32,38,Sunday,0,70
10810,SBRN,2016-06-05 01:00:00,2,12,Sunday,1,14
10811,SBRN,2016-06-05 07:00:00,2,2,Sunday,7,4
10812,SBRN,2016-06-05 08:00:00,34,9,Sunday,8,43
10813,SBRN,2016-06-05 09:00:00,58,74,Sunday,9,132
10814,SBRN,2016-06-05 10:00:00,66,67,Sunday,10,133
10815,SBRN,2016-06-05 11:00:00,64,111,Sunday,11,175
10816,SBRN,2016-06-05 12:00:00,95,101,Sunday,12,196
10817,SBRN,2016-06-05 13:00:00,78,116,Sunday,13,194
10818,SBRN,2016-06-05 14:00:00,74,118,Sunday,14,192
10819,SBRN,2016-06-05 15:00:00,93,86,Sunday,15,179
10820,SBRN,2016-06-05 16:00:00,121,112,Sunday,16,233
10821,SBRN,2016-06-05 17:00:00,112,105,Sunday,17,217
10822,SBRN,2016-06-05 18:00:00,82,67,Sunday,18,149
10823,SBRN,2016-06-05 19:00:00,83,71,Sunday,19,154
10824,SBRN,2016-06-05 20:00:00,63,64,Sunday,20,127
10825,SBRN,2016-06-05 21:00:00,48,79,Sunday,21,127
10826,SBRN,2016-06-05 22:00:00,37,43,Sunday,22,80
10827,SBRN,2016-06-05 23:00:00,16,28,Sunday,23,44
10828,SBRN,2016-06-06 00:00:00,20,12,Monday,0,32
10829,SBRN,2016-06-06 01:00:00,1,1,Monday,1,2
10830,SBRN,2016-06-06 05:00:00,58,33,Monday,5,91
10831,SBRN,2016-06-06 06:00:00,144,120,Monday,6,264
10832,SBRN,2016-06-06 07:00:00,408,221,Monday,7,629
10833,SBRN,2016-06-06 08:00:00,842,217,Monday,8,1059
10834,SBRN,2016-06-06 09:00:00,526,189,Monday,9,715
10835,SBRN,2016-06-06 10:00:00,206,91,Monday,10,297
10836,SBRN,2016-06-06 11:00:00,137,90,Monday,11,227
10837,SBRN,2016-06-06 12:00:00,102,107,Monday,12,209
10838,SBRN,2016-06-06 13:00:00,98,99,Monday,13,197
10839,SBRN,2016-06-06 14:00:00,112,131,Monday,14,243
10840,SBRN,2016-06-06 15:00:00,104,220,Monday,15,324
10841,SBRN,2016-06-06 16:00:00,192,381,Monday,16,573
10842,SBRN,2016-06-06 17:00:00,263,704,Monday,17,967
10843,SBRN,2016-06-06 18:00:00,307,677,Monday,18,984
10844,SBRN,2016-06-06 19:00:00,129,326,Monday,19,455
10845,SBRN,2016-06-06 20:00:00,72,143,Monday,20,215
10846,SBRN,2016-06-06 21:00:00,70,108,Monday,21,178
10847,SBRN,2016-06-06 22:00:00,75,117,Monday,22,192
10848,SBRN,2016-06-06 23:00:00,35,42,Monday,23,77
10849,SBRN,2016-06-07 00:00:00,13,19,Tuesday,0,32
10850,SBRN,2016-06-07 01:00:00,4,7,Tuesday,1,11
10851,SBRN,2016-06-07 05:00:00,52,40,Tuesday,5,92
10852,SBRN,2016-06-07 06:00:00,157,115,Tuesday,6,272
10853,SBRN,2016-06-07 07:00:00,422,201,Tuesday,7,623
10854,SBRN,2016-06-07 08:00:00,805,245,Tuesday,8,1050
10855,SBRN,2016-06-07 09:00:00,553,192,Tuesday,9,745
10856,SBRN,2016-06-07 10:00:00,254,127,Tuesday,10,381
10857,SBRN,2016-06-07 11:00:00,137,83,Tuesday,11,220
10858,SBRN,2016-06-07 12:00:00,155,96,Tuesday,12,251
10859,SBRN,2016-06-07 13:00:00,107,144,Tuesday,13,251
10860,SBRN,2016-06-07 14:00:00,120,145,Tuesday,14,265
10861,SBRN,2016-06-07 15:00:00,125,222,Tuesday,15,347
10862,SBRN,2016-06-07 16:00:00,177,392,Tuesday,16,569
10863,SBRN,2016-06-07 17:00:00,274,714,Tuesday,17,988
10864,SBRN,2016-06-07 18:00:00,322,674,Tuesday,18,996
10865,SBRN,2016-06-07 19:00:00,141,326,Tuesday,19,467
10866,SBRN,2016-06-07 20:00:00,75,147,Tuesday,20,222
10867,SBRN,2016-06-07 21:00:00,55,128,Tuesday,21,183
10868,SBRN,2016-06-07 22:00:00,57,96,Tuesday,22,153
10869,SBRN,2016-06-07 23:00:00,33,77,Tuesday,23,110
10870,SBRN,2016-06-08 00:00:00,20,30,Wednesday,0,50
10871,SBRN,2016-06-08 01:00:00,4,7,Wednesday,1,11
10872,SBRN,2016-06-08 05:00:00,62,39,Wednesday,5,101
10873,SBRN,2016-06-08 06:00:00,156,114,Wednesday,6,270
10874,SBRN,2016-06-08 07:00:00,395,204,Wednesday,7,599
10875,SBRN,2016-06-08 08:00:00,782,244,Wednesday,8,1026
10876,SBRN,2016-06-08 09:00:00,537,141,Wednesday,9,678
10877,SBRN,2016-06-08 10:00:00,236,110,Wednesday,10,346
10878,SBRN,2016-06-08 11:00:00,142,98,Wednesday,11,240
10879,SBRN,2016-06-08 12:00:00,89,92,Wednesday,12,181
10880,SBRN,2016-06-08 13:00:00,117,106,Wednesday,13,223
10881,SBRN,2016-06-08 14:00:00,118,144,Wednesday,14,262
10882,SBRN,2016-06-08 15:00:00,141,188,Wednesday,15,329
10883,SBRN,2016-06-08 16:00:00,166,393,Wednesday,16,559
10884,SBRN,2016-06-08 17:00:00,321,693,Wednesday,17,1014
10885,SBRN,2016-06-08 18:00:00,323,642,Wednesday,18,965
10886,SBRN,2016-06-08 19:00:00,126,298,Wednesday,19,424
10887,SBRN,2016-06-08 20:00:00,78,136,Wednesday,20,214
10888,SBRN,2016-06-08 21:00:00,72,138,Wednesday,21,210
10889,SBRN,2016-06-08 22:00:00,72,113,Wednesday,22,185
10890,SBRN,2016-06-08 23:00:00,29,82,Wednesday,23,111
10891,SBRN,2016-06-09 00:00:00,21,35,Thursday,0,56
10892,SBRN,2016-06-09 01:00:00,1,6,Thursday,1,7
10893,SBRN,2016-06-09 05:00:00,51,34,Thursday,5,85
10894,SBRN,2016-06-09 06:00:00,168,118,Thursday,6,286
10895,SBRN,2016-06-09 07:00:00,364,190,Thursday,7,554
10896,SBRN,2016-06-09 08:00:00,750,247,Thursday,8,997
10897,SBRN,2016-06-09 09:00:00,538,193,Thursday,9,731
10898,SBRN,2016-06-09 10:00:00,255,88,Thursday,10,343
10899,SBRN,2016-06-09 11:00:00,138,96,Thursday,11,234
10900,SBRN,2016-06-09 12:00:00,116,118,Thursday,12,234
10901,SBRN,2016-06-09 13:00:00,108,108,Thursday,13,216
10902,SBRN,2016-06-09 14:00:00,113,161,Thursday,14,274
10903,SBRN,2016-06-09 15:00:00,137,251,Thursday,15,388
10904,SBRN,2016-06-09 16:00:00,177,359,Thursday,16,536
10905,SBRN,2016-06-09 17:00:00,329,673,Thursday,17,1002
10906,SBRN,2016-06-09 18:00:00,283,551,Thursday,18,834
10907,SBRN,2016-06-09 19:00:00,136,361,Thursday,19,497
10908,SBRN,2016-06-09 20:00:00,76,149,Thursday,20,225
10909,SBRN,2016-06-09 21:00:00,82,125,Thursday,21,207
10910,SBRN,2016-06-09 22:00:00,65,125,Thursday,22,190
10911,SBRN,2016-06-09 23:00:00,33,89,Thursday,23,122
10912,SBRN,2016-06-10 00:00:00,33,29,Friday,0,62
10913,SBRN,2016-06-10 05:00:00,46,36,Friday,5,82
10914,SBRN,2016-06-10 06:00:00,111,109,Friday,6,220
10915,SBRN,2016-06-10 07:00:00,374,185,Friday,7,559
10916,SBRN,2016-06-10 08:00:00,688,226,Friday,8,914
10917,SBRN,2016-06-10 09:00:00,425,132,Friday,9,557
10918,SBRN,2016-06-10 10:00:00,199,104,Friday,10,303
10919,SBRN,2016-06-10 11:00:00,142,96,Friday,11,238
10920,SBRN,2016-06-10 12:00:00,96,144,Friday,12,240
10921,SBRN,2016-06-10 13:00:00,138,127,Friday,13,265
10922,SBRN,2016-06-10 14:00:00,146,187,Friday,14,333
10923,SBRN,2016-06-10 15:00:00,154,224,Friday,15,378
10924,SBRN,2016-06-10 16:00:00,215,415,Friday,16,630
10925,SBRN,2016-06-10 17:00:00,364,635,Friday,17,999
10926,SBRN,2016-06-10 18:00:00,290,498,Friday,18,788
10927,SBRN,2016-06-10 19:00:00,160,216,Friday,19,376
10928,SBRN,2016-06-10 20:00:00,82,124,Friday,20,206
10929,SBRN,2016-06-10 21:00:00,101,99,Friday,21,200
10930,SBRN,2016-06-10 22:00:00,69,133,Friday,22,202
10931,SBRN,2016-06-10 23:00:00,40,93,Friday,23,133
10932,SBRN,2016-06-11 00:00:00,18,51,Saturday,0,69
10933,SBRN,2016-06-11 01:00:00,3,11,Saturday,1,14
10934,SBRN,2016-06-11 05:00:00,1,1,Saturday,5,2
10935,SBRN,2016-06-11 06:00:00,16,10,Saturday,6,26
10936,SBRN,2016-06-11 07:00:00,50,62,Saturday,7,112
10937,SBRN,2016-06-11 08:00:00,68,91,Saturday,8,159
10938,SBRN,2016-06-11 09:00:00,83,58,Saturday,9,141
10939,SBRN,2016-06-11 10:00:00,80,69,Saturday,10,149
10940,SBRN,2016-06-11 11:00:00,109,115,Saturday,11,224
10941,SBRN,2016-06-11 12:00:00,112,106,Saturday,12,218
10942,SBRN,2016-06-11 13:00:00,119,139,Saturday,13,258
10943,SBRN,2016-06-11 14:00:00,157,125,Saturday,14,282
10944,SBRN,2016-06-11 15:00:00,156,165,Saturday,15,321
10945,SBRN,2016-06-11 16:00:00,105,127,Saturday,16,232
10946,SBRN,2016-06-11 17:00:00,140,121,Saturday,17,261
10947,SBRN,2016-06-11 18:00:00,153,163,Saturday,18,316
10948,SBRN,2016-06-11 19:00:00,131,119,Saturday,19,250
10949,SBRN,2016-06-11 20:00:00,83,85,Saturday,20,168
10950,SBRN,2016-06-11 21:00:00,91,86,Saturday,21,177
10951,SBRN,2016-06-11 22:00:00,94,69,Saturday,22,163
10952,SBRN,2016-06-11 23:00:00,37,71,Saturday,23,108
10953,SBRN,2016-06-12 00:00:00,25,49,Sunday,0,74
10954,SBRN,2016-06-12 01:00:00,1,13,Sunday,1,14
10955,SBRN,2016-06-12 07:00:00,4,4,Sunday,7,8
10956,SBRN,2016-06-12 08:00:00,41,5,Sunday,8,46
10957,SBRN,2016-06-12 09:00:00,70,77,Sunday,9,147
10958,SBRN,2016-06-12 10:00:00,80,71,Sunday,10,151
10959,SBRN,2016-06-12 11:00:00,86,94,Sunday,11,180
10960,SBRN,2016-06-12 12:00:00,99,112,Sunday,12,211
10961,SBRN,2016-06-12 13:00:00,118,92,Sunday,13,210
10962,SBRN,2016-06-12 14:00:00,91,107,Sunday,14,198
10963,SBRN,2016-06-12 15:00:00,76,133,Sunday,15,209
10964,SBRN,2016-06-12 16:00:00,110,62,Sunday,16,172
10965,SBRN,2016-06-12 17:00:00,98,116,Sunday,17,214
10966,SBRN,2016-06-12 18:00:00,114,121,Sunday,18,235
10967,SBRN,2016-06-12 19:00:00,119,94,Sunday,19,213
10968,SBRN,2016-06-12 20:00:00,88,73,Sunday,20,161
10969,SBRN,2016-06-12 21:00:00,43,47,Sunday,21,90
10970,SBRN,2016-06-12 22:00:00,39,71,Sunday,22,110
10971,SBRN,2016-06-12 23:00:00,24,28,Sunday,23,52
10972,SBRN,2016-06-13 00:00:00,16,40,Monday,0,56
10973,SBRN,2016-06-13 01:00:00,2,19,Monday,1,21
10974,SBRN,2016-06-13 04:00:00,12,1,Monday,4,13
10975,SBRN,2016-06-13 05:00:00,45,30,Monday,5,75
10976,SBRN,2016-06-13 06:00:00,147,97,Monday,6,244
10977,SBRN,2016-06-13 07:00:00,401,194,Monday,7,595
10978,SBRN,2016-06-13 08:00:00,786,258,Monday,8,1044
10979,SBRN,2016-06-13 09:00:00,499,173,Monday,9,672
10980,SBRN,2016-06-13 10:00:00,217,112,Monday,10,329
10981,SBRN,2016-06-13 11:00:00,114,80,Monday,11,194
10982,SBRN,2016-06-13 12:00:00,99,118,Monday,12,217
10983,SBRN,2016-06-13 13:00:00,110,101,Monday,13,211
10984,SBRN,2016-06-13 14:00:00,109,146,Monday,14,255
10985,SBRN,2016-06-13 15:00:00,130,217,Monday,15,347
10986,SBRN,2016-06-13 16:00:00,189,380,Monday,16,569
10987,SBRN,2016-06-13 17:00:00,322,725,Monday,17,1047
10988,SBRN,2016-06-13 18:00:00,319,632,Monday,18,951
10989,SBRN,2016-06-13 19:00:00,106,261,Monday,19,367
10990,SBRN,2016-06-13 20:00:00,59,126,Monday,20,185
10991,SBRN,2016-06-13 21:00:00,58,103,Monday,21,161
10992,SBRN,2016-06-13 22:00:00,76,129,Monday,22,205
10993,SBRN,2016-06-13 23:00:00,40,76,Monday,23,116
10994,SBRN,2016-06-14 00:00:00,19,29,Tuesday,0,48
10995,SBRN,2016-06-14 01:00:00,2,7,Tuesday,1,9
10996,SBRN,2016-06-14 04:00:00,12,1,Tuesday,4,13
10997,SBRN,2016-06-14 05:00:00,62,40,Tuesday,5,102
10998,SBRN,2016-06-14 06:00:00,149,106,Tuesday,6,255
10999,SBRN,2016-06-14 07:00:00,388,194,Tuesday,7,582
11000,SBRN,2016-06-14 08:00:00,792,289,Tuesday,8,1081
11001,SBRN,2016-06-14 09:00:00,527,158,Tuesday,9,685
11002,SBRN,2016-06-14 10:00:00,259,117,Tuesday,10,376
11003,SBRN,2016-06-14 11:00:00,146,78,Tuesday,11,224
11004,SBRN,2016-06-14 12:00:00,111,118,Tuesday,12,229
11005,SBRN,2016-06-14 13:00:00,120,109,Tuesday,13,229
11006,SBRN,2016-06-14 14:00:00,120,166,Tuesday,14,286
11007,SBRN,2016-06-14 15:00:00,132,222,Tuesday,15,354
11008,SBRN,2016-06-14 16:00:00,180,343,Tuesday,16,523
11009,SBRN,2016-06-14 17:00:00,275,742,Tuesday,17,1017
11010,SBRN,2016-06-14 18:00:00,300,701,Tuesday,18,1001
11011,SBRN,2016-06-14 19:00:00,143,341,Tuesday,19,484
11012,SBRN,2016-06-14 20:00:00,96,138,Tuesday,20,234
11013,SBRN,2016-06-14 21:00:00,63,107,Tuesday,21,170
11014,SBRN,2016-06-14 22:00:00,77,99,Tuesday,22,176
11015,SBRN,2016-06-14 23:00:00,41,68,Tuesday,23,109
11016,SFIA,2016-06-01 01:00:00,38,2,Wednesday,1,40
11017,SFIA,2016-06-01 04:00:00,2,4,Wednesday,4,6
11018,SFIA,2016-06-01 05:00:00,24,229,Wednesday,5,253
11019,SFIA,2016-06-01 06:00:00,32,288,Wednesday,6,320
11020,SFIA,2016-06-01 07:00:00,58,600,Wednesday,7,658
11021,SFIA,2016-06-01 08:00:00,188,491,Wednesday,8,679
11022,SFIA,2016-06-01 09:00:00,342,613,Wednesday,9,955
11023,SFIA,2016-06-01 10:00:00,431,386,Wednesday,10,817
11024,SFIA,2016-06-01 11:00:00,468,426,Wednesday,11,894
11025,SFIA,2016-06-01 12:00:00,533,413,Wednesday,12,946
11026,SFIA,2016-06-01 13:00:00,535,339,Wednesday,13,874
11027,SFIA,2016-06-01 14:00:00,488,382,Wednesday,14,870
11028,SFIA,2016-06-01 15:00:00,489,306,Wednesday,15,795
11029,SFIA,2016-06-01 16:00:00,586,330,Wednesday,16,916
11030,SFIA,2016-06-01 17:00:00,689,413,Wednesday,17,1102
11031,SFIA,2016-06-01 18:00:00,619,290,Wednesday,18,909
11032,SFIA,2016-06-01 19:00:00,532,280,Wednesday,19,812
11033,SFIA,2016-06-01 20:00:00,427,236,Wednesday,20,663
11034,SFIA,2016-06-01 21:00:00,375,250,Wednesday,21,625
11035,SFIA,2016-06-01 22:00:00,338,143,Wednesday,22,481
11036,SFIA,2016-06-01 23:00:00,273,50,Wednesday,23,323
11037,SFIA,2016-06-02 00:00:00,183,6,Thursday,0,189
11038,SFIA,2016-06-02 01:00:00,18,4,Thursday,1,22
11039,SFIA,2016-06-02 04:00:00,4,6,Thursday,4,10
11040,SFIA,2016-06-02 05:00:00,32,200,Thursday,5,232
11041,SFIA,2016-06-02 06:00:00,35,278,Thursday,6,313
11042,SFIA,2016-06-02 07:00:00,49,597,Thursday,7,646
11043,SFIA,2016-06-02 08:00:00,128,481,Thursday,8,609
11044,SFIA,2016-06-02 09:00:00,269,551,Thursday,9,820
11045,SFIA,2016-06-02 10:00:00,293,496,Thursday,10,789
11046,SFIA,2016-06-02 11:00:00,487,452,Thursday,11,939
11047,SFIA,2016-06-02 12:00:00,470,404,Thursday,12,874
11048,SFIA,2016-06-02 13:00:00,505,304,Thursday,13,809
11049,SFIA,2016-06-02 14:00:00,568,343,Thursday,14,911
11050,SFIA,2016-06-02 15:00:00,578,383,Thursday,15,961
11051,SFIA,2016-06-02 16:00:00,534,401,Thursday,16,935
11052,SFIA,2016-06-02 17:00:00,553,488,Thursday,17,1041
11053,SFIA,2016-06-02 18:00:00,636,488,Thursday,18,1124
11054,SFIA,2016-06-02 19:00:00,456,312,Thursday,19,768
11055,SFIA,2016-06-02 20:00:00,414,331,Thursday,20,745
11056,SFIA,2016-06-02 21:00:00,385,262,Thursday,21,647
11057,SFIA,2016-06-02 22:00:00,304,166,Thursday,22,470
11058,SFIA,2016-06-02 23:00:00,216,62,Thursday,23,278
11059,SFIA,2016-06-03 00:00:00,183,17,Friday,0,200
11060,SFIA,2016-06-03 01:00:00,34,6,Friday,1,40
11061,SFIA,2016-06-03 04:00:00,10,10,Friday,4,20
11062,SFIA,2016-06-03 05:00:00,40,232,Friday,5,272
11063,SFIA,2016-06-03 06:00:00,28,343,Friday,6,371
11064,SFIA,2016-06-03 07:00:00,62,453,Friday,7,515
11065,SFIA,2016-06-03 08:00:00,155,488,Friday,8,643
11066,SFIA,2016-06-03 09:00:00,341,534,Friday,9,875
11067,SFIA,2016-06-03 10:00:00,468,457,Friday,10,925
11068,SFIA,2016-06-03 11:00:00,547,452,Friday,11,999
11069,SFIA,2016-06-03 12:00:00,482,409,Friday,12,891
11070,SFIA,2016-06-03 13:00:00,486,408,Friday,13,894
11071,SFIA,2016-06-03 14:00:00,640,523,Friday,14,1163
11072,SFIA,2016-06-03 15:00:00,615,507,Friday,15,1122
11073,SFIA,2016-06-03 16:00:00,672,580,Friday,16,1252
11074,SFIA,2016-06-03 17:00:00,585,690,Friday,17,1275
11075,SFIA,2016-06-03 18:00:00,656,643,Friday,18,1299
11076,SFIA,2016-06-03 19:00:00,583,402,Friday,19,985
11077,SFIA,2016-06-03 20:00:00,390,355,Friday,20,745
11078,SFIA,2016-06-03 21:00:00,421,285,Friday,21,706
11079,SFIA,2016-06-03 22:00:00,321,187,Friday,22,508
11080,SFIA,2016-06-03 23:00:00,311,70,Friday,23,381
11081,SFIA,2016-06-04 00:00:00,184,21,Saturday,0,205
11082,SFIA,2016-06-04 01:00:00,21,16,Saturday,1,37
11083,SFIA,2016-06-04 05:00:00,3,2,Saturday,5,5
11084,SFIA,2016-06-04 06:00:00,21,20,Saturday,6,41
11085,SFIA,2016-06-04 07:00:00,58,328,Saturday,7,386
11086,SFIA,2016-06-04 08:00:00,113,305,Saturday,8,418
11087,SFIA,2016-06-04 09:00:00,289,407,Saturday,9,696
11088,SFIA,2016-06-04 10:00:00,391,395,Saturday,10,786
11089,SFIA,2016-06-04 11:00:00,465,386,Saturday,11,851
11090,SFIA,2016-06-04 12:00:00,448,369,Saturday,12,817
11091,SFIA,2016-06-04 13:00:00,498,319,Saturday,13,817
11092,SFIA,2016-06-04 14:00:00,564,343,Saturday,14,907
11093,SFIA,2016-06-04 15:00:00,486,302,Saturday,15,788
11094,SFIA,2016-06-04 16:00:00,503,305,Saturday,16,808
11095,SFIA,2016-06-04 17:00:00,404,234,Saturday,17,638
11096,SFIA,2016-06-04 18:00:00,452,217,Saturday,18,669
11097,SFIA,2016-06-04 19:00:00,421,230,Saturday,19,651
11098,SFIA,2016-06-04 20:00:00,350,193,Saturday,20,543
11099,SFIA,2016-06-04 21:00:00,277,180,Saturday,21,457
11100,SFIA,2016-06-04 22:00:00,299,98,Saturday,22,397
11101,SFIA,2016-06-04 23:00:00,248,50,Saturday,23,298
11102,SFIA,2016-06-05 00:00:00,132,9,Sunday,0,141
11103,SFIA,2016-06-05 01:00:00,31,9,Sunday,1,40
11104,SFIA,2016-06-05 07:00:00,1,1,Sunday,7,2
11105,SFIA,2016-06-05 08:00:00,101,21,Sunday,8,122
11106,SFIA,2016-06-05 09:00:00,231,488,Sunday,9,719
11107,SFIA,2016-06-05 10:00:00,331,358,Sunday,10,689
11108,SFIA,2016-06-05 11:00:00,517,360,Sunday,11,877
11109,SFIA,2016-06-05 12:00:00,563,342,Sunday,12,905
11110,SFIA,2016-06-05 13:00:00,566,376,Sunday,13,942
11111,SFIA,2016-06-05 14:00:00,506,314,Sunday,14,820
11112,SFIA,2016-06-05 15:00:00,553,271,Sunday,15,824
11113,SFIA,2016-06-05 16:00:00,480,340,Sunday,16,820
11114,SFIA,2016-06-05 17:00:00,453,408,Sunday,17,861
11115,SFIA,2016-06-05 18:00:00,527,346,Sunday,18,873
11116,SFIA,2016-06-05 19:00:00,431,289,Sunday,19,720
11117,SFIA,2016-06-05 20:00:00,383,264,Sunday,20,647
11118,SFIA,2016-06-05 21:00:00,402,213,Sunday,21,615
11119,SFIA,2016-06-05 22:00:00,282,112,Sunday,22,394
11120,SFIA,2016-06-05 23:00:00,249,45,Sunday,23,294
11121,SFIA,2016-06-06 00:00:00,183,8,Monday,0,191
11122,SFIA,2016-06-06 01:00:00,26,12,Monday,1,38
11123,SFIA,2016-06-06 04:00:00,11,9,Monday,4,20
11124,SFIA,2016-06-06 05:00:00,20,187,Monday,5,207
11125,SFIA,2016-06-06 06:00:00,30,348,Monday,6,378
11126,SFIA,2016-06-06 07:00:00,71,484,Monday,7,555
11127,SFIA,2016-06-06 08:00:00,257,445,Monday,8,702
11128,SFIA,2016-06-06 09:00:00,525,624,Monday,9,1149
11129,SFIA,2016-06-06 10:00:00,391,517,Monday,10,908
11130,SFIA,2016-06-06 11:00:00,640,491,Monday,11,1131
11131,SFIA,2016-06-06 12:00:00,491,338,Monday,12,829
11132,SFIA,2016-06-06 13:00:00,546,401,Monday,13,947
11133,SFIA,2016-06-06 14:00:00,508,299,Monday,14,807
11134,SFIA,2016-06-06 15:00:00,538,328,Monday,15,866
11135,SFIA,2016-06-06 16:00:00,593,384,Monday,16,977
11136,SFIA,2016-06-06 17:00:00,547,264,Monday,17,811
11137,SFIA,2016-06-06 18:00:00,711,304,Monday,18,1015
11138,SFIA,2016-06-06 19:00:00,513,299,Monday,19,812
11139,SFIA,2016-06-06 20:00:00,406,153,Monday,20,559
11140,SFIA,2016-06-06 21:00:00,394,196,Monday,21,590
11141,SFIA,2016-06-06 22:00:00,316,98,Monday,22,414
11142,SFIA,2016-06-06 23:00:00,327,56,Monday,23,383
11143,SFIA,2016-06-07 00:00:00,195,14,Tuesday,0,209
11144,SFIA,2016-06-07 01:00:00,18,3,Tuesday,1,21
11145,SFIA,2016-06-07 04:00:00,10,2,Tuesday,4,12
11146,SFIA,2016-06-07 05:00:00,26,156,Tuesday,5,182
11147,SFIA,2016-06-07 06:00:00,33,308,Tuesday,6,341
11148,SFIA,2016-06-07 07:00:00,61,523,Tuesday,7,584
11149,SFIA,2016-06-07 08:00:00,220,446,Tuesday,8,666
11150,SFIA,2016-06-07 09:00:00,322,541,Tuesday,9,863
11151,SFIA,2016-06-07 10:00:00,382,422,Tuesday,10,804
11152,SFIA,2016-06-07 11:00:00,399,396,Tuesday,11,795
11153,SFIA,2016-06-07 12:00:00,389,304,Tuesday,12,693
11154,SFIA,2016-06-07 13:00:00,478,324,Tuesday,13,802
11155,SFIA,2016-06-07 14:00:00,518,330,Tuesday,14,848
11156,SFIA,2016-06-07 15:00:00,538,386,Tuesday,15,924
11157,SFIA,2016-06-07 16:00:00,517,256,Tuesday,16,773
11158,SFIA,2016-06-07 17:00:00,488,437,Tuesday,17,925
11159,SFIA,2016-06-07 18:00:00,581,296,Tuesday,18,877
11160,SFIA,2016-06-07 19:00:00,371,303,Tuesday,19,674
11161,SFIA,2016-06-07 20:00:00,353,198,Tuesday,20,551
11162,SFIA,2016-06-07 21:00:00,331,186,Tuesday,21,517
11163,SFIA,2016-06-07 22:00:00,264,151,Tuesday,22,415
11164,SFIA,2016-06-07 23:00:00,250,68,Tuesday,23,318
11165,SFIA,2016-06-08 00:00:00,146,19,Wednesday,0,165
11166,SFIA,2016-06-08 01:00:00,29,8,Wednesday,1,37
11167,SFIA,2016-06-08 04:00:00,5,2,Wednesday,4,7
11168,SFIA,2016-06-08 05:00:00,34,181,Wednesday,5,215
11169,SFIA,2016-06-08 06:00:00,27,354,Wednesday,6,381
11170,SFIA,2016-06-08 07:00:00,58,449,Wednesday,7,507
11171,SFIA,2016-06-08 08:00:00,198,427,Wednesday,8,625
11172,SFIA,2016-06-08 09:00:00,320,506,Wednesday,9,826
11173,SFIA,2016-06-08 10:00:00,272,445,Wednesday,10,717
11174,SFIA,2016-06-08 11:00:00,371,438,Wednesday,11,809
11175,SFIA,2016-06-08 12:00:00,372,305,Wednesday,12,677
11176,SFIA,2016-06-08 13:00:00,452,311,Wednesday,13,763
11177,SFIA,2016-06-08 14:00:00,392,488,Wednesday,14,880
11178,SFIA,2016-06-08 15:00:00,540,330,Wednesday,15,870
11179,SFIA,2016-06-08 16:00:00,642,487,Wednesday,16,1129
11180,SFIA,2016-06-08 17:00:00,533,462,Wednesday,17,995
11181,SFIA,2016-06-08 18:00:00,650,445,Wednesday,18,1095
11182,SFIA,2016-06-08 19:00:00,503,337,Wednesday,19,840
11183,SFIA,2016-06-08 20:00:00,317,217,Wednesday,20,534
11184,SFIA,2016-06-08 21:00:00,321,208,Wednesday,21,529
11185,SFIA,2016-06-08 22:00:00,257,127,Wednesday,22,384
11186,SFIA,2016-06-08 23:00:00,229,77,Wednesday,23,306
11187,SFIA,2016-06-09 00:00:00,136,14,Thursday,0,150
11188,SFIA,2016-06-09 01:00:00,31,11,Thursday,1,42
11189,SFIA,2016-06-09 04:00:00,8,5,Thursday,4,13
11190,SFIA,2016-06-09 05:00:00,23,216,Thursday,5,239
11191,SFIA,2016-06-09 06:00:00,22,329,Thursday,6,351
11192,SFIA,2016-06-09 07:00:00,56,525,Thursday,7,581
11193,SFIA,2016-06-09 08:00:00,174,501,Thursday,8,675
11194,SFIA,2016-06-09 09:00:00,319,564,Thursday,9,883
11195,SFIA,2016-06-09 10:00:00,363,522,Thursday,10,885
11196,SFIA,2016-06-09 11:00:00,431,484,Thursday,11,915
11197,SFIA,2016-06-09 12:00:00,392,421,Thursday,12,813
11198,SFIA,2016-06-09 13:00:00,395,432,Thursday,13,827
11199,SFIA,2016-06-09 14:00:00,543,434,Thursday,14,977
11200,SFIA,2016-06-09 15:00:00,525,480,Thursday,15,1005
11201,SFIA,2016-06-09 16:00:00,611,563,Thursday,16,1174
11202,SFIA,2016-06-09 17:00:00,762,626,Thursday,17,1388
11203,SFIA,2016-06-09 18:00:00,637,541,Thursday,18,1178
11204,SFIA,2016-06-09 19:00:00,483,496,Thursday,19,979
11205,SFIA,2016-06-09 20:00:00,394,259,Thursday,20,653
11206,SFIA,2016-06-09 21:00:00,414,235,Thursday,21,649
11207,SFIA,2016-06-09 22:00:00,362,165,Thursday,22,527
11208,SFIA,2016-06-09 23:00:00,284,66,Thursday,23,350
11209,SFIA,2016-06-10 00:00:00,144,21,Friday,0,165
11210,SFIA,2016-06-10 01:00:00,21,9,Friday,1,30
11211,SFIA,2016-06-10 04:00:00,9,6,Friday,4,15
11212,SFIA,2016-06-10 05:00:00,15,177,Friday,5,192
11213,SFIA,2016-06-10 06:00:00,29,364,Friday,6,393
11214,SFIA,2016-06-10 07:00:00,57,562,Friday,7,619
11215,SFIA,2016-06-10 08:00:00,180,525,Friday,8,705
11216,SFIA,2016-06-10 09:00:00,424,531,Friday,9,955
11217,SFIA,2016-06-10 10:00:00,446,591,Friday,10,1037
11218,SFIA,2016-06-10 11:00:00,481,547,Friday,11,1028
11219,SFIA,2016-06-10 12:00:00,497,481,Friday,12,978
11220,SFIA,2016-06-10 13:00:00,489,472,Friday,13,961
11221,SFIA,2016-06-10 14:00:00,554,536,Friday,14,1090
11222,SFIA,2016-06-10 15:00:00,575,493,Friday,15,1068
11223,SFIA,2016-06-10 16:00:00,688,626,Friday,16,1314
11224,SFIA,2016-06-10 17:00:00,788,700,Friday,17,1488
11225,SFIA,2016-06-10 18:00:00,680,596,Friday,18,1276
11226,SFIA,2016-06-10 19:00:00,549,544,Friday,19,1093
11227,SFIA,2016-06-10 20:00:00,425,279,Friday,20,704
11228,SFIA,2016-06-10 21:00:00,315,272,Friday,21,587
11229,SFIA,2016-06-10 22:00:00,399,243,Friday,22,642
11230,SFIA,2016-06-10 23:00:00,325,69,Friday,23,394
11231,SFIA,2016-06-11 00:00:00,190,22,Saturday,0,212
11232,SFIA,2016-06-11 01:00:00,27,22,Saturday,1,49
11233,SFIA,2016-06-11 06:00:00,14,12,Saturday,6,26
11234,SFIA,2016-06-11 07:00:00,63,306,Saturday,7,369
11235,SFIA,2016-06-11 08:00:00,140,346,Saturday,8,486
11236,SFIA,2016-06-11 09:00:00,280,416,Saturday,9,696
11237,SFIA,2016-06-11 10:00:00,390,421,Saturday,10,811
11238,SFIA,2016-06-11 11:00:00,514,446,Saturday,11,960
11239,SFIA,2016-06-11 12:00:00,478,325,Saturday,12,803
11240,SFIA,2016-06-11 13:00:00,475,360,Saturday,13,835
11241,SFIA,2016-06-11 14:00:00,516,328,Saturday,14,844
11242,SFIA,2016-06-11 15:00:00,442,299,Saturday,15,741
11243,SFIA,2016-06-11 16:00:00,430,295,Saturday,16,725
11244,SFIA,2016-06-11 17:00:00,408,274,Saturday,17,682
11245,SFIA,2016-06-11 18:00:00,505,279,Saturday,18,784
11246,SFIA,2016-06-11 19:00:00,413,209,Saturday,19,622
11247,SFIA,2016-06-11 20:00:00,402,192,Saturday,20,594
11248,SFIA,2016-06-11 21:00:00,279,205,Saturday,21,484
11249,SFIA,2016-06-11 22:00:00,280,144,Saturday,22,424
11250,SFIA,2016-06-11 23:00:00,208,74,Saturday,23,282
11251,SFIA,2016-06-12 00:00:00,124,35,Sunday,0,159
11252,SFIA,2016-06-12 01:00:00,17,10,Sunday,1,27
11253,SFIA,2016-06-12 08:00:00,97,19,Sunday,8,116
11254,SFIA,2016-06-12 09:00:00,319,539,Sunday,9,858
11255,SFIA,2016-06-12 10:00:00,341,326,Sunday,10,667
11256,SFIA,2016-06-12 11:00:00,482,425,Sunday,11,907
11257,SFIA,2016-06-12 12:00:00,691,329,Sunday,12,1020
11258,SFIA,2016-06-12 13:00:00,559,332,Sunday,13,891
11259,SFIA,2016-06-12 14:00:00,518,374,Sunday,14,892
11260,SFIA,2016-06-12 15:00:00,537,288,Sunday,15,825
11261,SFIA,2016-06-12 16:00:00,525,282,Sunday,16,807
11262,SFIA,2016-06-12 17:00:00,459,338,Sunday,17,797
11263,SFIA,2016-06-12 18:00:00,490,347,Sunday,18,837
11264,SFIA,2016-06-12 19:00:00,438,283,Sunday,19,721
11265,SFIA,2016-06-12 20:00:00,438,290,Sunday,20,728
11266,SFIA,2016-06-12 21:00:00,456,189,Sunday,21,645
11267,SFIA,2016-06-12 22:00:00,439,141,Sunday,22,580
11268,SFIA,2016-06-12 23:00:00,373,51,Sunday,23,424
11269,SFIA,2016-06-13 00:00:00,214,17,Monday,0,231
11270,SFIA,2016-06-13 01:00:00,22,13,Monday,1,35
11271,SFIA,2016-06-13 04:00:00,5,4,Monday,4,9
11272,SFIA,2016-06-13 05:00:00,19,193,Monday,5,212
11273,SFIA,2016-06-13 06:00:00,36,286,Monday,6,322
11274,SFIA,2016-06-13 07:00:00,85,543,Monday,7,628
11275,SFIA,2016-06-13 08:00:00,353,580,Monday,8,933
11276,SFIA,2016-06-13 09:00:00,548,684,Monday,9,1232
11277,SFIA,2016-06-13 10:00:00,417,500,Monday,10,917
11278,SFIA,2016-06-13 11:00:00,539,516,Monday,11,1055
11279,SFIA,2016-06-13 12:00:00,527,379,Monday,12,906
11280,SFIA,2016-06-13 13:00:00,598,344,Monday,13,942
11281,SFIA,2016-06-13 14:00:00,524,383,Monday,14,907
11282,SFIA,2016-06-13 15:00:00,559,405,Monday,15,964
11283,SFIA,2016-06-13 16:00:00,683,424,Monday,16,1107
11284,SFIA,2016-06-13 17:00:00,610,396,Monday,17,1006
11285,SFIA,2016-06-13 18:00:00,731,369,Monday,18,1100
11286,SFIA,2016-06-13 19:00:00,580,381,Monday,19,961
11287,SFIA,2016-06-13 20:00:00,378,210,Monday,20,588
11288,SFIA,2016-06-13 21:00:00,373,188,Monday,21,561
11289,SFIA,2016-06-13 22:00:00,378,176,Monday,22,554
11290,SFIA,2016-06-13 23:00:00,325,58,Monday,23,383
11291,SFIA,2016-06-14 00:00:00,210,12,Tuesday,0,222
11292,SFIA,2016-06-14 01:00:00,22,6,Tuesday,1,28
11293,SFIA,2016-06-14 04:00:00,8,6,Tuesday,4,14
11294,SFIA,2016-06-14 05:00:00,29,200,Tuesday,5,229
11295,SFIA,2016-06-14 06:00:00,29,316,Tuesday,6,345
11296,SFIA,2016-06-14 07:00:00,53,420,Tuesday,7,473
11297,SFIA,2016-06-14 08:00:00,165,598,Tuesday,8,763
11298,SFIA,2016-06-14 09:00:00,370,609,Tuesday,9,979
11299,SFIA,2016-06-14 10:00:00,355,553,Tuesday,10,908
11300,SFIA,2016-06-14 11:00:00,437,470,Tuesday,11,907
11301,SFIA,2016-06-14 12:00:00,438,422,Tuesday,12,860
11302,SFIA,2016-06-14 13:00:00,413,463,Tuesday,13,876
11303,SFIA,2016-06-14 14:00:00,476,392,Tuesday,14,868
11304,SFIA,2016-06-14 15:00:00,482,340,Tuesday,15,822
11305,SFIA,2016-06-14 16:00:00,647,347,Tuesday,16,994
11306,SFIA,2016-06-14 17:00:00,605,390,Tuesday,17,995
11307,SFIA,2016-06-14 18:00:00,544,287,Tuesday,18,831
11308,SFIA,2016-06-14 19:00:00,418,305,Tuesday,19,723
11309,SFIA,2016-06-14 20:00:00,319,223,Tuesday,20,542
11310,SFIA,2016-06-14 21:00:00,271,243,Tuesday,21,514
11311,SFIA,2016-06-14 22:00:00,347,172,Tuesday,22,519
11312,SFIA,2016-06-14 23:00:00,269,65,Tuesday,23,334
11313,SHAY,2016-06-01 01:00:00,1,7,Wednesday,1,8
11314,SHAY,2016-06-01 05:00:00,99,39,Wednesday,5,138
11315,SHAY,2016-06-01 06:00:00,324,81,Wednesday,6,405
11316,SHAY,2016-06-01 07:00:00,636,103,Wednesday,7,739
11317,SHAY,2016-06-01 08:00:00,714,57,Wednesday,8,771
11318,SHAY,2016-06-01 09:00:00,395,74,Wednesday,9,469
11319,SHAY,2016-06-01 10:00:00,158,44,Wednesday,10,202
11320,SHAY,2016-06-01 11:00:00,124,50,Wednesday,11,174
11321,SHAY,2016-06-01 12:00:00,96,73,Wednesday,12,169
11322,SHAY,2016-06-01 13:00:00,86,75,Wednesday,13,161
11323,SHAY,2016-06-01 14:00:00,90,114,Wednesday,14,204
11324,SHAY,2016-06-01 15:00:00,99,210,Wednesday,15,309
11325,SHAY,2016-06-01 16:00:00,96,415,Wednesday,16,511
11326,SHAY,2016-06-01 17:00:00,130,488,Wednesday,17,618
11327,SHAY,2016-06-01 18:00:00,94,707,Wednesday,18,801
11328,SHAY,2016-06-01 19:00:00,53,276,Wednesday,19,329
11329,SHAY,2016-06-01 20:00:00,48,312,Wednesday,20,360
11330,SHAY,2016-06-01 21:00:00,36,56,Wednesday,21,92
11331,SHAY,2016-06-01 22:00:00,18,111,Wednesday,22,129
11332,SHAY,2016-06-01 23:00:00,14,49,Wednesday,23,63
11333,SHAY,2016-06-02 00:00:00,6,24,Thursday,0,30
11334,SHAY,2016-06-02 01:00:00,2,4,Thursday,1,6
11335,SHAY,2016-06-02 05:00:00,98,38,Thursday,5,136
11336,SHAY,2016-06-02 06:00:00,289,67,Thursday,6,356
11337,SHAY,2016-06-02 07:00:00,664,94,Thursday,7,758
11338,SHAY,2016-06-02 08:00:00,650,67,Thursday,8,717
11339,SHAY,2016-06-02 09:00:00,430,38,Thursday,9,468
11340,SHAY,2016-06-02 10:00:00,224,40,Thursday,10,264
11341,SHAY,2016-06-02 11:00:00,100,59,Thursday,11,159
11342,SHAY,2016-06-02 12:00:00,68,54,Thursday,12,122
11343,SHAY,2016-06-02 13:00:00,76,69,Thursday,13,145
11344,SHAY,2016-06-02 14:00:00,102,156,Thursday,14,258
11345,SHAY,2016-06-02 15:00:00,89,174,Thursday,15,263
11346,SHAY,2016-06-02 16:00:00,176,254,Thursday,16,430
11347,SHAY,2016-06-02 17:00:00,168,817,Thursday,17,985
11348,SHAY,2016-06-02 18:00:00,89,524,Thursday,18,613
11349,SHAY,2016-06-02 19:00:00,77,343,Thursday,19,420
11350,SHAY,2016-06-02 20:00:00,38,124,Thursday,20,162
11351,SHAY,2016-06-02 21:00:00,36,174,Thursday,21,210
11352,SHAY,2016-06-02 22:00:00,34,76,Thursday,22,110
11353,SHAY,2016-06-02 23:00:00,20,45,Thursday,23,65
11354,SHAY,2016-06-03 00:00:00,18,34,Friday,0,52
11355,SHAY,2016-06-03 01:00:00,2,8,Friday,1,10
11356,SHAY,2016-06-03 05:00:00,88,31,Friday,5,119
11357,SHAY,2016-06-03 06:00:00,273,60,Friday,6,333
11358,SHAY,2016-06-03 07:00:00,587,84,Friday,7,671
11359,SHAY,2016-06-03 08:00:00,584,78,Friday,8,662
11360,SHAY,2016-06-03 09:00:00,322,57,Friday,9,379
11361,SHAY,2016-06-03 10:00:00,163,49,Friday,10,212
11362,SHAY,2016-06-03 11:00:00,106,59,Friday,11,165
11363,SHAY,2016-06-03 12:00:00,84,74,Friday,12,158
11364,SHAY,2016-06-03 13:00:00,74,88,Friday,13,162
11365,SHAY,2016-06-03 14:00:00,79,118,Friday,14,197
11366,SHAY,2016-06-03 15:00:00,96,189,Friday,15,285
11367,SHAY,2016-06-03 16:00:00,119,341,Friday,16,460
11368,SHAY,2016-06-03 17:00:00,118,568,Friday,17,686
11369,SHAY,2016-06-03 18:00:00,89,393,Friday,18,482
11370,SHAY,2016-06-03 19:00:00,73,206,Friday,19,279
11371,SHAY,2016-06-03 20:00:00,45,127,Friday,20,172
11372,SHAY,2016-06-03 21:00:00,34,95,Friday,21,129
11373,SHAY,2016-06-03 22:00:00,32,76,Friday,22,108
11374,SHAY,2016-06-03 23:00:00,18,66,Friday,23,84
11375,SHAY,2016-06-04 00:00:00,6,47,Saturday,0,53
11376,SHAY,2016-06-04 01:00:00,3,15,Saturday,1,18
11377,SHAY,2016-06-04 06:00:00,27,11,Saturday,6,38
11378,SHAY,2016-06-04 07:00:00,69,25,Saturday,7,94
11379,SHAY,2016-06-04 08:00:00,81,29,Saturday,8,110
11380,SHAY,2016-06-04 09:00:00,107,30,Saturday,9,137
11381,SHAY,2016-06-04 10:00:00,97,37,Saturday,10,134
11382,SHAY,2016-06-04 11:00:00,101,52,Saturday,11,153
11383,SHAY,2016-06-04 12:00:00,87,55,Saturday,12,142
11384,SHAY,2016-06-04 13:00:00,100,83,Saturday,13,183
11385,SHAY,2016-06-04 14:00:00,73,49,Saturday,14,122
11386,SHAY,2016-06-04 15:00:00,72,104,Saturday,15,176
11387,SHAY,2016-06-04 16:00:00,63,81,Saturday,16,144
11388,SHAY,2016-06-04 17:00:00,49,84,Saturday,17,133
11389,SHAY,2016-06-04 18:00:00,46,82,Saturday,18,128
11390,SHAY,2016-06-04 19:00:00,40,93,Saturday,19,133
11391,SHAY,2016-06-04 20:00:00,31,62,Saturday,20,93
11392,SHAY,2016-06-04 21:00:00,28,59,Saturday,21,87
11393,SHAY,2016-06-04 22:00:00,26,70,Saturday,22,96
11394,SHAY,2016-06-04 23:00:00,19,42,Saturday,23,61
11395,SHAY,2016-06-05 00:00:00,4,31,Sunday,0,35
11396,SHAY,2016-06-05 01:00:00,2,10,Sunday,1,12
11397,SHAY,2016-06-05 08:00:00,44,24,Sunday,8,68
11398,SHAY,2016-06-05 09:00:00,63,25,Sunday,9,88
11399,SHAY,2016-06-05 10:00:00,82,10,Sunday,10,92
11400,SHAY,2016-06-05 11:00:00,100,28,Sunday,11,128
11401,SHAY,2016-06-05 12:00:00,98,45,Sunday,12,143
11402,SHAY,2016-06-05 13:00:00,81,30,Sunday,13,111
11403,SHAY,2016-06-05 14:00:00,54,66,Sunday,14,120
11404,SHAY,2016-06-05 15:00:00,78,56,Sunday,15,134
11405,SHAY,2016-06-05 16:00:00,44,88,Sunday,16,132
11406,SHAY,2016-06-05 17:00:00,46,93,Sunday,17,139
11407,SHAY,2016-06-05 18:00:00,21,84,Sunday,18,105
11408,SHAY,2016-06-05 19:00:00,21,62,Sunday,19,83
11409,SHAY,2016-06-05 20:00:00,23,98,Sunday,20,121
11410,SHAY,2016-06-05 21:00:00,33,45,Sunday,21,78
11411,SHAY,2016-06-05 22:00:00,23,38,Sunday,22,61
11412,SHAY,2016-06-05 23:00:00,11,22,Sunday,23,33
11413,SHAY,2016-06-06 00:00:00,5,21,Monday,0,26
11414,SHAY,2016-06-06 01:00:00,1,7,Monday,1,8
11415,SHAY,2016-06-06 04:00:00,5,1,Monday,4,6
11416,SHAY,2016-06-06 05:00:00,96,27,Monday,5,123
11417,SHAY,2016-06-06 06:00:00,306,43,Monday,6,349
11418,SHAY,2016-06-06 07:00:00,606,112,Monday,7,718
11419,SHAY,2016-06-06 08:00:00,647,85,Monday,8,732
11420,SHAY,2016-06-06 09:00:00,382,35,Monday,9,417
11421,SHAY,2016-06-06 10:00:00,169,43,Monday,10,212
11422,SHAY,2016-06-06 11:00:00,104,62,Monday,11,166
11423,SHAY,2016-06-06 12:00:00,93,80,Monday,12,173
11424,SHAY,2016-06-06 13:00:00,71,80,Monday,13,151
11425,SHAY,2016-06-06 14:00:00,80,119,Monday,14,199
11426,SHAY,2016-06-06 15:00:00,67,180,Monday,15,247
11427,SHAY,2016-06-06 16:00:00,131,390,Monday,16,521
11428,SHAY,2016-06-06 17:00:00,120,653,Monday,17,773
11429,SHAY,2016-06-06 18:00:00,108,548,Monday,18,656
11430,SHAY,2016-06-06 19:00:00,42,259,Monday,19,301
11431,SHAY,2016-06-06 20:00:00,44,102,Monday,20,146
11432,SHAY,2016-06-06 21:00:00,41,98,Monday,21,139
11433,SHAY,2016-06-06 22:00:00,16,68,Monday,22,84
11434,SHAY,2016-06-06 23:00:00,13,51,Monday,23,64
11435,SHAY,2016-06-07 00:00:00,7,31,Tuesday,0,38
11436,SHAY,2016-06-07 01:00:00,2,2,Tuesday,1,4
11437,SHAY,2016-06-07 05:00:00,107,32,Tuesday,5,139
11438,SHAY,2016-06-07 06:00:00,311,73,Tuesday,6,384
11439,SHAY,2016-06-07 07:00:00,645,110,Tuesday,7,755
11440,SHAY,2016-06-07 08:00:00,711,79,Tuesday,8,790
11441,SHAY,2016-06-07 09:00:00,345,53,Tuesday,9,398
11442,SHAY,2016-06-07 10:00:00,162,49,Tuesday,10,211
11443,SHAY,2016-06-07 11:00:00,103,65,Tuesday,11,168
11444,SHAY,2016-06-07 12:00:00,92,74,Tuesday,12,166
11445,SHAY,2016-06-07 13:00:00,68,98,Tuesday,13,166
11446,SHAY,2016-06-07 14:00:00,91,105,Tuesday,14,196
11447,SHAY,2016-06-07 15:00:00,98,159,Tuesday,15,257
11448,SHAY,2016-06-07 16:00:00,125,382,Tuesday,16,507
11449,SHAY,2016-06-07 17:00:00,123,715,Tuesday,17,838
11450,SHAY,2016-06-07 18:00:00,108,539,Tuesday,18,647
11451,SHAY,2016-06-07 19:00:00,50,263,Tuesday,19,313
11452,SHAY,2016-06-07 20:00:00,48,112,Tuesday,20,160
11453,SHAY,2016-06-07 21:00:00,25,89,Tuesday,21,114
11454,SHAY,2016-06-07 22:00:00,24,58,Tuesday,22,82
11455,SHAY,2016-06-07 23:00:00,14,73,Tuesday,23,87
11456,SHAY,2016-06-08 00:00:00,4,38,Wednesday,0,42
11457,SHAY,2016-06-08 01:00:00,3,5,Wednesday,1,8
11458,SHAY,2016-06-08 05:00:00,105,37,Wednesday,5,142
11459,SHAY,2016-06-08 06:00:00,330,84,Wednesday,6,414
11460,SHAY,2016-06-08 07:00:00,611,97,Wednesday,7,708
11461,SHAY,2016-06-08 08:00:00,591,74,Wednesday,8,665
11462,SHAY,2016-06-08 09:00:00,441,54,Wednesday,9,495
11463,SHAY,2016-06-08 10:00:00,176,40,Wednesday,10,216
11464,SHAY,2016-06-08 11:00:00,107,37,Wednesday,11,144
11465,SHAY,2016-06-08 12:00:00,88,55,Wednesday,12,143
11466,SHAY,2016-06-08 13:00:00,84,96,Wednesday,13,180
11467,SHAY,2016-06-08 14:00:00,100,98,Wednesday,14,198
11468,SHAY,2016-06-08 15:00:00,107,176,Wednesday,15,283
11469,SHAY,2016-06-08 16:00:00,136,451,Wednesday,16,587
11470,SHAY,2016-06-08 17:00:00,196,672,Wednesday,17,868
11471,SHAY,2016-06-08 18:00:00,125,507,Wednesday,18,632
11472,SHAY,2016-06-08 19:00:00,64,195,Wednesday,19,259
11473,SHAY,2016-06-08 20:00:00,44,140,Wednesday,20,184
11474,SHAY,2016-06-08 21:00:00,32,209,Wednesday,21,241
11475,SHAY,2016-06-08 22:00:00,24,81,Wednesday,22,105
11476,SHAY,2016-06-08 23:00:00,17,76,Wednesday,23,93
11477,SHAY,2016-06-09 00:00:00,11,32,Thursday,0,43
11478,SHAY,2016-06-09 05:00:00,112,39,Thursday,5,151
11479,SHAY,2016-06-09 06:00:00,302,57,Thursday,6,359
11480,SHAY,2016-06-09 07:00:00,564,98,Thursday,7,662
11481,SHAY,2016-06-09 08:00:00,698,74,Thursday,8,772
11482,SHAY,2016-06-09 09:00:00,339,47,Thursday,9,386
11483,SHAY,2016-06-09 10:00:00,146,43,Thursday,10,189
11484,SHAY,2016-06-09 11:00:00,106,38,Thursday,11,144
11485,SHAY,2016-06-09 12:00:00,96,65,Thursday,12,161
11486,SHAY,2016-06-09 13:00:00,93,78,Thursday,13,171
11487,SHAY,2016-06-09 14:00:00,74,86,Thursday,14,160
11488,SHAY,2016-06-09 15:00:00,104,167,Thursday,15,271
11489,SHAY,2016-06-09 16:00:00,110,402,Thursday,16,512
11490,SHAY,2016-06-09 17:00:00,110,652,Thursday,17,762
11491,SHAY,2016-06-09 18:00:00,92,518,Thursday,18,610
11492,SHAY,2016-06-09 19:00:00,53,243,Thursday,19,296
11493,SHAY,2016-06-09 20:00:00,34,112,Thursday,20,146
11494,SHAY,2016-06-09 21:00:00,39,84,Thursday,21,123
11495,SHAY,2016-06-09 22:00:00,28,79,Thursday,22,107
11496,SHAY,2016-06-09 23:00:00,9,76,Thursday,23,85
11497,SHAY,2016-06-10 00:00:00,9,32,Friday,0,41
11498,SHAY,2016-06-10 01:00:00,2,9,Friday,1,11
11499,SHAY,2016-06-10 05:00:00,85,30,Friday,5,115
11500,SHAY,2016-06-10 06:00:00,273,77,Friday,6,350
11501,SHAY,2016-06-10 07:00:00,559,102,Friday,7,661
11502,SHAY,2016-06-10 08:00:00,560,70,Friday,8,630
11503,SHAY,2016-06-10 09:00:00,319,57,Friday,9,376
11504,SHAY,2016-06-10 10:00:00,158,40,Friday,10,198
11505,SHAY,2016-06-10 11:00:00,104,63,Friday,11,167
11506,SHAY,2016-06-10 12:00:00,91,70,Friday,12,161
11507,SHAY,2016-06-10 13:00:00,100,95,Friday,13,195
11508,SHAY,2016-06-10 14:00:00,101,121,Friday,14,222
11509,SHAY,2016-06-10 15:00:00,108,194,Friday,15,302
11510,SHAY,2016-06-10 16:00:00,128,228,Friday,16,356
11511,SHAY,2016-06-10 17:00:00,195,682,Friday,17,877
11512,SHAY,2016-06-10 18:00:00,148,398,Friday,18,546
11513,SHAY,2016-06-10 19:00:00,49,171,Friday,19,220
11514,SHAY,2016-06-10 20:00:00,32,97,Friday,20,129
11515,SHAY,2016-06-10 21:00:00,40,141,Friday,21,181
11516,SHAY,2016-06-10 22:00:00,26,121,Friday,22,147
11517,SHAY,2016-06-10 23:00:00,12,81,Friday,23,93
11518,SHAY,2016-06-11 00:00:00,9,42,Saturday,0,51
11519,SHAY,2016-06-11 01:00:00,1,15,Saturday,1,16
11520,SHAY,2016-06-11 06:00:00,26,15,Saturday,6,41
11521,SHAY,2016-06-11 07:00:00,60,41,Saturday,7,101
11522,SHAY,2016-06-11 08:00:00,84,35,Saturday,8,119
11523,SHAY,2016-06-11 09:00:00,75,14,Saturday,9,89
11524,SHAY,2016-06-11 10:00:00,86,59,Saturday,10,145
11525,SHAY,2016-06-11 11:00:00,96,85,Saturday,11,181
11526,SHAY,2016-06-11 12:00:00,78,84,Saturday,12,162
11527,SHAY,2016-06-11 13:00:00,93,73,Saturday,13,166
11528,SHAY,2016-06-11 14:00:00,89,69,Saturday,14,158
11529,SHAY,2016-06-11 15:00:00,87,86,Saturday,15,173
11530,SHAY,2016-06-11 16:00:00,90,100,Saturday,16,190
11531,SHAY,2016-06-11 17:00:00,64,124,Saturday,17,188
11532,SHAY,2016-06-11 18:00:00,56,94,Saturday,18,150
11533,SHAY,2016-06-11 19:00:00,37,135,Saturday,19,172
11534,SHAY,2016-06-11 20:00:00,33,80,Saturday,20,113
11535,SHAY,2016-06-11 21:00:00,36,72,Saturday,21,108
11536,SHAY,2016-06-11 22:00:00,29,91,Saturday,22,120
11537,SHAY,2016-06-11 23:00:00,26,64,Saturday,23,90
11538,SHAY,2016-06-12 00:00:00,8,44,Sunday,0,52
11539,SHAY,2016-06-12 01:00:00,11,15,Sunday,1,26
11540,SHAY,2016-06-12 08:00:00,39,35,Sunday,8,74
11541,SHAY,2016-06-12 09:00:00,65,39,Sunday,9,104
11542,SHAY,2016-06-12 10:00:00,65,40,Sunday,10,105
11543,SHAY,2016-06-12 11:00:00,110,41,Sunday,11,151
11544,SHAY,2016-06-12 12:00:00,88,34,Sunday,12,122
11545,SHAY,2016-06-12 13:00:00,80,53,Sunday,13,133
11546,SHAY,2016-06-12 14:00:00,56,59,Sunday,14,115
11547,SHAY,2016-06-12 15:00:00,62,73,Sunday,15,135
11548,SHAY,2016-06-12 16:00:00,42,74,Sunday,16,116
11549,SHAY,2016-06-12 17:00:00,60,75,Sunday,17,135
11550,SHAY,2016-06-12 18:00:00,44,97,Sunday,18,141
11551,SHAY,2016-06-12 19:00:00,99,69,Sunday,19,168
11552,SHAY,2016-06-12 20:00:00,33,89,Sunday,20,122
11553,SHAY,2016-06-12 21:00:00,38,55,Sunday,21,93
11554,SHAY,2016-06-12 22:00:00,16,65,Sunday,22,81
11555,SHAY,2016-06-12 23:00:00,13,26,Sunday,23,39
11556,SHAY,2016-06-13 00:00:00,6,104,Monday,0,110
11557,SHAY,2016-06-13 01:00:00,1,5,Monday,1,6
11558,SHAY,2016-06-13 04:00:00,3,2,Monday,4,5
11559,SHAY,2016-06-13 05:00:00,102,27,Monday,5,129
11560,SHAY,2016-06-13 06:00:00,285,60,Monday,6,345
11561,SHAY,2016-06-13 07:00:00,592,101,Monday,7,693
11562,SHAY,2016-06-13 08:00:00,682,70,Monday,8,752
11563,SHAY,2016-06-13 09:00:00,359,53,Monday,9,412
11564,SHAY,2016-06-13 10:00:00,154,46,Monday,10,200
11565,SHAY,2016-06-13 11:00:00,89,59,Monday,11,148
11566,SHAY,2016-06-13 12:00:00,80,54,Monday,12,134
11567,SHAY,2016-06-13 13:00:00,82,82,Monday,13,164
11568,SHAY,2016-06-13 14:00:00,64,98,Monday,14,162
11569,SHAY,2016-06-13 15:00:00,83,178,Monday,15,261
11570,SHAY,2016-06-13 16:00:00,156,410,Monday,16,566
11571,SHAY,2016-06-13 17:00:00,174,669,Monday,17,843
11572,SHAY,2016-06-13 18:00:00,128,566,Monday,18,694
11573,SHAY,2016-06-13 19:00:00,59,212,Monday,19,271
11574,SHAY,2016-06-13 20:00:00,28,88,Monday,20,116
11575,SHAY,2016-06-13 21:00:00,20,137,Monday,21,157
11576,SHAY,2016-06-13 22:00:00,19,118,Monday,22,137
11577,SHAY,2016-06-13 23:00:00,17,87,Monday,23,104
11578,SHAY,2016-06-14 00:00:00,5,29,Tuesday,0,34
11579,SHAY,2016-06-14 01:00:00,1,9,Tuesday,1,10
11580,SHAY,2016-06-14 05:00:00,120,45,Tuesday,5,165
11581,SHAY,2016-06-14 06:00:00,327,76,Tuesday,6,403
11582,SHAY,2016-06-14 07:00:00,620,92,Tuesday,7,712
11583,SHAY,2016-06-14 08:00:00,641,82,Tuesday,8,723
11584,SHAY,2016-06-14 09:00:00,431,54,Tuesday,9,485
11585,SHAY,2016-06-14 10:00:00,152,36,Tuesday,10,188
11586,SHAY,2016-06-14 11:00:00,101,44,Tuesday,11,145
11587,SHAY,2016-06-14 12:00:00,94,62,Tuesday,12,156
11588,SHAY,2016-06-14 13:00:00,101,83,Tuesday,13,184
11589,SHAY,2016-06-14 14:00:00,89,107,Tuesday,14,196
11590,SHAY,2016-06-14 15:00:00,91,180,Tuesday,15,271
11591,SHAY,2016-06-14 16:00:00,102,401,Tuesday,16,503
11592,SHAY,2016-06-14 17:00:00,122,659,Tuesday,17,781
11593,SHAY,2016-06-14 18:00:00,128,581,Tuesday,18,709
11594,SHAY,2016-06-14 19:00:00,69,254,Tuesday,19,323
11595,SHAY,2016-06-14 20:00:00,41,103,Tuesday,20,144
11596,SHAY,2016-06-14 21:00:00,23,99,Tuesday,21,122
11597,SHAY,2016-06-14 22:00:00,26,89,Tuesday,22,115
11598,SHAY,2016-06-14 23:00:00,12,80,Tuesday,23,92
11599,SSAN,2016-06-01 01:00:00,2,5,Wednesday,1,7
11600,SSAN,2016-06-01 04:00:00,8,1,Wednesday,4,9
11601,SSAN,2016-06-01 05:00:00,69,42,Wednesday,5,111
11602,SSAN,2016-06-01 06:00:00,236,110,Wednesday,6,346
11603,SSAN,2016-06-01 07:00:00,590,219,Wednesday,7,809
11604,SSAN,2016-06-01 08:00:00,961,268,Wednesday,8,1229
11605,SSAN,2016-06-01 09:00:00,535,121,Wednesday,9,656
11606,SSAN,2016-06-01 10:00:00,206,56,Wednesday,10,262
11607,SSAN,2016-06-01 11:00:00,133,35,Wednesday,11,168
11608,SSAN,2016-06-01 12:00:00,109,73,Wednesday,12,182
11609,SSAN,2016-06-01 13:00:00,84,87,Wednesday,13,171
11610,SSAN,2016-06-01 14:00:00,73,132,Wednesday,14,205
11611,SSAN,2016-06-01 15:00:00,116,178,Wednesday,15,294
11612,SSAN,2016-06-01 16:00:00,196,346,Wednesday,16,542
11613,SSAN,2016-06-01 17:00:00,295,922,Wednesday,17,1217
11614,SSAN,2016-06-01 18:00:00,294,659,Wednesday,18,953
11615,SSAN,2016-06-01 19:00:00,140,353,Wednesday,19,493
11616,SSAN,2016-06-01 20:00:00,53,165,Wednesday,20,218
11617,SSAN,2016-06-01 21:00:00,23,136,Wednesday,21,159
11618,SSAN,2016-06-01 22:00:00,15,87,Wednesday,22,102
11619,SSAN,2016-06-01 23:00:00,10,73,Wednesday,23,83
11620,SSAN,2016-06-02 00:00:00,8,18,Thursday,0,26
11621,SSAN,2016-06-02 01:00:00,3,5,Thursday,1,8
11622,SSAN,2016-06-02 04:00:00,14,1,Thursday,4,15
11623,SSAN,2016-06-02 05:00:00,60,50,Thursday,5,110
11624,SSAN,2016-06-02 06:00:00,232,123,Thursday,6,355
11625,SSAN,2016-06-02 07:00:00,543,223,Thursday,7,766
11626,SSAN,2016-06-02 08:00:00,864,230,Thursday,8,1094
11627,SSAN,2016-06-02 09:00:00,636,111,Thursday,9,747
11628,SSAN,2016-06-02 10:00:00,217,84,Thursday,10,301
11629,SSAN,2016-06-02 11:00:00,120,35,Thursday,11,155
11630,SSAN,2016-06-02 12:00:00,98,71,Thursday,12,169
11631,SSAN,2016-06-02 13:00:00,100,74,Thursday,13,174
11632,SSAN,2016-06-02 14:00:00,99,150,Thursday,14,249
11633,SSAN,2016-06-02 15:00:00,128,197,Thursday,15,325
11634,SSAN,2016-06-02 16:00:00,233,425,Thursday,16,658
11635,SSAN,2016-06-02 17:00:00,340,767,Thursday,17,1107
11636,SSAN,2016-06-02 18:00:00,283,723,Thursday,18,1006
11637,SSAN,2016-06-02 19:00:00,129,245,Thursday,19,374
11638,SSAN,2016-06-02 20:00:00,46,175,Thursday,20,221
11639,SSAN,2016-06-02 21:00:00,25,185,Thursday,21,210
11640,SSAN,2016-06-02 22:00:00,27,106,Thursday,22,133
11641,SSAN,2016-06-02 23:00:00,9,77,Thursday,23,86
11642,SSAN,2016-06-03 00:00:00,3,29,Friday,0,32
11643,SSAN,2016-06-03 01:00:00,3,7,Friday,1,10
11644,SSAN,2016-06-03 04:00:00,8,2,Friday,4,10
11645,SSAN,2016-06-03 05:00:00,66,42,Friday,5,108
11646,SSAN,2016-06-03 06:00:00,201,94,Friday,6,295
11647,SSAN,2016-06-03 07:00:00,510,220,Friday,7,730
11648,SSAN,2016-06-03 08:00:00,874,185,Friday,8,1059
11649,SSAN,2016-06-03 09:00:00,438,112,Friday,9,550
11650,SSAN,2016-06-03 10:00:00,226,64,Friday,10,290
11651,SSAN,2016-06-03 11:00:00,147,52,Friday,11,199
11652,SSAN,2016-06-03 12:00:00,105,67,Friday,12,172
11653,SSAN,2016-06-03 13:00:00,96,106,Friday,13,202
11654,SSAN,2016-06-03 14:00:00,102,135,Friday,14,237
11655,SSAN,2016-06-03 15:00:00,138,226,Friday,15,364
11656,SSAN,2016-06-03 16:00:00,162,365,Friday,16,527
11657,SSAN,2016-06-03 17:00:00,255,682,Friday,17,937
11658,SSAN,2016-06-03 18:00:00,247,599,Friday,18,846
11659,SSAN,2016-06-03 19:00:00,126,287,Friday,19,413
11660,SSAN,2016-06-03 20:00:00,46,173,Friday,20,219
11661,SSAN,2016-06-03 21:00:00,35,119,Friday,21,154
11662,SSAN,2016-06-03 22:00:00,23,86,Friday,22,109
11663,SSAN,2016-06-03 23:00:00,13,87,Friday,23,100
11664,SSAN,2016-06-04 00:00:00,12,43,Saturday,0,55
11665,SSAN,2016-06-04 01:00:00,2,25,Saturday,1,27
11666,SSAN,2016-06-04 06:00:00,14,1,Saturday,6,15
11667,SSAN,2016-06-04 07:00:00,71,36,Saturday,7,107
11668,SSAN,2016-06-04 08:00:00,77,31,Saturday,8,108
11669,SSAN,2016-06-04 09:00:00,89,48,Saturday,9,137
11670,SSAN,2016-06-04 10:00:00,99,32,Saturday,10,131
11671,SSAN,2016-06-04 11:00:00,87,47,Saturday,11,134
11672,SSAN,2016-06-04 12:00:00,125,46,Saturday,12,171
11673,SSAN,2016-06-04 13:00:00,96,60,Saturday,13,156
11674,SSAN,2016-06-04 14:00:00,63,60,Saturday,14,123
11675,SSAN,2016-06-04 15:00:00,88,69,Saturday,15,157
11676,SSAN,2016-06-04 16:00:00,70,82,Saturday,16,152
11677,SSAN,2016-06-04 17:00:00,79,139,Saturday,17,218
11678,SSAN,2016-06-04 18:00:00,52,108,Saturday,18,160
11679,SSAN,2016-06-04 19:00:00,49,68,Saturday,19,117
11680,SSAN,2016-06-04 20:00:00,37,90,Saturday,20,127
11681,SSAN,2016-06-04 21:00:00,37,59,Saturday,21,96
11682,SSAN,2016-06-04 22:00:00,28,79,Saturday,22,107
11683,SSAN,2016-06-04 23:00:00,21,42,Saturday,23,63
11684,SSAN,2016-06-05 00:00:00,6,44,Sunday,0,50
11685,SSAN,2016-06-05 01:00:00,1,7,Sunday,1,8
11686,SSAN,2016-06-05 08:00:00,38,18,Sunday,8,56
11687,SSAN,2016-06-05 09:00:00,57,27,Sunday,9,84
11688,SSAN,2016-06-05 10:00:00,72,35,Sunday,10,107
11689,SSAN,2016-06-05 11:00:00,86,39,Sunday,11,125
11690,SSAN,2016-06-05 12:00:00,66,40,Sunday,12,106
11691,SSAN,2016-06-05 13:00:00,108,55,Sunday,13,163
11692,SSAN,2016-06-05 14:00:00,67,58,Sunday,14,125
11693,SSAN,2016-06-05 15:00:00,57,51,Sunday,15,108
11694,SSAN,2016-06-05 16:00:00,64,105,Sunday,16,169
11695,SSAN,2016-06-05 17:00:00,69,93,Sunday,17,162
11696,SSAN,2016-06-05 18:00:00,29,78,Sunday,18,107
11697,SSAN,2016-06-05 19:00:00,37,65,Sunday,19,102
11698,SSAN,2016-06-05 20:00:00,35,84,Sunday,20,119
11699,SSAN,2016-06-05 21:00:00,33,47,Sunday,21,80
11700,SSAN,2016-06-05 22:00:00,24,41,Sunday,22,65
11701,SSAN,2016-06-05 23:00:00,9,37,Sunday,23,46
11702,SSAN,2016-06-06 00:00:00,7,9,Monday,0,16
11703,SSAN,2016-06-06 05:00:00,62,28,Monday,5,90
11704,SSAN,2016-06-06 06:00:00,204,120,Monday,6,324
11705,SSAN,2016-06-06 07:00:00,535,226,Monday,7,761
11706,SSAN,2016-06-06 08:00:00,998,221,Monday,8,1219
11707,SSAN,2016-06-06 09:00:00,491,113,Monday,9,604
11708,SSAN,2016-06-06 10:00:00,217,62,Monday,10,279
11709,SSAN,2016-06-06 11:00:00,137,52,Monday,11,189
11710,SSAN,2016-06-06 12:00:00,109,56,Monday,12,165
11711,SSAN,2016-06-06 13:00:00,114,83,Monday,13,197
11712,SSAN,2016-06-06 14:00:00,81,148,Monday,14,229
11713,SSAN,2016-06-06 15:00:00,116,188,Monday,15,304
11714,SSAN,2016-06-06 16:00:00,173,384,Monday,16,557
11715,SSAN,2016-06-06 17:00:00,268,785,Monday,17,1053
11716,SSAN,2016-06-06 18:00:00,272,670,Monday,18,942
11717,SSAN,2016-06-06 19:00:00,122,320,Monday,19,442
11718,SSAN,2016-06-06 20:00:00,39,218,Monday,20,257
11719,SSAN,2016-06-06 21:00:00,23,115,Monday,21,138
11720,SSAN,2016-06-06 22:00:00,14,65,Monday,22,79
11721,SSAN,2016-06-06 23:00:00,10,48,Monday,23,58
11722,SSAN,2016-06-07 00:00:00,1,25,Tuesday,0,26
11723,SSAN,2016-06-07 01:00:00,2,5,Tuesday,1,7
11724,SSAN,2016-06-07 04:00:00,9,1,Tuesday,4,10
11725,SSAN,2016-06-07 05:00:00,70,45,Tuesday,5,115
11726,SSAN,2016-06-07 06:00:00,204,110,Tuesday,6,314
11727,SSAN,2016-06-07 07:00:00,594,253,Tuesday,7,847
11728,SSAN,2016-06-07 08:00:00,950,237,Tuesday,8,1187
11729,SSAN,2016-06-07 09:00:00,556,109,Tuesday,9,665
11730,SSAN,2016-06-07 10:00:00,222,57,Tuesday,10,279
11731,SSAN,2016-06-07 11:00:00,125,68,Tuesday,11,193
11732,SSAN,2016-06-07 12:00:00,101,57,Tuesday,12,158
11733,SSAN,2016-06-07 13:00:00,107,73,Tuesday,13,180
11734,SSAN,2016-06-07 14:00:00,98,149,Tuesday,14,247
11735,SSAN,2016-06-07 15:00:00,102,201,Tuesday,15,303
11736,SSAN,2016-06-07 16:00:00,193,399,Tuesday,16,592
11737,SSAN,2016-06-07 17:00:00,274,763,Tuesday,17,1037
11738,SSAN,2016-06-07 18:00:00,316,741,Tuesday,18,1057
11739,SSAN,2016-06-07 19:00:00,146,314,Tuesday,19,460
11740,SSAN,2016-06-07 20:00:00,52,200,Tuesday,20,252
11741,SSAN,2016-06-07 21:00:00,29,79,Tuesday,21,108
11742,SSAN,2016-06-07 22:00:00,24,122,Tuesday,22,146
11743,SSAN,2016-06-07 23:00:00,9,66,Tuesday,23,75
11744,SSAN,2016-06-08 00:00:00,8,26,Wednesday,0,34
11745,SSAN,2016-06-08 01:00:00,2,3,Wednesday,1,5
11746,SSAN,2016-06-08 04:00:00,14,1,Wednesday,4,15
11747,SSAN,2016-06-08 05:00:00,67,38,Wednesday,5,105
11748,SSAN,2016-06-08 06:00:00,198,127,Wednesday,6,325
11749,SSAN,2016-06-08 07:00:00,556,263,Wednesday,7,819
11750,SSAN,2016-06-08 08:00:00,977,227,Wednesday,8,1204
11751,SSAN,2016-06-08 09:00:00,571,124,Wednesday,9,695
11752,SSAN,2016-06-08 10:00:00,205,56,Wednesday,10,261
11753,SSAN,2016-06-08 11:00:00,110,45,Wednesday,11,155
11754,SSAN,2016-06-08 12:00:00,122,63,Wednesday,12,185
11755,SSAN,2016-06-08 13:00:00,94,101,Wednesday,13,195
11756,SSAN,2016-06-08 14:00:00,81,103,Wednesday,14,184
11757,SSAN,2016-06-08 15:00:00,120,194,Wednesday,15,314
11758,SSAN,2016-06-08 16:00:00,216,336,Wednesday,16,552
11759,SSAN,2016-06-08 17:00:00,318,891,Wednesday,17,1209
11760,SSAN,2016-06-08 18:00:00,319,674,Wednesday,18,993
11761,SSAN,2016-06-08 19:00:00,136,276,Wednesday,19,412
11762,SSAN,2016-06-08 20:00:00,44,144,Wednesday,20,188
11763,SSAN,2016-06-08 21:00:00,20,186,Wednesday,21,206
11764,SSAN,2016-06-08 22:00:00,18,84,Wednesday,22,102
11765,SSAN,2016-06-08 23:00:00,12,69,Wednesday,23,81
11766,SSAN,2016-06-09 00:00:00,8,21,Thursday,0,29
11767,SSAN,2016-06-09 01:00:00,1,6,Thursday,1,7
11768,SSAN,2016-06-09 04:00:00,17,6,Thursday,4,23
11769,SSAN,2016-06-09 05:00:00,69,43,Thursday,5,112
11770,SSAN,2016-06-09 06:00:00,235,124,Thursday,6,359
11771,SSAN,2016-06-09 07:00:00,539,211,Thursday,7,750
11772,SSAN,2016-06-09 08:00:00,959,258,Thursday,8,1217
11773,SSAN,2016-06-09 09:00:00,548,114,Thursday,9,662
11774,SSAN,2016-06-09 10:00:00,243,72,Thursday,10,315
11775,SSAN,2016-06-09 11:00:00,143,70,Thursday,11,213
11776,SSAN,2016-06-09 12:00:00,95,52,Thursday,12,147
11777,SSAN,2016-06-09 13:00:00,98,82,Thursday,13,180
11778,SSAN,2016-06-09 14:00:00,98,138,Thursday,14,236
11779,SSAN,2016-06-09 15:00:00,127,192,Thursday,15,319
11780,SSAN,2016-06-09 16:00:00,171,390,Thursday,16,561
11781,SSAN,2016-06-09 17:00:00,306,830,Thursday,17,1136
11782,SSAN,2016-06-09 18:00:00,273,575,Thursday,18,848
11783,SSAN,2016-06-09 19:00:00,149,359,Thursday,19,508
11784,SSAN,2016-06-09 20:00:00,66,145,Thursday,20,211
11785,SSAN,2016-06-09 21:00:00,33,168,Thursday,21,201
11786,SSAN,2016-06-09 22:00:00,17,80,Thursday,22,97
11787,SSAN,2016-06-09 23:00:00,9,69,Thursday,23,78
11788,SSAN,2016-06-10 00:00:00,7,32,Friday,0,39
11789,SSAN,2016-06-10 01:00:00,3,5,Friday,1,8
11790,SSAN,2016-06-10 04:00:00,9,3,Friday,4,12
11791,SSAN,2016-06-10 05:00:00,66,47,Friday,5,113
11792,SSAN,2016-06-10 06:00:00,180,92,Friday,6,272
11793,SSAN,2016-06-10 07:00:00,534,221,Friday,7,755
11794,SSAN,2016-06-10 08:00:00,863,198,Friday,8,1061
11795,SSAN,2016-06-10 09:00:00,487,88,Friday,9,575
11796,SSAN,2016-06-10 10:00:00,215,50,Friday,10,265
11797,SSAN,2016-06-10 11:00:00,127,64,Friday,11,191
11798,SSAN,2016-06-10 12:00:00,96,65,Friday,12,161
11799,SSAN,2016-06-10 13:00:00,100,91,Friday,13,191
11800,SSAN,2016-06-10 14:00:00,126,140,Friday,14,266
11801,SSAN,2016-06-10 15:00:00,122,213,Friday,15,335
11802,SSAN,2016-06-10 16:00:00,218,427,Friday,16,645
11803,SSAN,2016-06-10 17:00:00,342,632,Friday,17,974
11804,SSAN,2016-06-10 18:00:00,290,587,Friday,18,877
11805,SSAN,2016-06-10 19:00:00,97,242,Friday,19,339
11806,SSAN,2016-06-10 20:00:00,52,118,Friday,20,170
11807,SSAN,2016-06-10 21:00:00,27,98,Friday,21,125
11808,SSAN,2016-06-10 22:00:00,28,172,Friday,22,200
11809,SSAN,2016-06-10 23:00:00,27,81,Friday,23,108
11810,SSAN,2016-06-11 00:00:00,15,51,Saturday,0,66
11811,SSAN,2016-06-11 01:00:00,3,15,Saturday,1,18
11812,SSAN,2016-06-11 07:00:00,62,23,Saturday,7,85
11813,SSAN,2016-06-11 08:00:00,82,36,Saturday,8,118
11814,SSAN,2016-06-11 09:00:00,78,18,Saturday,9,96
11815,SSAN,2016-06-11 10:00:00,108,38,Saturday,10,146
11816,SSAN,2016-06-11 11:00:00,104,57,Saturday,11,161
11817,SSAN,2016-06-11 12:00:00,120,50,Saturday,12,170
11818,SSAN,2016-06-11 13:00:00,129,50,Saturday,13,179
11819,SSAN,2016-06-11 14:00:00,101,68,Saturday,14,169
11820,SSAN,2016-06-11 15:00:00,88,107,Saturday,15,195
11821,SSAN,2016-06-11 16:00:00,90,104,Saturday,16,194
11822,SSAN,2016-06-11 17:00:00,63,112,Saturday,17,175
11823,SSAN,2016-06-11 18:00:00,64,130,Saturday,18,194
11824,SSAN,2016-06-11 19:00:00,60,103,Saturday,19,163
11825,SSAN,2016-06-11 20:00:00,34,73,Saturday,20,107
11826,SSAN,2016-06-11 21:00:00,32,98,Saturday,21,130
11827,SSAN,2016-06-11 22:00:00,32,83,Saturday,22,115
11828,SSAN,2016-06-11 23:00:00,12,56,Saturday,23,68
11829,SSAN,2016-06-12 00:00:00,10,51,Sunday,0,61
11830,SSAN,2016-06-12 01:00:00,1,16,Sunday,1,17
11831,SSAN,2016-06-12 08:00:00,43,14,Sunday,8,57
11832,SSAN,2016-06-12 09:00:00,61,28,Sunday,9,89
11833,SSAN,2016-06-12 10:00:00,73,35,Sunday,10,108
11834,SSAN,2016-06-12 11:00:00,100,36,Sunday,11,136
11835,SSAN,2016-06-12 12:00:00,102,42,Sunday,12,144
11836,SSAN,2016-06-12 13:00:00,93,48,Sunday,13,141
11837,SSAN,2016-06-12 14:00:00,72,49,Sunday,14,121
11838,SSAN,2016-06-12 15:00:00,70,63,Sunday,15,133
11839,SSAN,2016-06-12 16:00:00,73,78,Sunday,16,151
11840,SSAN,2016-06-12 17:00:00,53,91,Sunday,17,144
11841,SSAN,2016-06-12 18:00:00,53,111,Sunday,18,164
11842,SSAN,2016-06-12 19:00:00,79,95,Sunday,19,174
11843,SSAN,2016-06-12 20:00:00,17,57,Sunday,20,74
11844,SSAN,2016-06-12 21:00:00,23,77,Sunday,21,100
11845,SSAN,2016-06-12 22:00:00,23,46,Sunday,22,69
11846,SSAN,2016-06-12 23:00:00,16,50,Sunday,23,66
11847,SSAN,2016-06-13 00:00:00,5,18,Monday,0,23
11848,SSAN,2016-06-13 04:00:00,5,2,Monday,4,7
11849,SSAN,2016-06-13 05:00:00,66,38,Monday,5,104
11850,SSAN,2016-06-13 06:00:00,223,106,Monday,6,329
11851,SSAN,2016-06-13 07:00:00,512,251,Monday,7,763
11852,SSAN,2016-06-13 08:00:00,980,215,Monday,8,1195
11853,SSAN,2016-06-13 09:00:00,517,115,Monday,9,632
11854,SSAN,2016-06-13 10:00:00,184,52,Monday,10,236
11855,SSAN,2016-06-13 11:00:00,113,58,Monday,11,171
11856,SSAN,2016-06-13 12:00:00,99,46,Monday,12,145
11857,SSAN,2016-06-13 13:00:00,80,79,Monday,13,159
11858,SSAN,2016-06-13 14:00:00,84,118,Monday,14,202
11859,SSAN,2016-06-13 15:00:00,113,177,Monday,15,290
11860,SSAN,2016-06-13 16:00:00,215,394,Monday,16,609
11861,SSAN,2016-06-13 17:00:00,317,876,Monday,17,1193
11862,SSAN,2016-06-13 18:00:00,288,710,Monday,18,998
11863,SSAN,2016-06-13 19:00:00,109,257,Monday,19,366
11864,SSAN,2016-06-13 20:00:00,31,127,Monday,20,158
11865,SSAN,2016-06-13 21:00:00,36,116,Monday,21,152
11866,SSAN,2016-06-13 22:00:00,19,143,Monday,22,162
11867,SSAN,2016-06-13 23:00:00,22,59,Monday,23,81
11868,SSAN,2016-06-14 00:00:00,4,28,Tuesday,0,32
11869,SSAN,2016-06-14 04:00:00,6,1,Tuesday,4,7
11870,SSAN,2016-06-14 05:00:00,69,39,Tuesday,5,108
11871,SSAN,2016-06-14 06:00:00,237,115,Tuesday,6,352
11872,SSAN,2016-06-14 07:00:00,569,234,Tuesday,7,803
11873,SSAN,2016-06-14 08:00:00,1008,263,Tuesday,8,1271
11874,SSAN,2016-06-14 09:00:00,544,118,Tuesday,9,662
11875,SSAN,2016-06-14 10:00:00,217,62,Tuesday,10,279
11876,SSAN,2016-06-14 11:00:00,130,58,Tuesday,11,188
11877,SSAN,2016-06-14 12:00:00,96,70,Tuesday,12,166
11878,SSAN,2016-06-14 13:00:00,93,80,Tuesday,13,173
11879,SSAN,2016-06-14 14:00:00,104,119,Tuesday,14,223
11880,SSAN,2016-06-14 15:00:00,94,253,Tuesday,15,347
11881,SSAN,2016-06-14 16:00:00,195,345,Tuesday,16,540
11882,SSAN,2016-06-14 17:00:00,332,905,Tuesday,17,1237
11883,SSAN,2016-06-14 18:00:00,324,657,Tuesday,18,981
11884,SSAN,2016-06-14 19:00:00,132,349,Tuesday,19,481
11885,SSAN,2016-06-14 20:00:00,46,170,Tuesday,20,216
11886,SSAN,2016-06-14 21:00:00,25,124,Tuesday,21,149
11887,SSAN,2016-06-14 22:00:00,22,94,Tuesday,22,116
11888,SSAN,2016-06-14 23:00:00,10,64,Tuesday,23,74
11889,UCTY,2016-06-01 01:00:00,2,4,Wednesday,1,6
11890,UCTY,2016-06-01 05:00:00,81,62,Wednesday,5,143
11891,UCTY,2016-06-01 06:00:00,300,114,Wednesday,6,414
11892,UCTY,2016-06-01 07:00:00,713,218,Wednesday,7,931
11893,UCTY,2016-06-01 08:00:00,1058,152,Wednesday,8,1210
11894,UCTY,2016-06-01 09:00:00,1076,91,Wednesday,9,1167
11895,UCTY,2016-06-01 10:00:00,536,97,Wednesday,10,633
11896,UCTY,2016-06-01 11:00:00,239,82,Wednesday,11,321
11897,UCTY,2016-06-01 12:00:00,161,121,Wednesday,12,282
11898,UCTY,2016-06-01 13:00:00,145,104,Wednesday,13,249
11899,UCTY,2016-06-01 14:00:00,133,220,Wednesday,14,353
11900,UCTY,2016-06-01 15:00:00,115,190,Wednesday,15,305
11901,UCTY,2016-06-01 16:00:00,176,676,Wednesday,16,852
11902,UCTY,2016-06-01 17:00:00,178,817,Wednesday,17,995
11903,UCTY,2016-06-01 18:00:00,174,1397,Wednesday,18,1571
11904,UCTY,2016-06-01 19:00:00,114,505,Wednesday,19,619
11905,UCTY,2016-06-01 20:00:00,272,297,Wednesday,20,569
11906,UCTY,2016-06-01 21:00:00,88,71,Wednesday,21,159
11907,UCTY,2016-06-01 22:00:00,31,140,Wednesday,22,171
11908,UCTY,2016-06-01 23:00:00,20,63,Wednesday,23,83
11909,UCTY,2016-06-02 00:00:00,10,41,Thursday,0,51
11910,UCTY,2016-06-02 04:00:00,6,2,Thursday,4,8
11911,UCTY,2016-06-02 05:00:00,88,56,Thursday,5,144
11912,UCTY,2016-06-02 06:00:00,271,118,Thursday,6,389
11913,UCTY,2016-06-02 07:00:00,720,233,Thursday,7,953
11914,UCTY,2016-06-02 08:00:00,994,174,Thursday,8,1168
11915,UCTY,2016-06-02 09:00:00,996,100,Thursday,9,1096
11916,UCTY,2016-06-02 10:00:00,470,81,Thursday,10,551
11917,UCTY,2016-06-02 11:00:00,178,72,Thursday,11,250
11918,UCTY,2016-06-02 12:00:00,88,108,Thursday,12,196
11919,UCTY,2016-06-02 13:00:00,104,112,Thursday,13,216
11920,UCTY,2016-06-02 14:00:00,107,125,Thursday,14,232
11921,UCTY,2016-06-02 15:00:00,147,181,Thursday,15,328
11922,UCTY,2016-06-02 16:00:00,255,408,Thursday,16,663
11923,UCTY,2016-06-02 17:00:00,286,1195,Thursday,17,1481
11924,UCTY,2016-06-02 18:00:00,187,307,Thursday,18,494
11925,UCTY,2016-06-02 19:00:00,120,1115,Thursday,19,1235
11926,UCTY,2016-06-02 20:00:00,92,175,Thursday,20,267
11927,UCTY,2016-06-02 21:00:00,58,320,Thursday,21,378
11928,UCTY,2016-06-02 22:00:00,36,145,Thursday,22,181
11929,UCTY,2016-06-02 23:00:00,21,86,Thursday,23,107
11930,UCTY,2016-06-03 00:00:00,16,45,Friday,0,61
11931,UCTY,2016-06-03 01:00:00,1,6,Friday,1,7
11932,UCTY,2016-06-03 05:00:00,70,54,Friday,5,124
11933,UCTY,2016-06-03 06:00:00,225,110,Friday,6,335
11934,UCTY,2016-06-03 07:00:00,603,193,Friday,7,796
11935,UCTY,2016-06-03 08:00:00,884,140,Friday,8,1024
11936,UCTY,2016-06-03 09:00:00,822,82,Friday,9,904
11937,UCTY,2016-06-03 10:00:00,511,76,Friday,10,587
11938,UCTY,2016-06-03 11:00:00,156,98,Friday,11,254
11939,UCTY,2016-06-03 12:00:00,122,67,Friday,12,189
11940,UCTY,2016-06-03 13:00:00,119,152,Friday,13,271
11941,UCTY,2016-06-03 14:00:00,106,264,Friday,14,370
11942,UCTY,2016-06-03 15:00:00,119,252,Friday,15,371
11943,UCTY,2016-06-03 16:00:00,180,500,Friday,16,680
11944,UCTY,2016-06-03 17:00:00,174,770,Friday,17,944
11945,UCTY,2016-06-03 18:00:00,206,994,Friday,18,1200
11946,UCTY,2016-06-03 19:00:00,158,349,Friday,19,507
11947,UCTY,2016-06-03 20:00:00,81,208,Friday,20,289
11948,UCTY,2016-06-03 21:00:00,52,128,Friday,21,180
11949,UCTY,2016-06-03 22:00:00,33,115,Friday,22,148
11950,UCTY,2016-06-03 23:00:00,31,96,Friday,23,127
11951,UCTY,2016-06-04 00:00:00,18,50,Saturday,0,68
11952,UCTY,2016-06-04 01:00:00,1,11,Saturday,1,12
11953,UCTY,2016-06-04 06:00:00,22,1,Saturday,6,23
11954,UCTY,2016-06-04 07:00:00,57,46,Saturday,7,103
11955,UCTY,2016-06-04 08:00:00,97,53,Saturday,8,150
11956,UCTY,2016-06-04 09:00:00,112,48,Saturday,9,160
11957,UCTY,2016-06-04 10:00:00,121,79,Saturday,10,200
11958,UCTY,2016-06-04 11:00:00,104,84,Saturday,11,188
11959,UCTY,2016-06-04 12:00:00,125,54,Saturday,12,179
11960,UCTY,2016-06-04 13:00:00,131,98,Saturday,13,229
11961,UCTY,2016-06-04 14:00:00,117,69,Saturday,14,186
11962,UCTY,2016-06-04 15:00:00,87,116,Saturday,15,203
11963,UCTY,2016-06-04 16:00:00,83,122,Saturday,16,205
11964,UCTY,2016-06-04 17:00:00,91,130,Saturday,17,221
11965,UCTY,2016-06-04 18:00:00,76,128,Saturday,18,204
11966,UCTY,2016-06-04 19:00:00,62,100,Saturday,19,162
11967,UCTY,2016-06-04 20:00:00,41,111,Saturday,20,152
11968,UCTY,2016-06-04 21:00:00,41,84,Saturday,21,125
11969,UCTY,2016-06-04 22:00:00,45,81,Saturday,22,126
11970,UCTY,2016-06-04 23:00:00,20,65,Saturday,23,85
11971,UCTY,2016-06-05 00:00:00,12,43,Sunday,0,55
11972,UCTY,2016-06-05 01:00:00,1,7,Sunday,1,8
11973,UCTY,2016-06-05 08:00:00,45,26,Sunday,8,71
11974,UCTY,2016-06-05 09:00:00,70,53,Sunday,9,123
11975,UCTY,2016-06-05 10:00:00,82,61,Sunday,10,143
11976,UCTY,2016-06-05 11:00:00,162,54,Sunday,11,216
11977,UCTY,2016-06-05 12:00:00,116,57,Sunday,12,173
11978,UCTY,2016-06-05 13:00:00,92,44,Sunday,13,136
11979,UCTY,2016-06-05 14:00:00,128,84,Sunday,14,212
11980,UCTY,2016-06-05 15:00:00,130,88,Sunday,15,218
11981,UCTY,2016-06-05 16:00:00,143,114,Sunday,16,257
11982,UCTY,2016-06-05 17:00:00,54,111,Sunday,17,165
11983,UCTY,2016-06-05 18:00:00,63,137,Sunday,18,200
11984,UCTY,2016-06-05 19:00:00,33,114,Sunday,19,147
11985,UCTY,2016-06-05 20:00:00,27,211,Sunday,20,238
11986,UCTY,2016-06-05 21:00:00,48,85,Sunday,21,133
11987,UCTY,2016-06-05 22:00:00,44,45,Sunday,22,89
11988,UCTY,2016-06-05 23:00:00,16,48,Sunday,23,64
11989,UCTY,2016-06-06 00:00:00,6,25,Monday,0,31
11990,UCTY,2016-06-06 01:00:00,1,2,Monday,1,3
11991,UCTY,2016-06-06 05:00:00,86,47,Monday,5,133
11992,UCTY,2016-06-06 06:00:00,251,113,Monday,6,364
11993,UCTY,2016-06-06 07:00:00,706,218,Monday,7,924
11994,UCTY,2016-06-06 08:00:00,1022,152,Monday,8,1174
11995,UCTY,2016-06-06 09:00:00,1024,112,Monday,9,1136
11996,UCTY,2016-06-06 10:00:00,499,88,Monday,10,587
11997,UCTY,2016-06-06 11:00:00,147,67,Monday,11,214
11998,UCTY,2016-06-06 12:00:00,127,93,Monday,12,220
11999,UCTY,2016-06-06 13:00:00,137,91,Monday,13,228
12000,UCTY,2016-06-06 14:00:00,109,113,Monday,14,222
12001,UCTY,2016-06-06 15:00:00,117,196,Monday,15,313
12002,UCTY,2016-06-06 16:00:00,140,493,Monday,16,633
12003,UCTY,2016-06-06 17:00:00,197,1089,Monday,17,1286
12004,UCTY,2016-06-06 18:00:00,173,1157,Monday,18,1330
12005,UCTY,2016-06-06 19:00:00,119,470,Monday,19,589
12006,UCTY,2016-06-06 20:00:00,57,231,Monday,20,288
12007,UCTY,2016-06-06 21:00:00,40,135,Monday,21,175
12008,UCTY,2016-06-06 22:00:00,33,97,Monday,22,130
12009,UCTY,2016-06-06 23:00:00,27,50,Monday,23,77
12010,UCTY,2016-06-07 00:00:00,8,22,Tuesday,0,30
12011,UCTY,2016-06-07 01:00:00,1,6,Tuesday,1,7
12012,UCTY,2016-06-07 05:00:00,88,55,Tuesday,5,143
12013,UCTY,2016-06-07 06:00:00,271,128,Tuesday,6,399
12014,UCTY,2016-06-07 07:00:00,679,241,Tuesday,7,920
12015,UCTY,2016-06-07 08:00:00,1202,168,Tuesday,8,1370
12016,UCTY,2016-06-07 09:00:00,1023,93,Tuesday,9,1116
12017,UCTY,2016-06-07 10:00:00,483,74,Tuesday,10,557
12018,UCTY,2016-06-07 11:00:00,158,111,Tuesday,11,269
12019,UCTY,2016-06-07 12:00:00,127,112,Tuesday,12,239
12020,UCTY,2016-06-07 13:00:00,132,97,Tuesday,13,229
12021,UCTY,2016-06-07 14:00:00,108,131,Tuesday,14,239
12022,UCTY,2016-06-07 15:00:00,115,232,Tuesday,15,347
12023,UCTY,2016-06-07 16:00:00,159,515,Tuesday,16,674
12024,UCTY,2016-06-07 17:00:00,198,1092,Tuesday,17,1290
12025,UCTY,2016-06-07 18:00:00,244,1139,Tuesday,18,1383
12026,UCTY,2016-06-07 19:00:00,135,491,Tuesday,19,626
12027,UCTY,2016-06-07 20:00:00,62,271,Tuesday,20,333
12028,UCTY,2016-06-07 21:00:00,39,146,Tuesday,21,185
12029,UCTY,2016-06-07 22:00:00,33,127,Tuesday,22,160
12030,UCTY,2016-06-07 23:00:00,18,68,Tuesday,23,86
12031,UCTY,2016-06-08 00:00:00,11,48,Wednesday,0,59
12032,UCTY,2016-06-08 01:00:00,3,20,Wednesday,1,23
12033,UCTY,2016-06-08 05:00:00,86,49,Wednesday,5,135
12034,UCTY,2016-06-08 06:00:00,262,120,Wednesday,6,382
12035,UCTY,2016-06-08 07:00:00,714,218,Wednesday,7,932
12036,UCTY,2016-06-08 08:00:00,834,171,Wednesday,8,1005
12037,UCTY,2016-06-08 09:00:00,1202,89,Wednesday,9,1291
12038,UCTY,2016-06-08 10:00:00,459,86,Wednesday,10,545
12039,UCTY,2016-06-08 11:00:00,166,85,Wednesday,11,251
12040,UCTY,2016-06-08 12:00:00,123,94,Wednesday,12,217
12041,UCTY,2016-06-08 13:00:00,151,110,Wednesday,13,261
12042,UCTY,2016-06-08 14:00:00,101,165,Wednesday,14,266
12043,UCTY,2016-06-08 15:00:00,124,200,Wednesday,15,324
12044,UCTY,2016-06-08 16:00:00,187,382,Wednesday,16,569
12045,UCTY,2016-06-08 17:00:00,317,1224,Wednesday,17,1541
12046,UCTY,2016-06-08 18:00:00,286,913,Wednesday,18,1199
12047,UCTY,2016-06-08 19:00:00,120,650,Wednesday,19,770
12048,UCTY,2016-06-08 20:00:00,82,212,Wednesday,20,294
12049,UCTY,2016-06-08 21:00:00,51,325,Wednesday,21,376
12050,UCTY,2016-06-08 22:00:00,37,106,Wednesday,22,143
12051,UCTY,2016-06-08 23:00:00,21,95,Wednesday,23,116
12052,UCTY,2016-06-09 00:00:00,8,42,Thursday,0,50
12053,UCTY,2016-06-09 01:00:00,1,16,Thursday,1,17
12054,UCTY,2016-06-09 05:00:00,78,56,Thursday,5,134
12055,UCTY,2016-06-09 06:00:00,261,99,Thursday,6,360
12056,UCTY,2016-06-09 07:00:00,588,156,Thursday,7,744
12057,UCTY,2016-06-09 08:00:00,1159,126,Thursday,8,1285
12058,UCTY,2016-06-09 09:00:00,900,93,Thursday,9,993
12059,UCTY,2016-06-09 10:00:00,474,91,Thursday,10,565
12060,UCTY,2016-06-09 11:00:00,188,95,Thursday,11,283
12061,UCTY,2016-06-09 12:00:00,124,105,Thursday,12,229
12062,UCTY,2016-06-09 13:00:00,126,104,Thursday,13,230
12063,UCTY,2016-06-09 14:00:00,109,137,Thursday,14,246
12064,UCTY,2016-06-09 15:00:00,102,204,Thursday,15,306
12065,UCTY,2016-06-09 16:00:00,167,492,Thursday,16,659
12066,UCTY,2016-06-09 17:00:00,207,1035,Thursday,17,1242
12067,UCTY,2016-06-09 18:00:00,217,1074,Thursday,18,1291
12068,UCTY,2016-06-09 19:00:00,115,550,Thursday,19,665
12069,UCTY,2016-06-09 20:00:00,72,163,Thursday,20,235
12070,UCTY,2016-06-09 21:00:00,47,156,Thursday,21,203
12071,UCTY,2016-06-09 22:00:00,34,93,Thursday,22,127
12072,UCTY,2016-06-09 23:00:00,20,103,Thursday,23,123
12073,UCTY,2016-06-10 00:00:00,6,27,Friday,0,33
12074,UCTY,2016-06-10 01:00:00,2,12,Friday,1,14
12075,UCTY,2016-06-10 05:00:00,74,51,Friday,5,125
12076,UCTY,2016-06-10 06:00:00,232,87,Friday,6,319
12077,UCTY,2016-06-10 07:00:00,605,150,Friday,7,755
12078,UCTY,2016-06-10 08:00:00,899,148,Friday,8,1047
12079,UCTY,2016-06-10 09:00:00,833,109,Friday,9,942
12080,UCTY,2016-06-10 10:00:00,384,77,Friday,10,461
12081,UCTY,2016-06-10 11:00:00,172,90,Friday,11,262
12082,UCTY,2016-06-10 12:00:00,128,72,Friday,12,200
12083,UCTY,2016-06-10 13:00:00,136,140,Friday,13,276
12084,UCTY,2016-06-10 14:00:00,83,188,Friday,14,271
12085,UCTY,2016-06-10 15:00:00,143,267,Friday,15,410
12086,UCTY,2016-06-10 16:00:00,219,351,Friday,16,570
12087,UCTY,2016-06-10 17:00:00,302,1006,Friday,17,1308
12088,UCTY,2016-06-10 18:00:00,298,828,Friday,18,1126
12089,UCTY,2016-06-10 19:00:00,149,395,Friday,19,544
12090,UCTY,2016-06-10 20:00:00,75,153,Friday,20,228
12091,UCTY,2016-06-10 21:00:00,43,193,Friday,21,236
12092,UCTY,2016-06-10 22:00:00,40,274,Friday,22,314
12093,UCTY,2016-06-10 23:00:00,27,128,Friday,23,155
12094,UCTY,2016-06-11 00:00:00,14,63,Saturday,0,77
12095,UCTY,2016-06-11 01:00:00,2,13,Saturday,1,15
12096,UCTY,2016-06-11 06:00:00,20,1,Saturday,6,21
12097,UCTY,2016-06-11 07:00:00,39,25,Saturday,7,64
12098,UCTY,2016-06-11 08:00:00,75,68,Saturday,8,143
12099,UCTY,2016-06-11 09:00:00,59,34,Saturday,9,93
12100,UCTY,2016-06-11 10:00:00,115,49,Saturday,10,164
12101,UCTY,2016-06-11 11:00:00,120,76,Saturday,11,196
12102,UCTY,2016-06-11 12:00:00,119,56,Saturday,12,175
12103,UCTY,2016-06-11 13:00:00,122,65,Saturday,13,187
12104,UCTY,2016-06-11 14:00:00,93,66,Saturday,14,159
12105,UCTY,2016-06-11 15:00:00,109,94,Saturday,15,203
12106,UCTY,2016-06-11 16:00:00,95,90,Saturday,16,185
12107,UCTY,2016-06-11 17:00:00,84,50,Saturday,17,134
12108,UCTY,2016-06-11 18:00:00,65,154,Saturday,18,219
12109,UCTY,2016-06-11 19:00:00,57,145,Saturday,19,202
12110,UCTY,2016-06-11 20:00:00,49,94,Saturday,20,143
12111,UCTY,2016-06-11 21:00:00,44,54,Saturday,21,98
12112,UCTY,2016-06-11 22:00:00,38,124,Saturday,22,162
12113,UCTY,2016-06-11 23:00:00,23,57,Saturday,23,80
12114,UCTY,2016-06-12 00:00:00,19,51,Sunday,0,70
12115,UCTY,2016-06-12 08:00:00,33,3,Sunday,8,36
12116,UCTY,2016-06-12 09:00:00,80,50,Sunday,9,130
12117,UCTY,2016-06-12 10:00:00,66,43,Sunday,10,109
12118,UCTY,2016-06-12 11:00:00,93,42,Sunday,11,135
12119,UCTY,2016-06-12 12:00:00,68,65,Sunday,12,133
12120,UCTY,2016-06-12 13:00:00,78,72,Sunday,13,150
12121,UCTY,2016-06-12 14:00:00,87,64,Sunday,14,151
12122,UCTY,2016-06-12 15:00:00,80,36,Sunday,15,116
12123,UCTY,2016-06-12 16:00:00,69,77,Sunday,16,146
12124,UCTY,2016-06-12 17:00:00,77,80,Sunday,17,157
12125,UCTY,2016-06-12 18:00:00,71,89,Sunday,18,160
12126,UCTY,2016-06-12 19:00:00,124,57,Sunday,19,181
12127,UCTY,2016-06-12 20:00:00,37,138,Sunday,20,175
12128,UCTY,2016-06-12 21:00:00,29,65,Sunday,21,94
12129,UCTY,2016-06-12 22:00:00,28,82,Sunday,22,110
12130,UCTY,2016-06-12 23:00:00,26,58,Sunday,23,84
12131,UCTY,2016-06-13 00:00:00,8,99,Monday,0,107
12132,UCTY,2016-06-13 04:00:00,6,2,Monday,4,8
12133,UCTY,2016-06-13 05:00:00,92,58,Monday,5,150
12134,UCTY,2016-06-13 06:00:00,225,110,Monday,6,335
12135,UCTY,2016-06-13 07:00:00,703,169,Monday,7,872
12136,UCTY,2016-06-13 08:00:00,1112,137,Monday,8,1249
12137,UCTY,2016-06-13 09:00:00,957,94,Monday,9,1051
12138,UCTY,2016-06-13 10:00:00,485,78,Monday,10,563
12139,UCTY,2016-06-13 11:00:00,162,72,Monday,11,234
12140,UCTY,2016-06-13 12:00:00,135,91,Monday,12,226
12141,UCTY,2016-06-13 13:00:00,112,90,Monday,13,202
12142,UCTY,2016-06-13 14:00:00,107,126,Monday,14,233
12143,UCTY,2016-06-13 15:00:00,102,214,Monday,15,316
12144,UCTY,2016-06-13 16:00:00,252,504,Monday,16,756
12145,UCTY,2016-06-13 17:00:00,320,827,Monday,17,1147
12146,UCTY,2016-06-13 18:00:00,250,1448,Monday,18,1698
12147,UCTY,2016-06-13 19:00:00,116,489,Monday,19,605
12148,UCTY,2016-06-13 20:00:00,80,140,Monday,20,220
12149,UCTY,2016-06-13 21:00:00,39,284,Monday,21,323
12150,UCTY,2016-06-13 22:00:00,37,185,Monday,22,222
12151,UCTY,2016-06-13 23:00:00,28,102,Monday,23,130
12152,UCTY,2016-06-14 00:00:00,6,35,Tuesday,0,41
12153,UCTY,2016-06-14 01:00:00,2,10,Tuesday,1,12
12154,UCTY,2016-06-14 04:00:00,4,1,Tuesday,4,5
12155,UCTY,2016-06-14 05:00:00,87,57,Tuesday,5,144
12156,UCTY,2016-06-14 06:00:00,262,112,Tuesday,6,374
12157,UCTY,2016-06-14 07:00:00,692,161,Tuesday,7,853
12158,UCTY,2016-06-14 08:00:00,971,139,Tuesday,8,1110
12159,UCTY,2016-06-14 09:00:00,1155,84,Tuesday,9,1239
12160,UCTY,2016-06-14 10:00:00,511,84,Tuesday,10,595
12161,UCTY,2016-06-14 11:00:00,168,83,Tuesday,11,251
12162,UCTY,2016-06-14 12:00:00,133,100,Tuesday,12,233
12163,UCTY,2016-06-14 13:00:00,106,115,Tuesday,13,221
12164,UCTY,2016-06-14 14:00:00,88,131,Tuesday,14,219
12165,UCTY,2016-06-14 15:00:00,107,237,Tuesday,15,344
12166,UCTY,2016-06-14 16:00:00,140,423,Tuesday,16,563
12167,UCTY,2016-06-14 17:00:00,228,1175,Tuesday,17,1403
12168,UCTY,2016-06-14 18:00:00,233,1157,Tuesday,18,1390
12169,UCTY,2016-06-14 19:00:00,120,551,Tuesday,19,671
12170,UCTY,2016-06-14 20:00:00,71,177,Tuesday,20,248
12171,UCTY,2016-06-14 21:00:00,28,137,Tuesday,21,165
12172,UCTY,2016-06-14 22:00:00,36,141,Tuesday,22,177
12173,UCTY,2016-06-14 23:00:00,20,90,Tuesday,23,110
12174,WCRK,2016-06-01 01:00:00,3,19,Wednesday,1,22
12175,WCRK,2016-06-01 04:00:00,6,4,Wednesday,4,10
12176,WCRK,2016-06-01 05:00:00,194,45,Wednesday,5,239
12177,WCRK,2016-06-01 06:00:00,523,143,Wednesday,6,666
12178,WCRK,2016-06-01 07:00:00,1334,330,Wednesday,7,1664
12179,WCRK,2016-06-01 08:00:00,1487,316,Wednesday,8,1803
12180,WCRK,2016-06-01 09:00:00,734,244,Wednesday,9,978
12181,WCRK,2016-06-01 10:00:00,379,169,Wednesday,10,548
12182,WCRK,2016-06-01 11:00:00,214,134,Wednesday,11,348
12183,WCRK,2016-06-01 12:00:00,159,121,Wednesday,12,280
12184,WCRK,2016-06-01 13:00:00,148,182,Wednesday,13,330
12185,WCRK,2016-06-01 14:00:00,161,210,Wednesday,14,371
12186,WCRK,2016-06-01 15:00:00,182,423,Wednesday,15,605
12187,WCRK,2016-06-01 16:00:00,255,830,Wednesday,16,1085
12188,WCRK,2016-06-01 17:00:00,374,1428,Wednesday,17,1802
12189,WCRK,2016-06-01 18:00:00,387,1313,Wednesday,18,1700
12190,WCRK,2016-06-01 19:00:00,203,570,Wednesday,19,773
12191,WCRK,2016-06-01 20:00:00,95,365,Wednesday,20,460
12192,WCRK,2016-06-01 21:00:00,82,183,Wednesday,21,265
12193,WCRK,2016-06-01 22:00:00,80,151,Wednesday,22,231
12194,WCRK,2016-06-01 23:00:00,45,97,Wednesday,23,142
12195,WCRK,2016-06-02 00:00:00,13,29,Thursday,0,42
12196,WCRK,2016-06-02 01:00:00,5,6,Thursday,1,11
12197,WCRK,2016-06-02 04:00:00,3,3,Thursday,4,6
12198,WCRK,2016-06-02 05:00:00,190,58,Thursday,5,248
12199,WCRK,2016-06-02 06:00:00,518,147,Thursday,6,665
12200,WCRK,2016-06-02 07:00:00,1312,315,Thursday,7,1627
12201,WCRK,2016-06-02 08:00:00,1472,299,Thursday,8,1771
12202,WCRK,2016-06-02 09:00:00,684,225,Thursday,9,909
12203,WCRK,2016-06-02 10:00:00,382,142,Thursday,10,524
12204,WCRK,2016-06-02 11:00:00,244,117,Thursday,11,361
12205,WCRK,2016-06-02 12:00:00,132,163,Thursday,12,295
12206,WCRK,2016-06-02 13:00:00,137,207,Thursday,13,344
12207,WCRK,2016-06-02 14:00:00,173,274,Thursday,14,447
12208,WCRK,2016-06-02 15:00:00,213,390,Thursday,15,603
12209,WCRK,2016-06-02 16:00:00,293,567,Thursday,16,860
12210,WCRK,2016-06-02 17:00:00,437,1730,Thursday,17,2167
12211,WCRK,2016-06-02 18:00:00,379,1300,Thursday,18,1679
12212,WCRK,2016-06-02 19:00:00,227,411,Thursday,19,638
12213,WCRK,2016-06-02 20:00:00,108,380,Thursday,20,488
12214,WCRK,2016-06-02 21:00:00,109,289,Thursday,21,398
12215,WCRK,2016-06-02 22:00:00,61,165,Thursday,22,226
12216,WCRK,2016-06-02 23:00:00,57,133,Thursday,23,190
12217,WCRK,2016-06-03 00:00:00,24,52,Friday,0,76
12218,WCRK,2016-06-03 01:00:00,6,9,Friday,1,15
12219,WCRK,2016-06-03 04:00:00,3,3,Friday,4,6
12220,WCRK,2016-06-03 05:00:00,178,45,Friday,5,223
12221,WCRK,2016-06-03 06:00:00,441,142,Friday,6,583
12222,WCRK,2016-06-03 07:00:00,1062,282,Friday,7,1344
12223,WCRK,2016-06-03 08:00:00,1270,301,Friday,8,1571
12224,WCRK,2016-06-03 09:00:00,614,209,Friday,9,823
12225,WCRK,2016-06-03 10:00:00,354,146,Friday,10,500
12226,WCRK,2016-06-03 11:00:00,190,157,Friday,11,347
12227,WCRK,2016-06-03 12:00:00,197,169,Friday,12,366
12228,WCRK,2016-06-03 13:00:00,154,226,Friday,13,380
12229,WCRK,2016-06-03 14:00:00,152,263,Friday,14,415
12230,WCRK,2016-06-03 15:00:00,238,454,Friday,15,692
12231,WCRK,2016-06-03 16:00:00,264,852,Friday,16,1116
12232,WCRK,2016-06-03 17:00:00,425,1229,Friday,17,1654
12233,WCRK,2016-06-03 18:00:00,370,1019,Friday,18,1389
12234,WCRK,2016-06-03 19:00:00,237,380,Friday,19,617
12235,WCRK,2016-06-03 20:00:00,128,245,Friday,20,373
12236,WCRK,2016-06-03 21:00:00,99,263,Friday,21,362
12237,WCRK,2016-06-03 22:00:00,81,176,Friday,22,257
12238,WCRK,2016-06-03 23:00:00,71,206,Friday,23,277
12239,WCRK,2016-06-04 00:00:00,36,83,Saturday,0,119
12240,WCRK,2016-06-04 01:00:00,12,35,Saturday,1,47
12241,WCRK,2016-06-04 06:00:00,27,40,Saturday,6,67
12242,WCRK,2016-06-04 07:00:00,65,71,Saturday,7,136
12243,WCRK,2016-06-04 08:00:00,117,104,Saturday,8,221
12244,WCRK,2016-06-04 09:00:00,160,139,Saturday,9,299
12245,WCRK,2016-06-04 10:00:00,167,113,Saturday,10,280
12246,WCRK,2016-06-04 11:00:00,207,135,Saturday,11,342
12247,WCRK,2016-06-04 12:00:00,257,137,Saturday,12,394
12248,WCRK,2016-06-04 13:00:00,157,203,Saturday,13,360
12249,WCRK,2016-06-04 14:00:00,167,194,Saturday,14,361
12250,WCRK,2016-06-04 15:00:00,183,196,Saturday,15,379
12251,WCRK,2016-06-04 16:00:00,205,217,Saturday,16,422
12252,WCRK,2016-06-04 17:00:00,220,207,Saturday,17,427
12253,WCRK,2016-06-04 18:00:00,188,228,Saturday,18,416
12254,WCRK,2016-06-04 19:00:00,163,152,Saturday,19,315
12255,WCRK,2016-06-04 20:00:00,113,157,Saturday,20,270
12256,WCRK,2016-06-04 21:00:00,97,138,Saturday,21,235
12257,WCRK,2016-06-04 22:00:00,98,196,Saturday,22,294
12258,WCRK,2016-06-04 23:00:00,76,95,Saturday,23,171
12259,WCRK,2016-06-05 00:00:00,43,85,Sunday,0,128
12260,WCRK,2016-06-05 01:00:00,16,21,Sunday,1,37
12261,WCRK,2016-06-05 08:00:00,60,93,Sunday,8,153
12262,WCRK,2016-06-05 09:00:00,113,100,Sunday,9,213
12263,WCRK,2016-06-05 10:00:00,175,139,Sunday,10,314
12264,WCRK,2016-06-05 11:00:00,156,127,Sunday,11,283
12265,WCRK,2016-06-05 12:00:00,162,181,Sunday,12,343
12266,WCRK,2016-06-05 13:00:00,173,144,Sunday,13,317
12267,WCRK,2016-06-05 14:00:00,147,172,Sunday,14,319
12268,WCRK,2016-06-05 15:00:00,185,184,Sunday,15,369
12269,WCRK,2016-06-05 16:00:00,159,188,Sunday,16,347
12270,WCRK,2016-06-05 17:00:00,121,166,Sunday,17,287
12271,WCRK,2016-06-05 18:00:00,123,122,Sunday,18,245
12272,WCRK,2016-06-05 19:00:00,109,118,Sunday,19,227
12273,WCRK,2016-06-05 20:00:00,107,145,Sunday,20,252
12274,WCRK,2016-06-05 21:00:00,92,98,Sunday,21,190
12275,WCRK,2016-06-05 22:00:00,81,71,Sunday,22,152
12276,WCRK,2016-06-05 23:00:00,37,65,Sunday,23,102
12277,WCRK,2016-06-06 00:00:00,17,25,Monday,0,42
12278,WCRK,2016-06-06 01:00:00,1,15,Monday,1,16
12279,WCRK,2016-06-06 04:00:00,22,2,Monday,4,24
12280,WCRK,2016-06-06 05:00:00,173,42,Monday,5,215
12281,WCRK,2016-06-06 06:00:00,529,150,Monday,6,679
12282,WCRK,2016-06-06 07:00:00,1223,305,Monday,7,1528
12283,WCRK,2016-06-06 08:00:00,1488,311,Monday,8,1799
12284,WCRK,2016-06-06 09:00:00,754,238,Monday,9,992
12285,WCRK,2016-06-06 10:00:00,318,148,Monday,10,466
12286,WCRK,2016-06-06 11:00:00,223,126,Monday,11,349
12287,WCRK,2016-06-06 12:00:00,178,175,Monday,12,353
12288,WCRK,2016-06-06 13:00:00,148,169,Monday,13,317
12289,WCRK,2016-06-06 14:00:00,140,245,Monday,14,385
12290,WCRK,2016-06-06 15:00:00,189,370,Monday,15,559
12291,WCRK,2016-06-06 16:00:00,272,816,Monday,16,1088
12292,WCRK,2016-06-06 17:00:00,392,1333,Monday,17,1725
12293,WCRK,2016-06-06 18:00:00,380,1384,Monday,18,1764
12294,WCRK,2016-06-06 19:00:00,208,557,Monday,19,765
12295,WCRK,2016-06-06 20:00:00,117,311,Monday,20,428
12296,WCRK,2016-06-06 21:00:00,89,189,Monday,21,278
12297,WCRK,2016-06-06 22:00:00,70,133,Monday,22,203
12298,WCRK,2016-06-06 23:00:00,42,79,Monday,23,121
12299,WCRK,2016-06-07 00:00:00,20,40,Tuesday,0,60
12300,WCRK,2016-06-07 01:00:00,3,6,Tuesday,1,9
12301,WCRK,2016-06-07 04:00:00,29,4,Tuesday,4,33
12302,WCRK,2016-06-07 05:00:00,150,43,Tuesday,5,193
12303,WCRK,2016-06-07 06:00:00,499,158,Tuesday,6,657
12304,WCRK,2016-06-07 07:00:00,1206,340,Tuesday,7,1546
12305,WCRK,2016-06-07 08:00:00,1523,350,Tuesday,8,1873
12306,WCRK,2016-06-07 09:00:00,848,219,Tuesday,9,1067
12307,WCRK,2016-06-07 10:00:00,425,155,Tuesday,10,580
12308,WCRK,2016-06-07 11:00:00,194,140,Tuesday,11,334
12309,WCRK,2016-06-07 12:00:00,181,148,Tuesday,12,329
12310,WCRK,2016-06-07 13:00:00,165,186,Tuesday,13,351
12311,WCRK,2016-06-07 14:00:00,171,313,Tuesday,14,484
12312,WCRK,2016-06-07 15:00:00,211,331,Tuesday,15,542
12313,WCRK,2016-06-07 16:00:00,312,790,Tuesday,16,1102
12314,WCRK,2016-06-07 17:00:00,504,1516,Tuesday,17,2020
12315,WCRK,2016-06-07 18:00:00,481,1212,Tuesday,18,1693
12316,WCRK,2016-06-07 19:00:00,211,598,Tuesday,19,809
12317,WCRK,2016-06-07 20:00:00,105,386,Tuesday,20,491
12318,WCRK,2016-06-07 21:00:00,82,189,Tuesday,21,271
12319,WCRK,2016-06-07 22:00:00,70,217,Tuesday,22,287
12320,WCRK,2016-06-07 23:00:00,40,275,Tuesday,23,315
12321,WCRK,2016-06-08 00:00:00,20,47,Wednesday,0,67
12322,WCRK,2016-06-08 01:00:00,2,13,Wednesday,1,15
12323,WCRK,2016-06-08 04:00:00,25,1,Wednesday,4,26
12324,WCRK,2016-06-08 05:00:00,153,48,Wednesday,5,201
12325,WCRK,2016-06-08 06:00:00,519,142,Wednesday,6,661
12326,WCRK,2016-06-08 07:00:00,1307,323,Wednesday,7,1630
12327,WCRK,2016-06-08 08:00:00,1465,350,Wednesday,8,1815
12328,WCRK,2016-06-08 09:00:00,744,248,Wednesday,9,992
12329,WCRK,2016-06-08 10:00:00,371,150,Wednesday,10,521
12330,WCRK,2016-06-08 11:00:00,220,132,Wednesday,11,352
12331,WCRK,2016-06-08 12:00:00,173,131,Wednesday,12,304
12332,WCRK,2016-06-08 13:00:00,159,173,Wednesday,13,332
12333,WCRK,2016-06-08 14:00:00,160,204,Wednesday,14,364
12334,WCRK,2016-06-08 15:00:00,157,388,Wednesday,15,545
12335,WCRK,2016-06-08 16:00:00,303,755,Wednesday,16,1058
12336,WCRK,2016-06-08 17:00:00,551,1489,Wednesday,17,2040
12337,WCRK,2016-06-08 18:00:00,521,1345,Wednesday,18,1866
12338,WCRK,2016-06-08 19:00:00,222,442,Wednesday,19,664
12339,WCRK,2016-06-08 20:00:00,106,331,Wednesday,20,437
12340,WCRK,2016-06-08 21:00:00,105,294,Wednesday,21,399
12341,WCRK,2016-06-08 22:00:00,70,239,Wednesday,22,309
12342,WCRK,2016-06-08 23:00:00,68,312,Wednesday,23,380
12343,WCRK,2016-06-09 00:00:00,12,60,Thursday,0,72
12344,WCRK,2016-06-09 01:00:00,2,12,Thursday,1,14
12345,WCRK,2016-06-09 04:00:00,1,3,Thursday,4,4
12346,WCRK,2016-06-09 05:00:00,171,58,Thursday,5,229
12347,WCRK,2016-06-09 06:00:00,486,162,Thursday,6,648
12348,WCRK,2016-06-09 07:00:00,1171,324,Thursday,7,1495
12349,WCRK,2016-06-09 08:00:00,1423,298,Thursday,8,1721
12350,WCRK,2016-06-09 09:00:00,739,222,Thursday,9,961
12351,WCRK,2016-06-09 10:00:00,387,160,Thursday,10,547
12352,WCRK,2016-06-09 11:00:00,250,138,Thursday,11,388
12353,WCRK,2016-06-09 12:00:00,196,178,Thursday,12,374
12354,WCRK,2016-06-09 13:00:00,163,172,Thursday,13,335
12355,WCRK,2016-06-09 14:00:00,199,289,Thursday,14,488
12356,WCRK,2016-06-09 15:00:00,144,396,Thursday,15,540
12357,WCRK,2016-06-09 16:00:00,275,817,Thursday,16,1092
12358,WCRK,2016-06-09 17:00:00,430,1344,Thursday,17,1774
12359,WCRK,2016-06-09 18:00:00,391,1259,Thursday,18,1650
12360,WCRK,2016-06-09 19:00:00,236,529,Thursday,19,765
12361,WCRK,2016-06-09 20:00:00,96,379,Thursday,20,475
12362,WCRK,2016-06-09 21:00:00,102,232,Thursday,21,334
12363,WCRK,2016-06-09 22:00:00,95,190,Thursday,22,285
12364,WCRK,2016-06-09 23:00:00,64,148,Thursday,23,212
12365,WCRK,2016-06-10 00:00:00,26,43,Friday,0,69
12366,WCRK,2016-06-10 01:00:00,4,11,Friday,1,15
12367,WCRK,2016-06-10 05:00:00,146,36,Friday,5,182
12368,WCRK,2016-06-10 06:00:00,440,158,Friday,6,598
12369,WCRK,2016-06-10 07:00:00,930,321,Friday,7,1251
12370,WCRK,2016-06-10 08:00:00,1269,303,Friday,8,1572
12371,WCRK,2016-06-10 09:00:00,563,231,Friday,9,794
12372,WCRK,2016-06-10 10:00:00,372,162,Friday,10,534
12373,WCRK,2016-06-10 11:00:00,247,180,Friday,11,427
12374,WCRK,2016-06-10 12:00:00,175,195,Friday,12,370
12375,WCRK,2016-06-10 13:00:00,189,246,Friday,13,435
12376,WCRK,2016-06-10 14:00:00,207,322,Friday,14,529
12377,WCRK,2016-06-10 15:00:00,242,461,Friday,15,703
12378,WCRK,2016-06-10 16:00:00,394,839,Friday,16,1233
12379,WCRK,2016-06-10 17:00:00,553,1184,Friday,17,1737
12380,WCRK,2016-06-10 18:00:00,506,942,Friday,18,1448
12381,WCRK,2016-06-10 19:00:00,236,346,Friday,19,582
12382,WCRK,2016-06-10 20:00:00,134,256,Friday,20,390
12383,WCRK,2016-06-10 21:00:00,92,204,Friday,21,296
12384,WCRK,2016-06-10 22:00:00,110,322,Friday,22,432
12385,WCRK,2016-06-10 23:00:00,83,279,Friday,23,362
12386,WCRK,2016-06-11 00:00:00,42,107,Saturday,0,149
12387,WCRK,2016-06-11 01:00:00,8,41,Saturday,1,49
12388,WCRK,2016-06-11 06:00:00,8,44,Saturday,6,52
12389,WCRK,2016-06-11 07:00:00,86,67,Saturday,7,153
12390,WCRK,2016-06-11 08:00:00,136,98,Saturday,8,234
12391,WCRK,2016-06-11 09:00:00,148,149,Saturday,9,297
12392,WCRK,2016-06-11 10:00:00,197,141,Saturday,10,338
12393,WCRK,2016-06-11 11:00:00,234,140,Saturday,11,374
12394,WCRK,2016-06-11 12:00:00,251,144,Saturday,12,395
12395,WCRK,2016-06-11 13:00:00,223,170,Saturday,13,393
12396,WCRK,2016-06-11 14:00:00,320,122,Saturday,14,442
12397,WCRK,2016-06-11 15:00:00,210,184,Saturday,15,394
12398,WCRK,2016-06-11 16:00:00,228,247,Saturday,16,475
12399,WCRK,2016-06-11 17:00:00,262,156,Saturday,17,418
12400,WCRK,2016-06-11 18:00:00,166,228,Saturday,18,394
12401,WCRK,2016-06-11 19:00:00,148,258,Saturday,19,406
12402,WCRK,2016-06-11 20:00:00,109,225,Saturday,20,334
12403,WCRK,2016-06-11 21:00:00,96,214,Saturday,21,310
12404,WCRK,2016-06-11 22:00:00,88,271,Saturday,22,359
12405,WCRK,2016-06-11 23:00:00,89,153,Saturday,23,242
12406,WCRK,2016-06-12 00:00:00,28,89,Sunday,0,117
12407,WCRK,2016-06-12 01:00:00,6,32,Sunday,1,38
12408,WCRK,2016-06-12 08:00:00,42,93,Sunday,8,135
12409,WCRK,2016-06-12 09:00:00,118,127,Sunday,9,245
12410,WCRK,2016-06-12 10:00:00,153,118,Sunday,10,271
12411,WCRK,2016-06-12 11:00:00,266,130,Sunday,11,396
12412,WCRK,2016-06-12 12:00:00,212,126,Sunday,12,338
12413,WCRK,2016-06-12 13:00:00,226,153,Sunday,13,379
12414,WCRK,2016-06-12 14:00:00,213,140,Sunday,14,353
12415,WCRK,2016-06-12 15:00:00,259,136,Sunday,15,395
12416,WCRK,2016-06-12 16:00:00,226,207,Sunday,16,433
12417,WCRK,2016-06-12 17:00:00,163,224,Sunday,17,387
12418,WCRK,2016-06-12 18:00:00,159,159,Sunday,18,318
12419,WCRK,2016-06-12 19:00:00,140,201,Sunday,19,341
12420,WCRK,2016-06-12 20:00:00,112,163,Sunday,20,275
12421,WCRK,2016-06-12 21:00:00,86,249,Sunday,21,335
12422,WCRK,2016-06-12 22:00:00,80,199,Sunday,22,279
12423,WCRK,2016-06-12 23:00:00,47,65,Sunday,23,112
12424,WCRK,2016-06-13 00:00:00,19,40,Monday,0,59
12425,WCRK,2016-06-13 01:00:00,5,6,Monday,1,11
12426,WCRK,2016-06-13 05:00:00,166,39,Monday,5,205
12427,WCRK,2016-06-13 06:00:00,496,148,Monday,6,644
12428,WCRK,2016-06-13 07:00:00,1305,286,Monday,7,1591
12429,WCRK,2016-06-13 08:00:00,1443,320,Monday,8,1763
12430,WCRK,2016-06-13 09:00:00,783,189,Monday,9,972
12431,WCRK,2016-06-13 10:00:00,356,138,Monday,10,494
12432,WCRK,2016-06-13 11:00:00,216,140,Monday,11,356
12433,WCRK,2016-06-13 12:00:00,181,124,Monday,12,305
12434,WCRK,2016-06-13 13:00:00,157,183,Monday,13,340
12435,WCRK,2016-06-13 14:00:00,154,225,Monday,14,379
12436,WCRK,2016-06-13 15:00:00,221,369,Monday,15,590
12437,WCRK,2016-06-13 16:00:00,275,853,Monday,16,1128
12438,WCRK,2016-06-13 17:00:00,503,1574,Monday,17,2077
12439,WCRK,2016-06-13 18:00:00,452,1155,Monday,18,1607
12440,WCRK,2016-06-13 19:00:00,191,431,Monday,19,622
12441,WCRK,2016-06-13 20:00:00,84,260,Monday,20,344
12442,WCRK,2016-06-13 21:00:00,96,242,Monday,21,338
12443,WCRK,2016-06-13 22:00:00,79,289,Monday,22,368
12444,WCRK,2016-06-13 23:00:00,47,211,Monday,23,258
12445,WCRK,2016-06-14 00:00:00,12,41,Tuesday,0,53
12446,WCRK,2016-06-14 01:00:00,3,8,Tuesday,1,11
12447,WCRK,2016-06-14 04:00:00,18,2,Tuesday,4,20
12448,WCRK,2016-06-14 05:00:00,156,40,Tuesday,5,196
12449,WCRK,2016-06-14 06:00:00,509,168,Tuesday,6,677
12450,WCRK,2016-06-14 07:00:00,1211,312,Tuesday,7,1523
12451,WCRK,2016-06-14 08:00:00,1602,329,Tuesday,8,1931
12452,WCRK,2016-06-14 09:00:00,765,208,Tuesday,9,973
12453,WCRK,2016-06-14 10:00:00,407,176,Tuesday,10,583
12454,WCRK,2016-06-14 11:00:00,225,135,Tuesday,11,360
12455,WCRK,2016-06-14 12:00:00,205,152,Tuesday,12,357
12456,WCRK,2016-06-14 13:00:00,158,195,Tuesday,13,353
12457,WCRK,2016-06-14 14:00:00,168,237,Tuesday,14,405
12458,WCRK,2016-06-14 15:00:00,184,390,Tuesday,15,574
12459,WCRK,2016-06-14 16:00:00,305,794,Tuesday,16,1099
12460,WCRK,2016-06-14 17:00:00,493,1484,Tuesday,17,1977
12461,WCRK,2016-06-14 18:00:00,516,1330,Tuesday,18,1846
12462,WCRK,2016-06-14 19:00:00,194,504,Tuesday,19,698
12463,WCRK,2016-06-14 20:00:00,119,373,Tuesday,20,492
12464,WCRK,2016-06-14 21:00:00,121,155,Tuesday,21,276
12465,WCRK,2016-06-14 22:00:00,71,271,Tuesday,22,342
12466,WCRK,2016-06-14 23:00:00,43,288,Tuesday,23,331
12467,WDUB,2016-06-01 05:00:00,68,16,Wednesday,5,84
12468,WDUB,2016-06-01 06:00:00,261,32,Wednesday,6,293
12469,WDUB,2016-06-01 07:00:00,485,100,Wednesday,7,585
12470,WDUB,2016-06-01 08:00:00,692,174,Wednesday,8,866
12471,WDUB,2016-06-01 09:00:00,563,113,Wednesday,9,676
12472,WDUB,2016-06-01 10:00:00,300,79,Wednesday,10,379
12473,WDUB,2016-06-01 11:00:00,194,56,Wednesday,11,250
12474,WDUB,2016-06-01 12:00:00,140,77,Wednesday,12,217
12475,WDUB,2016-06-01 13:00:00,76,89,Wednesday,13,165
12476,WDUB,2016-06-01 14:00:00,65,100,Wednesday,14,165
12477,WDUB,2016-06-01 15:00:00,72,250,Wednesday,15,322
12478,WDUB,2016-06-01 16:00:00,94,418,Wednesday,16,512
12479,WDUB,2016-06-01 17:00:00,150,547,Wednesday,17,697
12480,WDUB,2016-06-01 18:00:00,169,943,Wednesday,18,1112
12481,WDUB,2016-06-01 19:00:00,100,389,Wednesday,19,489
12482,WDUB,2016-06-01 20:00:00,40,172,Wednesday,20,212
12483,WDUB,2016-06-01 21:00:00,56,103,Wednesday,21,159
12484,WDUB,2016-06-01 22:00:00,49,71,Wednesday,22,120
12485,WDUB,2016-06-01 23:00:00,22,55,Wednesday,23,77
12486,WDUB,2016-06-02 00:00:00,10,12,Thursday,0,22
12487,WDUB,2016-06-02 05:00:00,74,21,Thursday,5,95
12488,WDUB,2016-06-02 06:00:00,260,30,Thursday,6,290
12489,WDUB,2016-06-02 07:00:00,441,100,Thursday,7,541
12490,WDUB,2016-06-02 08:00:00,680,140,Thursday,8,820
12491,WDUB,2016-06-02 09:00:00,640,127,Thursday,9,767
12492,WDUB,2016-06-02 10:00:00,285,57,Thursday,10,342
12493,WDUB,2016-06-02 11:00:00,138,62,Thursday,11,200
12494,WDUB,2016-06-02 12:00:00,84,68,Thursday,12,152
12495,WDUB,2016-06-02 13:00:00,58,61,Thursday,13,119
12496,WDUB,2016-06-02 14:00:00,84,115,Thursday,14,199
12497,WDUB,2016-06-02 15:00:00,95,288,Thursday,15,383
12498,WDUB,2016-06-02 16:00:00,147,264,Thursday,16,411
12499,WDUB,2016-06-02 17:00:00,234,883,Thursday,17,1117
12500,WDUB,2016-06-02 18:00:00,189,659,Thursday,18,848
12501,WDUB,2016-06-02 19:00:00,85,326,Thursday,19,411
12502,WDUB,2016-06-02 20:00:00,47,163,Thursday,20,210
12503,WDUB,2016-06-02 21:00:00,60,242,Thursday,21,302
12504,WDUB,2016-06-02 22:00:00,37,96,Thursday,22,133
12505,WDUB,2016-06-02 23:00:00,27,49,Thursday,23,76
12506,WDUB,2016-06-03 00:00:00,8,23,Friday,0,31
12507,WDUB,2016-06-03 01:00:00,1,12,Friday,1,13
12508,WDUB,2016-06-03 04:00:00,2,1,Friday,4,3
12509,WDUB,2016-06-03 05:00:00,63,14,Friday,5,77
12510,WDUB,2016-06-03 06:00:00,211,31,Friday,6,242
12511,WDUB,2016-06-03 07:00:00,373,109,Friday,7,482
12512,WDUB,2016-06-03 08:00:00,585,127,Friday,8,712
12513,WDUB,2016-06-03 09:00:00,487,92,Friday,9,579
12514,WDUB,2016-06-03 10:00:00,254,68,Friday,10,322
12515,WDUB,2016-06-03 11:00:00,120,61,Friday,11,181
12516,WDUB,2016-06-03 12:00:00,95,90,Friday,12,185
12517,WDUB,2016-06-03 13:00:00,77,116,Friday,13,193
12518,WDUB,2016-06-03 14:00:00,74,136,Friday,14,210
12519,WDUB,2016-06-03 15:00:00,67,220,Friday,15,287
12520,WDUB,2016-06-03 16:00:00,127,436,Friday,16,563
12521,WDUB,2016-06-03 17:00:00,184,483,Friday,17,667
12522,WDUB,2016-06-03 18:00:00,204,629,Friday,18,833
12523,WDUB,2016-06-03 19:00:00,130,261,Friday,19,391
12524,WDUB,2016-06-03 20:00:00,63,135,Friday,20,198
12525,WDUB,2016-06-03 21:00:00,47,93,Friday,21,140
12526,WDUB,2016-06-03 22:00:00,54,101,Friday,22,155
12527,WDUB,2016-06-03 23:00:00,22,63,Friday,23,85
12528,WDUB,2016-06-04 00:00:00,9,62,Saturday,0,71
12529,WDUB,2016-06-04 01:00:00,3,5,Saturday,1,8
12530,WDUB,2016-06-04 05:00:00,1,1,Saturday,5,2
12531,WDUB,2016-06-04 07:00:00,30,39,Saturday,7,69
12532,WDUB,2016-06-04 08:00:00,49,58,Saturday,8,107
12533,WDUB,2016-06-04 09:00:00,65,61,Saturday,9,126
12534,WDUB,2016-06-04 10:00:00,89,62,Saturday,10,151
12535,WDUB,2016-06-04 11:00:00,103,95,Saturday,11,198
12536,WDUB,2016-06-04 12:00:00,105,64,Saturday,12,169
12537,WDUB,2016-06-04 13:00:00,94,79,Saturday,13,173
12538,WDUB,2016-06-04 14:00:00,76,67,Saturday,14,143
12539,WDUB,2016-06-04 15:00:00,52,121,Saturday,15,173
12540,WDUB,2016-06-04 16:00:00,92,91,Saturday,16,183
12541,WDUB,2016-06-04 17:00:00,121,72,Saturday,17,193
12542,WDUB,2016-06-04 18:00:00,107,97,Saturday,18,204
12543,WDUB,2016-06-04 19:00:00,107,123,Saturday,19,230
12544,WDUB,2016-06-04 20:00:00,55,86,Saturday,20,141
12545,WDUB,2016-06-04 21:00:00,70,62,Saturday,21,132
12546,WDUB,2016-06-04 22:00:00,50,82,Saturday,22,132
12547,WDUB,2016-06-04 23:00:00,35,64,Saturday,23,99
12548,WDUB,2016-06-05 00:00:00,8,50,Sunday,0,58
12549,WDUB,2016-06-05 01:00:00,4,6,Sunday,1,10
12550,WDUB,2016-06-05 08:00:00,13,49,Sunday,8,62
12551,WDUB,2016-06-05 09:00:00,50,36,Sunday,9,86
12552,WDUB,2016-06-05 10:00:00,66,85,Sunday,10,151
12553,WDUB,2016-06-05 11:00:00,81,74,Sunday,11,155
12554,WDUB,2016-06-05 12:00:00,93,54,Sunday,12,147
12555,WDUB,2016-06-05 13:00:00,71,55,Sunday,13,126
12556,WDUB,2016-06-05 14:00:00,109,84,Sunday,14,193
12557,WDUB,2016-06-05 15:00:00,124,61,Sunday,15,185
12558,WDUB,2016-06-05 16:00:00,120,71,Sunday,16,191
12559,WDUB,2016-06-05 17:00:00,72,67,Sunday,17,139
12560,WDUB,2016-06-05 18:00:00,105,75,Sunday,18,180
12561,WDUB,2016-06-05 19:00:00,76,71,Sunday,19,147
12562,WDUB,2016-06-05 20:00:00,42,205,Sunday,20,247
12563,WDUB,2016-06-05 21:00:00,52,65,Sunday,21,117
12564,WDUB,2016-06-05 22:00:00,17,27,Sunday,22,44
12565,WDUB,2016-06-05 23:00:00,12,24,Sunday,23,36
12566,WDUB,2016-06-06 00:00:00,4,21,Monday,0,25
12567,WDUB,2016-06-06 01:00:00,1,1,Monday,1,2
12568,WDUB,2016-06-06 05:00:00,61,17,Monday,5,78
12569,WDUB,2016-06-06 06:00:00,262,31,Monday,6,293
12570,WDUB,2016-06-06 07:00:00,479,111,Monday,7,590
12571,WDUB,2016-06-06 08:00:00,704,133,Monday,8,837
12572,WDUB,2016-06-06 09:00:00,700,126,Monday,9,826
12573,WDUB,2016-06-06 10:00:00,263,70,Monday,10,333
12574,WDUB,2016-06-06 11:00:00,126,58,Monday,11,184
12575,WDUB,2016-06-06 12:00:00,88,62,Monday,12,150
12576,WDUB,2016-06-06 13:00:00,61,75,Monday,13,136
12577,WDUB,2016-06-06 14:00:00,52,112,Monday,14,164
12578,WDUB,2016-06-06 15:00:00,63,223,Monday,15,286
12579,WDUB,2016-06-06 16:00:00,102,440,Monday,16,542
12580,WDUB,2016-06-06 17:00:00,152,751,Monday,17,903
12581,WDUB,2016-06-06 18:00:00,151,581,Monday,18,732
12582,WDUB,2016-06-06 19:00:00,98,537,Monday,19,635
12583,WDUB,2016-06-06 20:00:00,60,157,Monday,20,217
12584,WDUB,2016-06-06 21:00:00,85,102,Monday,21,187
12585,WDUB,2016-06-06 22:00:00,43,106,Monday,22,149
12586,WDUB,2016-06-06 23:00:00,18,51,Monday,23,69
12587,WDUB,2016-06-07 00:00:00,10,19,Tuesday,0,29
12588,WDUB,2016-06-07 01:00:00,2,7,Tuesday,1,9
12589,WDUB,2016-06-07 05:00:00,69,16,Tuesday,5,85
12590,WDUB,2016-06-07 06:00:00,252,32,Tuesday,6,284
12591,WDUB,2016-06-07 07:00:00,479,110,Tuesday,7,589
12592,WDUB,2016-06-07 08:00:00,634,154,Tuesday,8,788
12593,WDUB,2016-06-07 09:00:00,638,114,Tuesday,9,752
12594,WDUB,2016-06-07 10:00:00,276,67,Tuesday,10,343
12595,WDUB,2016-06-07 11:00:00,124,64,Tuesday,11,188
12596,WDUB,2016-06-07 12:00:00,95,73,Tuesday,12,168
12597,WDUB,2016-06-07 13:00:00,62,75,Tuesday,13,137
12598,WDUB,2016-06-07 14:00:00,67,105,Tuesday,14,172
12599,WDUB,2016-06-07 15:00:00,78,187,Tuesday,15,265
12600,WDUB,2016-06-07 16:00:00,132,405,Tuesday,16,537
12601,WDUB,2016-06-07 17:00:00,224,765,Tuesday,17,989
12602,WDUB,2016-06-07 18:00:00,239,683,Tuesday,18,922
12603,WDUB,2016-06-07 19:00:00,112,363,Tuesday,19,475
12604,WDUB,2016-06-07 20:00:00,55,160,Tuesday,20,215
12605,WDUB,2016-06-07 21:00:00,65,123,Tuesday,21,188
12606,WDUB,2016-06-07 22:00:00,33,128,Tuesday,22,161
12607,WDUB,2016-06-07 23:00:00,18,168,Tuesday,23,186
12608,WDUB,2016-06-08 00:00:00,12,18,Wednesday,0,30
12609,WDUB,2016-06-08 05:00:00,69,15,Wednesday,5,84
12610,WDUB,2016-06-08 06:00:00,225,42,Wednesday,6,267
12611,WDUB,2016-06-08 07:00:00,478,101,Wednesday,7,579
12612,WDUB,2016-06-08 08:00:00,630,166,Wednesday,8,796
12613,WDUB,2016-06-08 09:00:00,564,138,Wednesday,9,702
12614,WDUB,2016-06-08 10:00:00,296,70,Wednesday,10,366
12615,WDUB,2016-06-08 11:00:00,136,60,Wednesday,11,196
12616,WDUB,2016-06-08 12:00:00,89,63,Wednesday,12,152
12617,WDUB,2016-06-08 13:00:00,87,83,Wednesday,13,170
12618,WDUB,2016-06-08 14:00:00,90,101,Wednesday,14,191
12619,WDUB,2016-06-08 15:00:00,75,203,Wednesday,15,278
12620,WDUB,2016-06-08 16:00:00,134,405,Wednesday,16,539
12621,WDUB,2016-06-08 17:00:00,287,727,Wednesday,17,1014
12622,WDUB,2016-06-08 18:00:00,251,689,Wednesday,18,940
12623,WDUB,2016-06-08 19:00:00,112,312,Wednesday,19,424
12624,WDUB,2016-06-08 20:00:00,54,179,Wednesday,20,233
12625,WDUB,2016-06-08 21:00:00,60,196,Wednesday,21,256
12626,WDUB,2016-06-08 22:00:00,46,104,Wednesday,22,150
12627,WDUB,2016-06-08 23:00:00,29,169,Wednesday,23,198
12628,WDUB,2016-06-09 00:00:00,8,34,Thursday,0,42
12629,WDUB,2016-06-09 05:00:00,75,11,Thursday,5,86
12630,WDUB,2016-06-09 06:00:00,210,38,Thursday,6,248
12631,WDUB,2016-06-09 07:00:00,485,104,Thursday,7,589
12632,WDUB,2016-06-09 08:00:00,616,183,Thursday,8,799
12633,WDUB,2016-06-09 09:00:00,548,118,Thursday,9,666
12634,WDUB,2016-06-09 10:00:00,270,79,Thursday,10,349
12635,WDUB,2016-06-09 11:00:00,119,56,Thursday,11,175
12636,WDUB,2016-06-09 12:00:00,70,67,Thursday,12,137
12637,WDUB,2016-06-09 13:00:00,106,92,Thursday,13,198
12638,WDUB,2016-06-09 14:00:00,64,135,Thursday,14,199
12639,WDUB,2016-06-09 15:00:00,83,191,Thursday,15,274
12640,WDUB,2016-06-09 16:00:00,137,402,Thursday,16,539
12641,WDUB,2016-06-09 17:00:00,202,640,Thursday,17,842
12642,WDUB,2016-06-09 18:00:00,199,683,Thursday,18,882
12643,WDUB,2016-06-09 19:00:00,82,358,Thursday,19,440
12644,WDUB,2016-06-09 20:00:00,60,158,Thursday,20,218
12645,WDUB,2016-06-09 21:00:00,70,138,Thursday,21,208
12646,WDUB,2016-06-09 22:00:00,49,100,Thursday,22,149
12647,WDUB,2016-06-09 23:00:00,21,61,Thursday,23,82
12648,WDUB,2016-06-10 00:00:00,11,25,Friday,0,36
12649,WDUB,2016-06-10 05:00:00,59,16,Friday,5,75
12650,WDUB,2016-06-10 06:00:00,190,35,Friday,6,225
12651,WDUB,2016-06-10 07:00:00,365,95,Friday,7,460
12652,WDUB,2016-06-10 08:00:00,524,119,Friday,8,643
12653,WDUB,2016-06-10 09:00:00,465,99,Friday,9,564
12654,WDUB,2016-06-10 10:00:00,248,75,Friday,10,323
12655,WDUB,2016-06-10 11:00:00,145,77,Friday,11,222
12656,WDUB,2016-06-10 12:00:00,119,101,Friday,12,220
12657,WDUB,2016-06-10 13:00:00,97,114,Friday,13,211
12658,WDUB,2016-06-10 14:00:00,71,145,Friday,14,216
12659,WDUB,2016-06-10 15:00:00,98,243,Friday,15,341
12660,WDUB,2016-06-10 16:00:00,177,435,Friday,16,612
12661,WDUB,2016-06-10 17:00:00,296,625,Friday,17,921
12662,WDUB,2016-06-10 18:00:00,247,511,Friday,18,758
12663,WDUB,2016-06-10 19:00:00,116,230,Friday,19,346
12664,WDUB,2016-06-10 20:00:00,61,117,Friday,20,178
12665,WDUB,2016-06-10 21:00:00,48,147,Friday,21,195
12666,WDUB,2016-06-10 22:00:00,49,119,Friday,22,168
12667,WDUB,2016-06-10 23:00:00,29,159,Friday,23,188
12668,WDUB,2016-06-11 00:00:00,16,69,Saturday,0,85
12669,WDUB,2016-06-11 01:00:00,1,23,Saturday,1,24
12670,WDUB,2016-06-11 06:00:00,8,10,Saturday,6,18
12671,WDUB,2016-06-11 07:00:00,30,28,Saturday,7,58
12672,WDUB,2016-06-11 08:00:00,53,60,Saturday,8,113
12673,WDUB,2016-06-11 09:00:00,73,60,Saturday,9,133
12674,WDUB,2016-06-11 10:00:00,120,79,Saturday,10,199
12675,WDUB,2016-06-11 11:00:00,142,88,Saturday,11,230
12676,WDUB,2016-06-11 12:00:00,107,80,Saturday,12,187
12677,WDUB,2016-06-11 13:00:00,167,86,Saturday,13,253
12678,WDUB,2016-06-11 14:00:00,150,83,Saturday,14,233
12679,WDUB,2016-06-11 15:00:00,115,113,Saturday,15,228
12680,WDUB,2016-06-11 16:00:00,96,77,Saturday,16,173
12681,WDUB,2016-06-11 17:00:00,111,124,Saturday,17,235
12682,WDUB,2016-06-11 18:00:00,94,121,Saturday,18,215
12683,WDUB,2016-06-11 19:00:00,98,105,Saturday,19,203
12684,WDUB,2016-06-11 20:00:00,64,87,Saturday,20,151
12685,WDUB,2016-06-11 21:00:00,60,110,Saturday,21,170
12686,WDUB,2016-06-11 22:00:00,48,180,Saturday,22,228
12687,WDUB,2016-06-11 23:00:00,36,85,Saturday,23,121
12688,WDUB,2016-06-12 00:00:00,13,50,Sunday,0,63
12689,WDUB,2016-06-12 01:00:00,3,28,Sunday,1,31
12690,WDUB,2016-06-12 08:00:00,18,50,Sunday,8,68
12691,WDUB,2016-06-12 09:00:00,38,46,Sunday,9,84
12692,WDUB,2016-06-12 10:00:00,64,78,Sunday,10,142
12693,WDUB,2016-06-12 11:00:00,90,85,Sunday,11,175
12694,WDUB,2016-06-12 12:00:00,86,59,Sunday,12,145
12695,WDUB,2016-06-12 13:00:00,82,73,Sunday,13,155
12696,WDUB,2016-06-12 14:00:00,89,59,Sunday,14,148
12697,WDUB,2016-06-12 15:00:00,94,80,Sunday,15,174
12698,WDUB,2016-06-12 16:00:00,114,63,Sunday,16,177
12699,WDUB,2016-06-12 17:00:00,85,79,Sunday,17,164
12700,WDUB,2016-06-12 18:00:00,106,74,Sunday,18,180
12701,WDUB,2016-06-12 19:00:00,98,84,Sunday,19,182
12702,WDUB,2016-06-12 20:00:00,73,67,Sunday,20,140
12703,WDUB,2016-06-12 21:00:00,46,89,Sunday,21,135
12704,WDUB,2016-06-12 22:00:00,32,121,Sunday,22,153
12705,WDUB,2016-06-12 23:00:00,17,41,Sunday,23,58
12706,WDUB,2016-06-13 00:00:00,6,48,Monday,0,54
12707,WDUB,2016-06-13 05:00:00,69,12,Monday,5,81
12708,WDUB,2016-06-13 06:00:00,211,31,Monday,6,242
12709,WDUB,2016-06-13 07:00:00,457,109,Monday,7,566
12710,WDUB,2016-06-13 08:00:00,664,158,Monday,8,822
12711,WDUB,2016-06-13 09:00:00,573,115,Monday,9,688
12712,WDUB,2016-06-13 10:00:00,293,75,Monday,10,368
12713,WDUB,2016-06-13 11:00:00,130,56,Monday,11,186
12714,WDUB,2016-06-13 12:00:00,81,58,Monday,12,139
12715,WDUB,2016-06-13 13:00:00,89,113,Monday,13,202
12716,WDUB,2016-06-13 14:00:00,71,120,Monday,14,191
12717,WDUB,2016-06-13 15:00:00,129,194,Monday,15,323
12718,WDUB,2016-06-13 16:00:00,203,443,Monday,16,646
12719,WDUB,2016-06-13 17:00:00,331,650,Monday,17,981
12720,WDUB,2016-06-13 18:00:00,319,729,Monday,18,1048
12721,WDUB,2016-06-13 19:00:00,124,276,Monday,19,400
12722,WDUB,2016-06-13 20:00:00,61,142,Monday,20,203
12723,WDUB,2016-06-13 21:00:00,49,316,Monday,21,365
12724,WDUB,2016-06-13 22:00:00,43,201,Monday,22,244
12725,WDUB,2016-06-13 23:00:00,20,160,Monday,23,180
12726,WDUB,2016-06-14 00:00:00,24,76,Tuesday,0,100
12727,WDUB,2016-06-14 01:00:00,1,15,Tuesday,1,16
12728,WDUB,2016-06-14 05:00:00,77,17,Tuesday,5,94
12729,WDUB,2016-06-14 06:00:00,227,36,Tuesday,6,263
12730,WDUB,2016-06-14 07:00:00,481,113,Tuesday,7,594
12731,WDUB,2016-06-14 08:00:00,651,182,Tuesday,8,833
12732,WDUB,2016-06-14 09:00:00,660,125,Tuesday,9,785
12733,WDUB,2016-06-14 10:00:00,282,63,Tuesday,10,345
12734,WDUB,2016-06-14 11:00:00,136,55,Tuesday,11,191
12735,WDUB,2016-06-14 12:00:00,92,43,Tuesday,12,135
12736,WDUB,2016-06-14 13:00:00,66,96,Tuesday,13,162
12737,WDUB,2016-06-14 14:00:00,81,112,Tuesday,14,193
12738,WDUB,2016-06-14 15:00:00,77,197,Tuesday,15,274
12739,WDUB,2016-06-14 16:00:00,138,394,Tuesday,16,532
12740,WDUB,2016-06-14 17:00:00,220,709,Tuesday,17,929
12741,WDUB,2016-06-14 18:00:00,261,732,Tuesday,18,993
12742,WDUB,2016-06-14 19:00:00,119,376,Tuesday,19,495
12743,WDUB,2016-06-14 20:00:00,63,175,Tuesday,20,238
12744,WDUB,2016-06-14 21:00:00,63,150,Tuesday,21,213
12745,WDUB,2016-06-14 22:00:00,49,123,Tuesday,22,172
12746,WDUB,2016-06-14 23:00:00,15,156,Tuesday,23,171
12747,WOAK,2016-06-01 01:00:00,4,5,Wednesday,1,9
12748,WOAK,2016-06-01 04:00:00,43,14,Wednesday,4,57
12749,WOAK,2016-06-01 05:00:00,223,31,Wednesday,5,254
12750,WOAK,2016-06-01 06:00:00,508,83,Wednesday,6,591
12751,WOAK,2016-06-01 07:00:00,931,140,Wednesday,7,1071
12752,WOAK,2016-06-01 08:00:00,1448,169,Wednesday,8,1617
12753,WOAK,2016-06-01 09:00:00,1099,148,Wednesday,9,1247
12754,WOAK,2016-06-01 10:00:00,621,120,Wednesday,10,741
12755,WOAK,2016-06-01 11:00:00,325,143,Wednesday,11,468
12756,WOAK,2016-06-01 12:00:00,300,194,Wednesday,12,494
12757,WOAK,2016-06-01 13:00:00,258,268,Wednesday,13,526
12758,WOAK,2016-06-01 14:00:00,245,345,Wednesday,14,590
12759,WOAK,2016-06-01 15:00:00,262,533,Wednesday,15,795
12760,WOAK,2016-06-01 16:00:00,270,689,Wednesday,16,959
12761,WOAK,2016-06-01 17:00:00,350,1271,Wednesday,17,1621
12762,WOAK,2016-06-01 18:00:00,285,1107,Wednesday,18,1392
12763,WOAK,2016-06-01 19:00:00,179,656,Wednesday,19,835
12764,WOAK,2016-06-01 20:00:00,127,465,Wednesday,20,592
12765,WOAK,2016-06-01 21:00:00,106,374,Wednesday,21,480
12766,WOAK,2016-06-01 22:00:00,103,287,Wednesday,22,390
12767,WOAK,2016-06-01 23:00:00,51,196,Wednesday,23,247
12768,WOAK,2016-06-02 00:00:00,37,109,Thursday,0,146
12769,WOAK,2016-06-02 01:00:00,3,2,Thursday,1,5
12770,WOAK,2016-06-02 04:00:00,48,18,Thursday,4,66
12771,WOAK,2016-06-02 05:00:00,210,31,Thursday,5,241
12772,WOAK,2016-06-02 06:00:00,490,97,Thursday,6,587
12773,WOAK,2016-06-02 07:00:00,898,129,Thursday,7,1027
12774,WOAK,2016-06-02 08:00:00,1475,199,Thursday,8,1674
12775,WOAK,2016-06-02 09:00:00,1123,172,Thursday,9,1295
12776,WOAK,2016-06-02 10:00:00,517,186,Thursday,10,703
12777,WOAK,2016-06-02 11:00:00,326,122,Thursday,11,448
12778,WOAK,2016-06-02 12:00:00,248,266,Thursday,12,514
12779,WOAK,2016-06-02 13:00:00,328,271,Thursday,13,599
12780,WOAK,2016-06-02 14:00:00,261,321,Thursday,14,582
12781,WOAK,2016-06-02 15:00:00,421,517,Thursday,15,938
12782,WOAK,2016-06-02 16:00:00,264,788,Thursday,16,1052
12783,WOAK,2016-06-02 17:00:00,394,1383,Thursday,17,1777
12784,WOAK,2016-06-02 18:00:00,369,907,Thursday,18,1276
12785,WOAK,2016-06-02 19:00:00,196,488,Thursday,19,684
12786,WOAK,2016-06-02 20:00:00,125,440,Thursday,20,565
12787,WOAK,2016-06-02 21:00:00,128,478,Thursday,21,606
12788,WOAK,2016-06-02 22:00:00,103,337,Thursday,22,440
12789,WOAK,2016-06-02 23:00:00,66,245,Thursday,23,311
12790,WOAK,2016-06-03 00:00:00,30,132,Friday,0,162
12791,WOAK,2016-06-03 01:00:00,6,2,Friday,1,8
12792,WOAK,2016-06-03 04:00:00,29,10,Friday,4,39
12793,WOAK,2016-06-03 05:00:00,223,30,Friday,5,253
12794,WOAK,2016-06-03 06:00:00,464,84,Friday,6,548
12795,WOAK,2016-06-03 07:00:00,867,121,Friday,7,988
12796,WOAK,2016-06-03 08:00:00,1254,159,Friday,8,1413
12797,WOAK,2016-06-03 09:00:00,944,167,Friday,9,1111
12798,WOAK,2016-06-03 10:00:00,549,130,Friday,10,679
12799,WOAK,2016-06-03 11:00:00,316,154,Friday,11,470
12800,WOAK,2016-06-03 12:00:00,284,216,Friday,12,500
12801,WOAK,2016-06-03 13:00:00,273,301,Friday,13,574
12802,WOAK,2016-06-03 14:00:00,246,377,Friday,14,623
12803,WOAK,2016-06-03 15:00:00,309,534,Friday,15,843
12804,WOAK,2016-06-03 16:00:00,322,798,Friday,16,1120
12805,WOAK,2016-06-03 17:00:00,401,1052,Friday,17,1453
12806,WOAK,2016-06-03 18:00:00,317,904,Friday,18,1221
12807,WOAK,2016-06-03 19:00:00,301,590,Friday,19,891
12808,WOAK,2016-06-03 20:00:00,173,449,Friday,20,622
12809,WOAK,2016-06-03 21:00:00,147,361,Friday,21,508
12810,WOAK,2016-06-03 22:00:00,106,347,Friday,22,453
12811,WOAK,2016-06-03 23:00:00,68,290,Friday,23,358
12812,WOAK,2016-06-04 00:00:00,75,185,Saturday,0,260
12813,WOAK,2016-06-04 06:00:00,121,35,Saturday,6,156
12814,WOAK,2016-06-04 07:00:00,241,51,Saturday,7,292
12815,WOAK,2016-06-04 08:00:00,286,62,Saturday,8,348
12816,WOAK,2016-06-04 09:00:00,325,62,Saturday,9,387
12817,WOAK,2016-06-04 10:00:00,360,143,Saturday,10,503
12818,WOAK,2016-06-04 11:00:00,311,125,Saturday,11,436
12819,WOAK,2016-06-04 12:00:00,308,151,Saturday,12,459
12820,WOAK,2016-06-04 13:00:00,308,217,Saturday,13,525
12821,WOAK,2016-06-04 14:00:00,280,237,Saturday,14,517
12822,WOAK,2016-06-04 15:00:00,282,278,Saturday,15,560
12823,WOAK,2016-06-04 16:00:00,280,329,Saturday,16,609
12824,WOAK,2016-06-04 17:00:00,267,313,Saturday,17,580
12825,WOAK,2016-06-04 18:00:00,210,310,Saturday,18,520
12826,WOAK,2016-06-04 19:00:00,213,313,Saturday,19,526
12827,WOAK,2016-06-04 20:00:00,163,278,Saturday,20,441
12828,WOAK,2016-06-04 21:00:00,146,267,Saturday,21,413
12829,WOAK,2016-06-04 22:00:00,90,296,Saturday,22,386
12830,WOAK,2016-06-04 23:00:00,75,246,Saturday,23,321
12831,WOAK,2016-06-05 00:00:00,51,157,Sunday,0,208
12832,WOAK,2016-06-05 01:00:00,2,1,Sunday,1,3
12833,WOAK,2016-06-05 08:00:00,175,64,Sunday,8,239
12834,WOAK,2016-06-05 09:00:00,214,69,Sunday,9,283
12835,WOAK,2016-06-05 10:00:00,293,96,Sunday,10,389
12836,WOAK,2016-06-05 11:00:00,295,92,Sunday,11,387
12837,WOAK,2016-06-05 12:00:00,254,119,Sunday,12,373
12838,WOAK,2016-06-05 13:00:00,338,159,Sunday,13,497
12839,WOAK,2016-06-05 14:00:00,229,185,Sunday,14,414
12840,WOAK,2016-06-05 15:00:00,243,247,Sunday,15,490
12841,WOAK,2016-06-05 16:00:00,234,262,Sunday,16,496
12842,WOAK,2016-06-05 17:00:00,187,306,Sunday,17,493
12843,WOAK,2016-06-05 18:00:00,171,275,Sunday,18,446
12844,WOAK,2016-06-05 19:00:00,99,240,Sunday,19,339
12845,WOAK,2016-06-05 20:00:00,114,226,Sunday,20,340
12846,WOAK,2016-06-05 21:00:00,111,203,Sunday,21,314
12847,WOAK,2016-06-05 22:00:00,82,162,Sunday,22,244
12848,WOAK,2016-06-05 23:00:00,41,139,Sunday,23,180
12849,WOAK,2016-06-06 00:00:00,28,48,Monday,0,76
12850,WOAK,2016-06-06 04:00:00,38,10,Monday,4,48
12851,WOAK,2016-06-06 05:00:00,194,25,Monday,5,219
12852,WOAK,2016-06-06 06:00:00,452,83,Monday,6,535
12853,WOAK,2016-06-06 07:00:00,868,144,Monday,7,1012
12854,WOAK,2016-06-06 08:00:00,1386,159,Monday,8,1545
12855,WOAK,2016-06-06 09:00:00,1102,166,Monday,9,1268
12856,WOAK,2016-06-06 10:00:00,540,112,Monday,10,652
12857,WOAK,2016-06-06 11:00:00,272,106,Monday,11,378
12858,WOAK,2016-06-06 12:00:00,214,170,Monday,12,384
12859,WOAK,2016-06-06 13:00:00,233,225,Monday,13,458
12860,WOAK,2016-06-06 14:00:00,252,336,Monday,14,588
12861,WOAK,2016-06-06 15:00:00,268,467,Monday,15,735
12862,WOAK,2016-06-06 16:00:00,248,726,Monday,16,974
12863,WOAK,2016-06-06 17:00:00,324,1219,Monday,17,1543
12864,WOAK,2016-06-06 18:00:00,280,1007,Monday,18,1287
12865,WOAK,2016-06-06 19:00:00,165,598,Monday,19,763
12866,WOAK,2016-06-06 20:00:00,116,397,Monday,20,513
12867,WOAK,2016-06-06 21:00:00,117,354,Monday,21,471
12868,WOAK,2016-06-06 22:00:00,77,269,Monday,22,346
12869,WOAK,2016-06-06 23:00:00,42,208,Monday,23,250
12870,WOAK,2016-06-07 00:00:00,16,85,Tuesday,0,101
12871,WOAK,2016-06-07 04:00:00,50,14,Tuesday,4,64
12872,WOAK,2016-06-07 05:00:00,208,26,Tuesday,5,234
12873,WOAK,2016-06-07 06:00:00,460,83,Tuesday,6,543
12874,WOAK,2016-06-07 07:00:00,895,122,Tuesday,7,1017
12875,WOAK,2016-06-07 08:00:00,1380,193,Tuesday,8,1573
12876,WOAK,2016-06-07 09:00:00,1118,139,Tuesday,9,1257
12877,WOAK,2016-06-07 10:00:00,583,129,Tuesday,10,712
12878,WOAK,2016-06-07 11:00:00,326,150,Tuesday,11,476
12879,WOAK,2016-06-07 12:00:00,272,195,Tuesday,12,467
12880,WOAK,2016-06-07 13:00:00,232,211,Tuesday,13,443
12881,WOAK,2016-06-07 14:00:00,254,334,Tuesday,14,588
12882,WOAK,2016-06-07 15:00:00,287,472,Tuesday,15,759
12883,WOAK,2016-06-07 16:00:00,313,796,Tuesday,16,1109
12884,WOAK,2016-06-07 17:00:00,367,1176,Tuesday,17,1543
12885,WOAK,2016-06-07 18:00:00,413,1038,Tuesday,18,1451
12886,WOAK,2016-06-07 19:00:00,159,645,Tuesday,19,804
12887,WOAK,2016-06-07 20:00:00,133,425,Tuesday,20,558
12888,WOAK,2016-06-07 21:00:00,98,427,Tuesday,21,525
12889,WOAK,2016-06-07 22:00:00,125,384,Tuesday,22,509
12890,WOAK,2016-06-07 23:00:00,47,305,Tuesday,23,352
12891,WOAK,2016-06-08 00:00:00,28,118,Wednesday,0,146
12892,WOAK,2016-06-08 01:00:00,7,4,Wednesday,1,11
12893,WOAK,2016-06-08 04:00:00,37,12,Wednesday,4,49
12894,WOAK,2016-06-08 05:00:00,215,30,Wednesday,5,245
12895,WOAK,2016-06-08 06:00:00,493,89,Wednesday,6,582
12896,WOAK,2016-06-08 07:00:00,905,143,Wednesday,7,1048
12897,WOAK,2016-06-08 08:00:00,1320,159,Wednesday,8,1479
12898,WOAK,2016-06-08 09:00:00,1219,149,Wednesday,9,1368
12899,WOAK,2016-06-08 10:00:00,576,124,Wednesday,10,700
12900,WOAK,2016-06-08 11:00:00,324,140,Wednesday,11,464
12901,WOAK,2016-06-08 12:00:00,276,173,Wednesday,12,449
12902,WOAK,2016-06-08 13:00:00,234,257,Wednesday,13,491
12903,WOAK,2016-06-08 14:00:00,250,347,Wednesday,14,597
12904,WOAK,2016-06-08 15:00:00,247,474,Wednesday,15,721
12905,WOAK,2016-06-08 16:00:00,300,774,Wednesday,16,1074
12906,WOAK,2016-06-08 17:00:00,430,1214,Wednesday,17,1644
12907,WOAK,2016-06-08 18:00:00,371,1058,Wednesday,18,1429
12908,WOAK,2016-06-08 19:00:00,192,500,Wednesday,19,692
12909,WOAK,2016-06-08 20:00:00,100,397,Wednesday,20,497
12910,WOAK,2016-06-08 21:00:00,135,488,Wednesday,21,623
12911,WOAK,2016-06-08 22:00:00,89,436,Wednesday,22,525
12912,WOAK,2016-06-08 23:00:00,53,271,Wednesday,23,324
12913,WOAK,2016-06-09 00:00:00,24,108,Thursday,0,132
12914,WOAK,2016-06-09 01:00:00,8,4,Thursday,1,12
12915,WOAK,2016-06-09 04:00:00,38,13,Thursday,4,51
12916,WOAK,2016-06-09 05:00:00,197,34,Thursday,5,231
12917,WOAK,2016-06-09 06:00:00,473,96,Thursday,6,569
12918,WOAK,2016-06-09 07:00:00,814,126,Thursday,7,940
12919,WOAK,2016-06-09 08:00:00,1401,181,Thursday,8,1582
12920,WOAK,2016-06-09 09:00:00,1075,126,Thursday,9,1201
12921,WOAK,2016-06-09 10:00:00,544,138,Thursday,10,682
12922,WOAK,2016-06-09 11:00:00,318,120,Thursday,11,438
12923,WOAK,2016-06-09 12:00:00,273,185,Thursday,12,458
12924,WOAK,2016-06-09 13:00:00,251,230,Thursday,13,481
12925,WOAK,2016-06-09 14:00:00,271,331,Thursday,14,602
12926,WOAK,2016-06-09 15:00:00,267,454,Thursday,15,721
12927,WOAK,2016-06-09 16:00:00,263,719,Thursday,16,982
12928,WOAK,2016-06-09 17:00:00,363,1189,Thursday,17,1552
12929,WOAK,2016-06-09 18:00:00,337,992,Thursday,18,1329
12930,WOAK,2016-06-09 19:00:00,175,573,Thursday,19,748
12931,WOAK,2016-06-09 20:00:00,125,501,Thursday,20,626
12932,WOAK,2016-06-09 21:00:00,119,463,Thursday,21,582
12933,WOAK,2016-06-09 22:00:00,94,323,Thursday,22,417
12934,WOAK,2016-06-09 23:00:00,57,240,Thursday,23,297
12935,WOAK,2016-06-10 00:00:00,31,111,Friday,0,142
12936,WOAK,2016-06-10 01:00:00,13,2,Friday,1,15
12937,WOAK,2016-06-10 04:00:00,34,13,Friday,4,47
12938,WOAK,2016-06-10 05:00:00,212,29,Friday,5,241
12939,WOAK,2016-06-10 06:00:00,441,87,Friday,6,528
12940,WOAK,2016-06-10 07:00:00,801,113,Friday,7,914
12941,WOAK,2016-06-10 08:00:00,1268,157,Friday,8,1425
12942,WOAK,2016-06-10 09:00:00,973,144,Friday,9,1117
12943,WOAK,2016-06-10 10:00:00,577,156,Friday,10,733
12944,WOAK,2016-06-10 11:00:00,356,144,Friday,11,500
12945,WOAK,2016-06-10 12:00:00,289,212,Friday,12,501
12946,WOAK,2016-06-10 13:00:00,301,314,Friday,13,615
12947,WOAK,2016-06-10 14:00:00,262,459,Friday,14,721
12948,WOAK,2016-06-10 15:00:00,340,484,Friday,15,824
12949,WOAK,2016-06-10 16:00:00,309,784,Friday,16,1093
12950,WOAK,2016-06-10 17:00:00,480,1169,Friday,17,1649
12951,WOAK,2016-06-10 18:00:00,477,861,Friday,18,1338
12952,WOAK,2016-06-10 19:00:00,274,425,Friday,19,699
12953,WOAK,2016-06-10 20:00:00,148,310,Friday,20,458
12954,WOAK,2016-06-10 21:00:00,105,419,Friday,21,524
12955,WOAK,2016-06-10 22:00:00,103,500,Friday,22,603
12956,WOAK,2016-06-10 23:00:00,66,342,Friday,23,408
12957,WOAK,2016-06-11 00:00:00,101,186,Saturday,0,287
12958,WOAK,2016-06-11 01:00:00,14,1,Saturday,1,15
12959,WOAK,2016-06-11 06:00:00,116,45,Saturday,6,161
12960,WOAK,2016-06-11 07:00:00,227,55,Saturday,7,282
12961,WOAK,2016-06-11 08:00:00,328,63,Saturday,8,391
12962,WOAK,2016-06-11 09:00:00,349,57,Saturday,9,406
12963,WOAK,2016-06-11 10:00:00,316,114,Saturday,10,430
12964,WOAK,2016-06-11 11:00:00,322,146,Saturday,11,468
12965,WOAK,2016-06-11 12:00:00,371,170,Saturday,12,541
12966,WOAK,2016-06-11 13:00:00,388,226,Saturday,13,614
12967,WOAK,2016-06-11 14:00:00,362,215,Saturday,14,577
12968,WOAK,2016-06-11 15:00:00,386,254,Saturday,15,640
12969,WOAK,2016-06-11 16:00:00,338,348,Saturday,16,686
12970,WOAK,2016-06-11 17:00:00,274,347,Saturday,17,621
12971,WOAK,2016-06-11 18:00:00,307,397,Saturday,18,704
12972,WOAK,2016-06-11 19:00:00,220,380,Saturday,19,600
12973,WOAK,2016-06-11 20:00:00,149,319,Saturday,20,468
12974,WOAK,2016-06-11 21:00:00,135,421,Saturday,21,556
12975,WOAK,2016-06-11 22:00:00,113,326,Saturday,22,439
12976,WOAK,2016-06-11 23:00:00,98,273,Saturday,23,371
12977,WOAK,2016-06-12 00:00:00,41,172,Sunday,0,213
12978,WOAK,2016-06-12 01:00:00,3,3,Sunday,1,6
12979,WOAK,2016-06-12 08:00:00,150,75,Sunday,8,225
12980,WOAK,2016-06-12 09:00:00,226,64,Sunday,9,290
12981,WOAK,2016-06-12 10:00:00,262,73,Sunday,10,335
12982,WOAK,2016-06-12 11:00:00,260,89,Sunday,11,349
12983,WOAK,2016-06-12 12:00:00,290,132,Sunday,12,422
12984,WOAK,2016-06-12 13:00:00,278,140,Sunday,13,418
12985,WOAK,2016-06-12 14:00:00,267,170,Sunday,14,437
12986,WOAK,2016-06-12 15:00:00,265,179,Sunday,15,444
12987,WOAK,2016-06-12 16:00:00,265,234,Sunday,16,499
12988,WOAK,2016-06-12 17:00:00,248,263,Sunday,17,511
12989,WOAK,2016-06-12 18:00:00,216,307,Sunday,18,523
12990,WOAK,2016-06-12 19:00:00,145,274,Sunday,19,419
12991,WOAK,2016-06-12 20:00:00,109,279,Sunday,20,388
12992,WOAK,2016-06-12 21:00:00,92,376,Sunday,21,468
12993,WOAK,2016-06-12 22:00:00,105,230,Sunday,22,335
12994,WOAK,2016-06-12 23:00:00,45,103,Sunday,23,148
12995,WOAK,2016-06-13 00:00:00,32,126,Monday,0,158
12996,WOAK,2016-06-13 01:00:00,6,1,Monday,1,7
12997,WOAK,2016-06-13 04:00:00,38,10,Monday,4,48
12998,WOAK,2016-06-13 05:00:00,191,26,Monday,5,217
12999,WOAK,2016-06-13 06:00:00,477,80,Monday,6,557
13000,WOAK,2016-06-13 07:00:00,881,156,Monday,7,1037
13001,WOAK,2016-06-13 08:00:00,1394,169,Monday,8,1563
13002,WOAK,2016-06-13 09:00:00,1089,145,Monday,9,1234
13003,WOAK,2016-06-13 10:00:00,516,91,Monday,10,607
13004,WOAK,2016-06-13 11:00:00,291,129,Monday,11,420
13005,WOAK,2016-06-13 12:00:00,258,173,Monday,12,431
13006,WOAK,2016-06-13 13:00:00,231,213,Monday,13,444
13007,WOAK,2016-06-13 14:00:00,253,382,Monday,14,635
13008,WOAK,2016-06-13 15:00:00,254,486,Monday,15,740
13009,WOAK,2016-06-13 16:00:00,286,811,Monday,16,1097
13010,WOAK,2016-06-13 17:00:00,392,1300,Monday,17,1692
13011,WOAK,2016-06-13 18:00:00,348,997,Monday,18,1345
13012,WOAK,2016-06-13 19:00:00,151,471,Monday,19,622
13013,WOAK,2016-06-13 20:00:00,82,268,Monday,20,350
13014,WOAK,2016-06-13 21:00:00,148,485,Monday,21,633
13015,WOAK,2016-06-13 22:00:00,72,308,Monday,22,380
13016,WOAK,2016-06-13 23:00:00,51,233,Monday,23,284
13017,WOAK,2016-06-14 00:00:00,34,88,Tuesday,0,122
13018,WOAK,2016-06-14 04:00:00,46,16,Tuesday,4,62
13019,WOAK,2016-06-14 05:00:00,219,29,Tuesday,5,248
13020,WOAK,2016-06-14 06:00:00,501,95,Tuesday,6,596
13021,WOAK,2016-06-14 07:00:00,887,127,Tuesday,7,1014
13022,WOAK,2016-06-14 08:00:00,1449,182,Tuesday,8,1631
13023,WOAK,2016-06-14 09:00:00,1116,144,Tuesday,9,1260
13024,WOAK,2016-06-14 10:00:00,555,130,Tuesday,10,685
13025,WOAK,2016-06-14 11:00:00,340,131,Tuesday,11,471
13026,WOAK,2016-06-14 12:00:00,278,191,Tuesday,12,469
13027,WOAK,2016-06-14 13:00:00,244,220,Tuesday,13,464
13028,WOAK,2016-06-14 14:00:00,243,337,Tuesday,14,580
13029,WOAK,2016-06-14 15:00:00,269,440,Tuesday,15,709
13030,WOAK,2016-06-14 16:00:00,289,724,Tuesday,16,1013
13031,WOAK,2016-06-14 17:00:00,395,1322,Tuesday,17,1717
13032,WOAK,2016-06-14 18:00:00,352,1080,Tuesday,18,1432
13033,WOAK,2016-06-14 19:00:00,198,612,Tuesday,19,810
13034,WOAK,2016-06-14 20:00:00,124,409,Tuesday,20,533
13035,WOAK,2016-06-14 21:00:00,118,301,Tuesday,21,419
13036,WOAK,2016-06-14 22:00:00,82,412,Tuesday,22,494
13037,WOAK,2016-06-14 23:00:00,72,332,Tuesday,23,404
